"","sub","item","cond","seq","Bnd_loc","tCross","tStarted","tCompleted","tChange","tActualChange","nextFlag","tNextFlag","tChangetoFixOnset"
"1",1,28,5,1,271,935602,935605,935613,8,11,"EFIX",935602,588
"2",1,88,5,2,667,947504,947507,947515,8,11,"EFIX",947505,613
"3",1,39,4,3,436,954381,954384,954386,2,5,"SFIX",954385,1
"4",1,84,1,4,425,963306,963309,963316,7,10,"SFIX",963318,-2
"5",1,2,3,5,359,974729,974739,974745,6,16,"EFIX",974732,423
"6",1,118,5,6,315,985967,985970,985974,4,7,"EFIX",985770,381
"7",1,72,1,7,337,995567,995570,995577,7,10,"SFIX",995578,-1
"8",1,46,5,8,271,1002093,1002096,1002101,5,8,"SFIX",1002100,1
"9",1,41,6,9,348,1013364,1013366,1013371,5,7,"SFIX",1013369,2
"10",1,6,1,10,502,1025030,1025033,1025046,13,16,"SFIX",1025046,0
"11",1,125,6,11,260,1034693,1034696,1034703,7,10,"SFIX",1034702,1
"12",1,19,2,12,359,1041368,1041371,1041373,2,5,"SFIX",1041372,1
"13",1,23,6,13,370,1053422,1053425,1053429,4,7,"EFIX",1053424,560
"14",1,7,2,14,513,1063851,1063854,1063859,5,8,"SFIX",1063863,-4
"15",1,61,2,15,513,1076365,1076368,1076374,6,9,"SFIX",1076385,-11
"16",1,5,6,16,480,1081968,1081970,1081972,2,4,"SFIX",1081977,-5
"17",1,79,2,17,579,1091987,1091990,1091995,5,8,"EFIX",1091989,417
"18",1,66,1,18,524,1097594,1097597,1097599,2,5,"SFIX",1097600,-1
"19",1,122,3,19,403,1102694,1102697,1102704,7,10,"EFIX",1102695,432
"20",1,55,2,20,579,1108014,1108017,1108022,5,8,"SFIX",1108020,2
"21",1,96,1,21,359,1113531,1113534,1113540,6,9,"SFIX",1113534,6
"22",1,40,5,22,513,1120686,1120689,1120691,2,5,"SFIX",1120701,-10
"23",1,105,4,23,315,1129215,1129218,1129221,3,6,"SFIX",1129226,-5
"24",1,91,2,24,216,1135544,1135547,1135552,5,8,"SFIX",1135556,-4
"25",1,68,3,25,634,1142725,1142728,1142729,1,4,"SFIX",1142738,-9
"26",1,137,6,26,249,1149338,1149341,1149347,6,9,"SFIX",1149354,-7
"27",1,54,1,27,535,1157041,1157044,1157051,7,10,"SFIX",1157053,-2
"28",1,59,6,28,249,1166607,1166614,1166620,6,13,"SFIX",1166616,4
"29",1,109,2,29,381,1173044,1173047,1173051,4,7,"SFIX",1173056,-5
"30",1,58,5,30,403,1180458,1180461,1180469,8,11,"SFIX",1180470,-1
"31",1,3,4,31,260,1186152,1186155,1186160,5,8,"SFIX",1186163,-3
"32",1,98,3,32,579,1196428,1196431,1196436,5,8,"SFIX",1196440,-4
"33",1,57,4,33,381,1204594,1204597,1204600,3,6,"SFIX",1204600,0
"34",1,83,6,34,491,1212358,1212361,1212364,3,6,"EFIX",1212357,994
"35",1,124,5,35,513,1219613,1219616,1219621,5,8,"SFIX",1219619,2
"36",1,14,3,36,480,1226977,1226980,1226985,5,8,"SFIX",1226985,0
"37",1,42,1,37,480,1238947,1238954,1238960,6,13,"EFIX",1238952,519
"38",1,85,2,38,436,1248425,1248428,1248430,2,5,"SFIX",1248438,-8
"39",1,16,5,39,502,1255177,1255180,1255188,8,11,"SFIX",1255190,-2
"40",1,123,4,40,370,1264630,1264633,1264638,5,8,"SFIX",1264646,-8
"41",1,104,3,41,601,1271241,1271244,1271248,4,7,"SFIX",1271249,-1
"42",1,75,4,42,249,1276241,1276244,1276247,3,6,"EFIX",1276241,459
"43",1,49,2,43,513,1285837,1285839,1285843,4,6,"SFIX",1285844,-1
"44",1,31,2,44,315,1293687,1293690,1293693,3,6,"SFIX",1293693,0
"45",1,120,1,45,403,1304046,1304049,1304056,7,10,"SFIX",1304057,-1
"46",1,114,1,46,271,1312260,1312264,1312273,9,13,"SFIX",1312273,0
"47",1,111,4,47,348,1319403,1319406,1319411,5,8,"SFIX",1319410,1
"48",1,130,5,48,535,1326279,1326282,1326288,6,9,"SFIX",1326291,-3
"49",1,136,5,49,436,1332099,1332101,1332106,5,7,"EFIX",1332097,479
"50",1,103,2,50,458,1340140,1340143,1340150,7,10,"SFIX",1340145,5
"51",1,8,3,51,612,1348118,1348121,1348127,6,9,"EFIX",1348118,635
"52",1,71,6,52,403,1359047,1359050,1359056,6,9,"SFIX",1359057,-1
"53",1,64,5,53,623,1367972,1367975,1367979,4,7,"SFIX",1367981,-2
"54",1,101,6,54,359,1373555,1373558,1373564,6,9,"SFIX",1373565,-1
"55",1,25,2,55,337,1379362,1379365,1379368,3,6,"EFIX",1379364,691
"56",1,63,4,56,403,1389706,1389709,1389711,2,5,"SFIX",1389709,2
"57",1,56,3,57,480,1395707,1395710,1395716,6,9,"SFIX",1395726,-10
"58",1,15,4,58,227,1400766,1400769,1400774,5,8,"SFIX",1400774,0
"59",1,10,5,59,656,1411620,1411623,1411630,7,10,"SFIX",1411634,-4
"60",1,60,1,60,304,1420083,1420086,1420093,7,10,"SFIX",1420094,-1
"61",1,87,4,61,524,1426964,1426967,1426971,4,7,"SFIX",1426971,0
"62",1,93,4,62,502,1434145,1434148,1434155,7,10,"SFIX",1434154,1
"63",1,44,3,63,381,1439725,1439727,1439733,6,8,"EFIX",1439725,428
"64",1,34,5,64,425,1447765,1447769,1447776,7,11,"SFIX",1447776,0
"65",1,65,6,65,502,1458060,1458063,1458066,3,6,"SFIX",1458069,-3
"66",1,119,6,66,502,1494610,1494613,1494619,6,9,"SFIX",1494613,6
"67",1,95,6,67,425,1501020,1501023,1501030,7,10,"SFIX",1501030,0
"68",1,4,5,68,480,1507784,1507787,1507794,7,10,"SFIX",1507794,0
"69",1,29,6,69,480,1517105,1517108,1517111,3,6,"SFIX",1517117,-6
"70",1,107,6,70,436,1526625,1526628,1526634,6,9,"SFIX",1526640,-6
"71",1,78,1,71,546,1531818,1531821,1531825,4,7,"SFIX",1531834,-9
"72",1,82,5,72,436,NA,1537310,1537317,7,NA,"EFIX",1537307,523
"73",1,102,1,73,557,1545564,1545567,1545574,7,10,"EFIX",1545565,416
"74",1,47,6,74,425,1551995,1551998,1552004,6,9,"SFIX",1551999,5
"75",1,89,6,75,700,1561801,1561804,1561807,3,6,"SFIX",1561810,-3
"76",1,32,3,76,370,1567307,1567310,1567312,2,5,"SFIX",1567316,-4
"77",1,133,2,77,392,1575709,1575712,1575716,4,7,"SFIX",1575718,-2
"78",1,13,2,78,271,1581533,1581536,1581540,4,7,"SFIX",1581551,-11
"79",1,138,1,79,524,1591778,1591781,1591783,2,5,"SFIX",1591785,-2
"80",1,106,5,80,403,1596987,1596990,1596995,5,8,"SFIX",1596991,4
"81",1,36,1,81,392,1602115,1602118,1602119,1,4,"SFIX",1602128,-9
"82",1,116,3,82,414,1609369,1609404,1609410,6,41,"EFIX",1609214,296
"83",1,135,4,83,293,1616041,1616044,1616047,3,6,"SFIX",1616054,-7
"84",1,76,5,84,458,1621390,1621393,1621399,6,9,"SFIX",1621404,-5
"85",1,74,3,85,315,1628191,1628194,1628196,2,5,"SFIX",1628205,-9
"86",1,48,1,86,282,1634712,1634715,1634721,6,9,"SFIX",1634720,1
"87",1,27,4,87,304,1644400,1644403,1644410,7,10,"SFIX",1644412,-2
"88",1,94,5,88,293,1653973,1653976,1653980,4,7,"SFIX",1653991,-11
"89",1,21,4,89,656,1660580,1660583,1660584,1,4,"SFIX",1660587,-3
"90",1,9,4,90,667,1671892,1671895,1671900,5,8,"SFIX",1671910,-10
"91",1,38,3,91,447,1680301,1680304,1680310,6,9,"SFIX",1680304,6
"92",1,92,3,92,546,1688544,1688547,1688554,7,10,"SFIX",1688549,5
"93",1,69,4,93,381,1696102,1696105,1696111,6,9,"SFIX",1696115,-4
"94",1,108,1,94,326,1700592,1700595,1700603,8,11,"SFIX",1700598,5
"95",1,52,5,95,370,1705819,1705822,1705828,6,9,"SFIX",1705825,3
"96",1,51,4,96,634,1715408,1715411,1715417,6,9,"SFIX",1715413,4
"97",1,67,2,97,414,1724828,1724831,1724834,3,6,"SFIX",1724839,-5
"98",1,112,5,98,216,1729668,1729672,1729679,7,11,"SFIX",1729684,-5
"99",1,45,4,99,469,1734948,1734951,1734957,6,9,"SFIX",1734954,3
"100",1,99,4,100,194,1742618,1742621,1742627,6,9,"SFIX",1742631,-4
"101",1,86,3,101,282,1751293,1751297,1751304,7,11,"SFIX",1751307,-3
"102",1,73,2,102,524,1756840,1756843,1756849,6,9,"SFIX",1756852,-3
"103",1,90,1,103,238,1762953,1762956,1762960,4,7,"SFIX",1762963,-3
"104",1,17,6,104,315,1769020,1769023,1769031,8,11,"SFIX",1769027,4
"105",1,129,4,105,271,1780085,1780088,1780094,6,9,"SFIX",1780093,1
"106",1,18,1,106,381,1785954,1785957,1785965,8,11,"SFIX",1785968,-3
"107",1,33,4,107,502,1795377,1795380,1795381,1,4,"SFIX",1795393,-12
"108",1,30,1,108,315,1804282,1804285,1804291,6,9,"SFIX",1804296,-5
"109",1,117,4,109,337,1812582,1812585,1812588,3,6,"SFIX",1812594,-6
"110",1,11,6,110,293,1818353,1818356,1818359,3,6,"SFIX",1818368,-9
"111",1,12,1,111,590,1827261,1827263,1827269,6,8,"SFIX",1827266,3
"112",1,22,5,112,557,1836859,1836862,1836866,4,7,"SFIX",1836873,-7
"113",1,37,2,113,678,1846142,1846145,1846149,4,7,"EFIX",1846141,437
"114",1,26,3,114,249,1854194,1854197,1854199,2,5,"SFIX",1854205,-6
"115",1,62,3,115,546,1866828,1866831,1866835,4,7,"SFIX",1866841,-6
"116",1,100,5,116,414,1873504,1873508,1873512,4,8,"SFIX",1873513,-1
"117",1,53,6,117,326,1879416,1879419,1879423,4,7,"SFIX",1879426,-3
"118",1,24,1,118,480,1890613,1890616,1890633,17,20,"SFIX",1890623,10
"119",1,77,6,119,414,1899467,1899470,1899476,6,9,"SFIX",1899480,-4
"120",1,131,6,120,447,1905617,1905621,1905627,6,10,"EFIX",1905620,350
"121",1,113,6,121,513,1911101,1911105,1911112,7,11,"SFIX",1911108,4
"122",1,110,3,122,414,1916490,1916493,1916496,3,6,"SFIX",1916494,2
"123",1,50,3,123,458,1922068,1922071,1922074,3,6,"SFIX",1922077,-3
"124",1,81,4,124,700,1932008,1932011,1932017,6,9,"SFIX",1932020,-3
"125",1,134,3,125,348,1937974,1937977,1937982,5,8,"SFIX",1937977,5
"126",1,97,2,126,689,1945152,1945155,1945159,4,7,"SFIX",1945174,-15
"127",1,115,2,127,447,1949977,1949980,1949984,4,7,"SFIX",1949990,-6
"128",1,20,3,128,502,1955516,1955519,1955522,3,6,"EFIX",1955515,435
"129",1,127,2,129,513,1965031,1965034,1965038,4,7,"SFIX",1965045,-7
"130",1,126,1,130,469,1973304,1973307,1973329,22,25,"SFIX",1973319,10
"131",1,35,6,131,469,1981564,1981567,1981586,19,22,"SFIX",1981572,14
"132",1,128,3,132,282,1989856,1989859,1989863,4,7,"EFIX",1989851,326
"133",1,1,2,133,513,1996235,1996238,1996240,2,5,"SFIX",1996244,-4
"134",1,70,5,134,733,2005569,2005572,2005577,5,8,"SFIX",2005582,-5
"135",1,132,1,135,458,2010764,2010767,2010775,8,11,"SFIX",2010772,3
"136",1,121,2,136,436,2016550,2016553,2016559,6,9,"SFIX",2016566,-7
"137",1,43,2,137,216,2021580,2021583,2021591,8,11,"SFIX",2021589,2
"138",1,80,3,138,414,2030910,2030913,2030921,8,11,"EFIX",2030909,371
"139",2,56,4,1,480,3226424,3226427,3226433,6,9,"SFIX",3226439,-6
"140",2,133,3,2,392,3233507,3233510,3233517,7,10,"SFIX",3233523,-6
"141",2,49,3,3,513,3240421,3240423,3240428,5,7,"EFIX",3240416,446
"142",2,47,1,4,425,3249310,3249313,3249318,5,8,"EFIX",3249312,308
"143",2,58,6,5,403,3257964,3257967,3257975,8,11,"SFIX",3257970,5
"144",2,64,6,6,623,3264354,3264357,3264359,2,5,"SFIX",3264569,-210
"145",2,28,6,7,271,3269388,3269391,3269397,6,9,"SFIX",3269391,6
"146",2,7,3,8,513,3280524,3280527,3280533,6,9,"SFIX",3280528,5
"147",2,40,6,9,513,3294372,3294374,3294381,7,9,"EFIX",3294344,642
"148",2,110,4,10,414,3305143,3305147,3305151,4,8,"SFIX",3305150,1
"149",2,48,2,11,282,3312564,3312568,3312574,6,10,"SFIX",3312580,-6
"150",2,8,4,12,612,3321999,3322002,3322004,2,5,"SFIX",3322003,1
"151",2,132,2,13,458,3333078,3333081,3333087,6,9,"SFIX",3333088,-1
"152",2,107,1,14,436,3340182,3340185,3340191,6,9,"EFIX",3340184,498
"153",2,128,4,15,282,3345848,3345851,3345856,5,8,"SFIX",3345859,-3
"154",2,13,3,16,271,3354738,3354741,3354746,5,8,"SFIX",3354743,3
"155",2,10,6,17,656,3364704,3364707,3364709,2,5,"SFIX",3364711,-2
"156",2,37,3,18,678,3375308,3375311,3375332,21,24,"SFIX",3375312,20
"157",2,130,6,19,535,3386103,3386106,3386114,8,11,"SFIX",3386110,4
"158",2,45,5,20,469,3394187,3394189,3394191,2,4,"SFIX",3394190,1
"159",2,88,6,21,667,3404308,3404311,3404314,3,6,"SFIX",3404317,-3
"160",2,44,4,22,381,3410589,3410592,3410598,6,9,"SFIX",3410600,-2
"161",2,67,3,23,414,3420364,3420367,3420375,8,11,"SFIX",3420368,7
"162",2,29,1,24,480,3425619,3425622,3425626,4,7,"SFIX",3425630,-4
"163",2,119,1,25,502,3435604,3435607,3435609,2,5,"SFIX",3435608,1
"164",2,59,1,26,249,3441240,3441243,3441247,4,7,"SFIX",3441244,3
"165",2,46,6,27,271,3448678,3448681,3448684,3,6,"SFIX",3448690,-6
"166",2,2,4,28,359,3458522,3458525,3458527,2,5,"SFIX",3458533,-6
"167",2,118,6,29,315,3468474,3468477,3468484,7,10,"EFIX",3468474,431
"168",2,104,4,30,601,3476834,3476837,3476841,4,7,"SFIX",3476837,4
"169",2,42,2,31,480,3485305,3485305,3485311,6,6,"EFIX",3484988,439
"170",2,72,2,32,337,3494109,3494112,3494114,2,5,"SFIX",3494121,-7
"171",2,98,4,33,579,3499759,3499762,3499765,3,6,"SFIX",3499776,-11
"172",2,65,1,34,502,3506984,3506987,3506989,2,5,"SFIX",3506988,1
"173",2,126,2,35,469,3512843,3512846,3512847,1,4,"EFIX",3512840,438
"174",2,108,2,36,326,3520928,3520932,3520938,6,10,"SFIX",3520943,-5
"175",2,6,2,37,502,3528543,3528546,3528548,2,5,"SFIX",3528553,-5
"176",2,9,5,38,667,3540122,3540125,3540131,6,9,"SFIX",3540131,0
"177",2,54,2,39,535,3550536,3550539,3550547,8,11,"SFIX",3550547,0
"178",2,74,4,40,315,3561047,3561050,3561056,6,9,"SFIX",3561059,-3
"179",2,129,5,41,271,3567778,3567781,3567787,6,9,"SFIX",3567789,-2
"180",2,63,5,42,403,3574073,3574075,3574078,3,5,"EFIX",3574069,469
"181",2,31,3,43,315,3579384,3579387,3579389,2,5,"EFIX",3579369,522
"182",2,27,5,44,304,3590576,3590579,3590585,6,9,"SFIX",3590584,1
"183",2,121,3,45,436,3598886,3598889,3598896,7,10,"SFIX",3598897,-1
"184",2,60,2,46,304,3604497,3604501,3604507,6,10,"SFIX",3604505,2
"185",2,90,2,47,238,3611397,3611397,3611404,7,7,"EFIX",3611226,385
"186",2,85,3,48,436,3618899,3618902,3618908,6,9,"SFIX",3618906,2
"187",2,25,3,49,337,3624338,3624341,3624346,5,8,"SFIX",3624347,-1
"188",2,114,2,50,271,3632907,3632910,3632916,6,9,"SFIX",3632917,-1
"189",2,136,6,51,436,3639787,3639790,3639794,4,7,"SFIX",3639796,-2
"190",2,116,4,52,414,3645895,3645898,3645905,7,10,"SFIX",3645902,3
"191",2,124,6,53,513,3652751,3652754,3652756,2,5,"SFIX",3652754,2
"192",2,122,4,54,403,3657542,3657545,3657547,2,5,"SFIX",3657554,-7
"193",2,94,6,55,293,3661794,3661798,3661806,8,12,"SFIX",3661805,1
"194",2,135,5,56,293,3668401,3668405,3668410,5,9,"SFIX",3668414,-4
"195",2,77,1,57,414,3674365,3674368,3674374,6,9,"SFIX",3674378,-4
"196",2,41,1,58,348,3679755,3679758,3679766,8,11,"SFIX",3679768,-2
"197",2,111,5,59,348,3688139,3688142,3688149,7,10,"SFIX",3688150,-1
"198",2,101,1,60,359,3694421,3694423,3694427,4,6,"EFIX",3694421,325
"199",2,21,5,61,656,3700797,3700801,3700805,4,8,"SFIX",3700806,-1
"200",2,66,2,62,524,3708668,3708671,3708675,4,7,"SFIX",3708685,-10
"201",2,84,2,63,425,3713543,3713546,3713553,7,10,"EFIX",3713533,442
"202",2,91,3,64,216,3718162,3718165,3718172,7,10,"SFIX",3718167,5
"203",2,3,5,65,260,3723382,3723385,3723390,5,8,"SFIX",3723394,-4
"204",2,34,6,66,425,3770439,3770442,3770446,4,7,"SFIX",3770442,4
"205",2,43,3,67,216,3779303,3779306,3779309,3,6,"EFIX",3779304,414
"206",2,86,4,68,282,3787916,3787919,3787926,7,10,"EFIX",3787914,374
"207",2,127,3,69,513,3793574,3793577,3793584,7,10,"SFIX",3793585,-1
"208",2,32,4,70,370,3798121,3798124,3798129,5,8,"SFIX",3798138,-9
"209",2,81,5,71,700,3810416,3810419,3810424,5,8,"EFIX",3810407,305
"210",2,95,1,72,425,3815379,3815382,3815389,7,10,"SFIX",3815389,0
"211",2,134,4,73,348,3821771,3821774,3821780,6,9,"SFIX",3821782,-2
"212",2,36,2,74,392,3827102,3827105,3827112,7,10,"SFIX",3827108,4
"213",2,109,3,75,381,3836733,3836736,3836741,5,8,"SFIX",3836747,-6
"214",2,4,6,76,480,3842561,3842564,3842566,2,5,"SFIX",3842574,-8
"215",2,113,1,77,513,3851003,3851006,3851009,3,6,"EFIX",3850998,408
"216",2,68,4,78,634,3856688,3856691,3856694,3,6,"SFIX",3856698,-4
"217",2,102,2,79,557,3862772,3862775,3862778,3,6,"SFIX",3862784,-6
"218",2,106,6,80,403,3868483,3868486,3868490,4,7,"SFIX",3868490,0
"219",2,123,5,81,370,3874066,3874066,3874067,1,1,"SFIX",3874248,-181
"220",2,26,4,82,249,3879626,3879629,3879632,3,6,"SFIX",3879629,3
"221",2,5,1,83,480,3888771,3888774,3888782,8,11,"SFIX",3888774,8
"222",2,73,3,84,524,3899988,3899991,3899998,7,10,"SFIX",3899997,1
"223",2,93,5,85,502,3907745,3907748,3907755,7,10,"SFIX",3907760,-5
"224",2,14,4,86,480,3912836,3912839,3912847,8,11,"SFIX",3912844,3
"225",2,70,6,87,733,3925054,3925057,3925062,5,8,"EFIX",3925040,434
"226",2,16,6,88,502,3932181,3932184,3932186,2,5,"SFIX",3932191,-5
"227",2,17,1,89,315,3940498,3940500,3940503,3,5,"EFIX",3940499,360
"228",2,39,5,90,436,3950428,3950431,3950433,2,5,"SFIX",3950439,-6
"229",2,33,5,91,502,3960174,3960177,3960182,5,8,"EFIX",3960164,444
"230",2,53,1,92,326,3968245,3968248,3968253,5,8,"EFIX",3968240,419
"231",2,35,1,93,469,3978262,3978265,3978269,4,7,"EFIX",3978261,375
"232",2,22,6,94,557,3989152,3989152,3989158,6,6,"SFIX",3989182,-24
"233",2,78,2,95,546,4000138,4000141,4000148,7,10,"SFIX",4000145,3
"234",2,75,5,96,249,4004010,4004013,4004020,7,10,"SFIX",4004014,6
"235",2,120,2,97,403,4010552,4010556,4010557,1,5,"SFIX",4010559,-2
"236",2,11,1,98,293,4015727,4015731,4015735,4,8,"EFIX",4015721,346
"237",2,57,5,99,381,4026527,4026529,4026531,2,4,"SFIX",4026533,-2
"238",2,52,6,100,370,4031881,4031884,4031889,5,8,"SFIX",4031884,5
"239",2,76,6,101,458,4041535,4041538,4041546,8,11,"SFIX",4041542,4
"240",2,100,6,102,414,4047222,4047225,4047230,5,8,"SFIX",4047234,-4
"241",2,19,3,103,359,4053435,4053438,4053441,3,6,"SFIX",4053439,2
"242",2,12,2,104,590,4068139,4068142,4068149,7,10,"SFIX",4068149,0
"243",2,69,5,105,381,4076770,4076773,4076779,6,9,"SFIX",4076777,2
"244",2,131,1,106,447,4081718,4081720,4081724,4,6,"EFIX",4081714,504
"245",2,38,4,107,447,4087832,4087835,4087842,7,10,"EFIX",4087820,452
"246",2,71,1,108,403,4095986,4095989,4095992,3,6,"SFIX",4095997,-5
"247",2,24,2,109,480,4102421,4102424,4102430,6,9,"SFIX",4102428,2
"248",2,103,3,110,458,4113904,4113907,4113912,5,8,"SFIX",4113913,-1
"249",2,1,3,111,513,4119846,4119849,4119857,8,11,"EFIX",4119841,421
"250",2,92,4,112,546,4132387,4132390,4132392,2,5,"SFIX",4132394,-2
"251",2,87,5,113,524,4140121,4140124,4140129,5,8,"SFIX",4140134,-5
"252",2,112,6,114,216,4146202,4146205,4146207,2,5,"SFIX",4146216,-9
"253",2,55,3,115,579,4152793,4152796,4152798,2,5,"SFIX",4152801,-3
"254",2,97,3,116,689,4159033,4159036,4159042,6,9,"SFIX",4159041,1
"255",2,89,1,117,700,4164751,4164753,4164760,7,9,"SFIX",4164758,2
"256",2,30,2,118,315,4168823,4168826,4168832,6,9,"SFIX",4168830,2
"257",2,137,1,119,249,4177632,4177635,4177642,7,10,"SFIX",4177641,1
"258",2,138,2,120,524,4185518,4185521,4185526,5,8,"EFIX",4185216,232
"259",2,18,2,121,381,4190456,4190459,4190464,5,8,"SFIX",4190465,-1
"260",2,20,4,122,502,4199569,4199572,4199574,2,5,"SFIX",4199575,-1
"261",2,117,5,123,337,4207873,4207875,4207878,3,5,"EFIX",4207864,615
"262",2,96,2,124,359,4214592,4214596,4214602,6,10,"SFIX",4214602,0
"263",2,61,3,125,513,4222443,4222446,4222452,6,9,"SFIX",4222453,-1
"264",2,115,3,126,447,4228147,4228150,4228157,7,10,"SFIX",4228161,-4
"265",2,51,5,127,634,4235903,4235906,4235908,2,5,"SFIX",4235917,-9
"266",2,50,4,128,458,4244427,4244430,4244438,8,11,"SFIX",4244435,3
"267",2,80,4,129,414,4253838,4253841,4253848,7,10,"SFIX",4253848,0
"268",2,79,3,130,579,4259289,4259292,4259299,7,10,"SFIX",4259296,3
"269",2,82,6,131,436,4264792,4264795,4264797,2,5,"SFIX",4264805,-8
"270",2,125,1,132,260,4269268,4269268,4269275,7,7,"EFIX",4269224,332
"271",2,62,4,133,546,4274926,4274929,4274933,4,7,"SFIX",4274936,-3
"272",2,15,5,134,227,4279066,4279069,4279072,3,6,"EFIX",4279035,306
"273",2,23,1,135,370,4287350,4287353,4287355,2,5,"SFIX",4287363,-8
"274",2,105,5,136,315,4296392,4296395,4296398,3,6,"SFIX",4296400,-2
"275",2,83,1,137,491,4303417,4303420,4303423,3,6,"SFIX",4303430,-7
"276",2,99,5,138,194,4308495,4308498,4308501,3,6,"EFIX",4308494,351
"277",3,5,2,1,480,5519723,5519726,5519728,2,5,"SFIX",5519729,-1
"278",3,87,6,2,524,5532531,5532534,5532550,16,19,"SFIX",5532538,12
"279",3,73,4,3,524,5542799,5542802,5542806,4,7,"SFIX",5542809,-3
"280",3,96,3,4,359,5551211,5551214,5551216,2,5,"SFIX",5551220,-4
"281",3,32,5,5,370,5558682,5558685,5558687,2,5,"SFIX",5558688,-1
"282",3,43,4,6,216,5569464,5569467,5569469,2,5,"SFIX",5569478,-9
"283",3,66,3,7,524,5581400,5581404,5581419,15,19,"SFIX",5581407,12
"284",3,21,6,8,656,5589843,5589845,5589862,17,19,"SFIX",5589849,13
"285",3,79,4,9,579,5600450,5600453,5600458,5,8,"SFIX",5600460,-2
"286",3,42,3,10,480,5608429,5608432,5608435,3,6,"EFIX",5608431,673
"287",3,127,4,11,513,5618851,5618854,5618858,4,7,"SFIX",5618856,2
"288",3,47,2,12,425,5625299,5625302,5625309,7,10,"SFIX",5625311,-2
"289",3,69,6,13,381,5634885,5634888,5634892,4,7,"SFIX",5634889,3
"290",3,85,4,14,436,5641943,5641946,5641949,3,6,"SFIX",5641957,-8
"291",3,12,3,15,590,5650827,5650830,5650833,3,6,"SFIX",5650838,-5
"292",3,76,1,16,458,5660390,5660393,5660396,3,6,"SFIX",5660393,3
"293",3,104,5,17,601,5671065,5671068,5671072,4,7,"SFIX",5671073,-1
"294",3,49,4,18,513,5677245,5677248,5677250,2,5,"SFIX",5677257,-7
"295",3,62,5,19,546,5686865,5686868,5686873,5,8,"SFIX",5686868,5
"296",3,112,1,20,216,5692174,5692177,5692184,7,10,"SFIX",5692189,-5
"297",3,89,2,21,700,5700658,5700661,5700668,7,10,"SFIX",5700662,6
"298",3,11,2,22,293,5707149,5707152,5707159,7,10,"SFIX",5707155,4
"299",3,57,6,23,381,5718619,5718622,5718628,6,9,"SFIX",5718624,4
"300",3,108,3,24,326,5726593,5726597,5726598,1,5,"SFIX",5726607,-9
"301",3,75,6,25,249,5732808,5732811,5732816,5,8,"SFIX",5732816,0
"302",3,7,4,26,513,5743687,5743690,5743692,2,5,"EFIX",5743670,444
"303",3,74,5,27,315,5759153,5759156,5759173,17,20,"SFIX",5759171,2
"304",3,120,3,28,403,5767927,5767930,5767936,6,9,"SFIX",5767935,1
"305",3,15,6,29,227,5774047,5774050,5774054,4,7,"SFIX",5774054,0
"306",3,56,5,30,480,5785312,5785315,5785317,2,5,"SFIX",5785320,-3
"307",3,38,5,31,447,5792710,5792713,5792721,8,11,"SFIX",5792724,-3
"308",3,106,1,32,403,5802639,5802642,5802643,1,4,"SFIX",5802650,-7
"309",3,92,5,33,546,5809877,5809880,5809894,14,17,"SFIX",5809893,1
"310",3,83,2,34,491,5818998,5819001,5819004,3,6,"SFIX",5819006,-2
"311",3,58,1,35,403,5827738,5827741,5827748,7,10,"SFIX",5827748,0
"312",3,23,2,36,370,5834508,5834511,5834519,8,11,"SFIX",5834518,1
"313",3,6,3,37,502,5845383,5845386,5845388,2,5,"SFIX",5845395,-7
"314",3,129,6,38,271,5857748,5857751,5857757,6,9,"EFIX",5857750,475
"315",3,3,6,39,260,5864465,5864468,5864474,6,9,"SFIX",5864479,-5
"316",3,80,5,40,414,5876807,5876810,5876816,6,9,"SFIX",5876817,-1
"317",3,13,4,41,271,5882539,5882542,5882547,5,8,"SFIX",5882552,-5
"318",3,59,2,42,249,5893224,5893244,5893250,6,26,"EFIX",5893242,427
"319",3,88,1,43,667,5904289,5904292,5904299,7,10,"SFIX",5904296,3
"320",3,44,5,44,381,5911016,5911019,5911024,5,8,"EFIX",5911017,566
"321",3,19,4,45,359,5919875,5919878,5919880,2,5,"SFIX",5919882,-2
"322",3,115,4,46,447,5929956,5929959,5929963,4,7,"SFIX",5929964,-1
"323",3,40,1,47,513,5937035,5937038,5937041,3,6,"SFIX",5937043,-2
"324",3,77,2,48,414,5946627,5946630,5946637,7,10,"SFIX",5946634,3
"325",3,91,4,49,216,5952276,5952279,5952282,3,6,"SFIX",5952284,-2
"326",3,138,3,50,524,5959982,5959985,5959992,7,10,"SFIX",5959990,2
"327",3,130,1,51,535,5966280,5966283,5966290,7,10,"SFIX",5966285,5
"328",3,95,2,52,425,5974502,5974505,5974507,2,5,"SFIX",5974515,-8
"329",3,124,1,53,513,5981889,5981893,5981898,5,9,"SFIX",5981903,-5
"330",3,54,3,54,535,5988067,5988070,5988075,5,8,"SFIX",5988079,-4
"331",3,18,3,55,381,5998062,5998065,5998072,7,10,"SFIX",5998070,2
"332",3,17,2,56,315,6007877,6007880,6007888,8,11,"SFIX",6007889,-1
"333",3,45,6,57,469,6022217,6022220,6022223,3,6,"SFIX",6022231,-8
"334",3,101,2,58,359,6031003,6031006,6031013,7,10,"SFIX",6031010,3
"335",3,65,2,59,502,6038910,6038913,6038916,3,6,"SFIX",6038921,-5
"336",3,46,1,60,271,6045264,6045268,6045274,6,10,"SFIX",6045277,-3
"337",3,134,5,61,348,6055763,6055766,6055770,4,7,"SFIX",6055774,-4
"338",3,34,1,62,425,6062326,6062328,6062335,7,9,"SFIX",6062333,2
"339",3,60,3,63,304,6074674,6074677,6074683,6,9,"SFIX",6074685,-2
"340",3,131,2,64,447,6083051,6083055,6083060,5,9,"SFIX",6083059,1
"341",3,24,3,65,480,6089047,6089050,6089051,1,4,"SFIX",6089059,-8
"342",3,51,6,66,634,6128022,6128025,6128030,5,8,"SFIX",6128031,-1
"343",3,118,1,67,315,6137055,6137057,6137060,3,5,"SFIX",6137058,2
"344",3,29,2,68,480,6144197,6144200,6144204,4,7,"SFIX",6144205,-1
"345",3,72,3,69,337,6155617,6155620,6155627,7,10,"SFIX",6155627,0
"346",3,16,1,70,502,6164177,6164180,6164184,4,7,"SFIX",6164190,-6
"347",3,105,6,71,315,6172260,6172263,6172267,4,7,"SFIX",6172269,-2
"348",3,33,6,72,502,6179167,6179170,6179172,2,5,"SFIX",6179173,-1
"349",3,111,6,73,348,6190970,6190973,6190981,8,11,"SFIX",6190976,5
"350",3,81,6,74,700,NA,6199831,6199837,6,NA,"EFIX",6199830,779
"351",3,117,6,75,337,6207586,6207589,6207594,5,8,"SFIX",6207591,3
"352",3,70,1,76,733,6214830,6214832,6214838,6,8,"SFIX",6214839,-1
"353",3,121,4,77,436,6222778,6222781,6222802,21,24,"SFIX",6222785,17
"354",3,55,4,78,579,6232214,6232217,6232219,2,5,"SFIX",6232223,-4
"355",3,71,2,79,403,6237188,6237191,6237197,6,9,"SFIX",6237200,-3
"356",3,114,3,80,271,6242978,6242981,6242988,7,10,"SFIX",6242988,0
"357",3,1,4,81,513,6252127,6252130,6252138,8,11,"SFIX",6252132,6
"358",3,94,1,82,293,6264006,6264009,6264014,5,8,"SFIX",6264016,-2
"359",3,113,2,83,513,6275451,6275454,6275470,16,19,"SFIX",6275461,9
"360",3,27,6,84,304,6282419,6282422,6282427,5,8,"SFIX",6282425,2
"361",3,39,6,85,436,6291936,6291939,6291943,4,7,"EFIX",6291933,319
"362",3,48,3,86,282,6299618,6299621,6299627,6,9,"SFIX",6299628,-1
"363",3,35,2,87,469,6308803,6308806,6308810,4,7,"EFIX",6308805,499
"364",3,53,2,88,326,6334672,6334674,6334681,7,9,"SFIX",6334679,2
"365",3,107,2,89,436,6345405,6345408,6345410,2,5,"SFIX",6345415,-5
"366",3,4,1,90,480,6352863,6352866,6352874,8,11,"SFIX",6352867,7
"367",3,122,5,91,403,6362049,6362051,6362057,6,8,"EFIX",6362050,578
"368",3,67,4,92,414,6370096,6370099,6370101,2,5,"SFIX",6370103,-2
"369",3,109,4,93,381,6378128,6378131,6378138,7,10,"SFIX",6378142,-4
"370",3,110,5,94,414,6386427,6386430,6386449,19,22,"SFIX",6386432,17
"371",3,36,3,95,392,6393553,6393556,6393559,3,6,"SFIX",6393556,3
"372",3,8,5,96,612,6407909,6407912,6407914,2,5,"SFIX",6407918,-4
"373",3,25,4,97,337,6416234,6416237,6416244,7,10,"SFIX",6416244,0
"374",3,135,6,98,293,6426800,6426803,6426807,4,7,"SFIX",6426811,-4
"375",3,14,5,99,480,6434141,6434143,6434151,8,10,"EFIX",6434140,405
"376",3,93,6,100,502,6444465,6444468,6444474,6,9,"SFIX",6444470,4
"377",3,61,4,101,513,6450785,6450788,6450791,3,6,"SFIX",6450799,-8
"378",3,22,1,102,557,6458362,6458365,6458369,4,7,"SFIX",6458372,-3
"379",3,64,1,103,623,6472509,6472512,6472537,25,28,"SFIX",6472514,23
"380",3,30,3,104,315,6478405,6478408,6478415,7,10,"SFIX",6478409,6
"381",3,78,3,105,546,6487787,6487790,6487798,8,11,"SFIX",6487791,7
"382",3,50,5,106,458,6494549,6494552,6494576,24,27,"SFIX",6494558,18
"383",3,20,5,107,502,6504990,6504993,6504998,5,8,"SFIX",6505005,-7
"384",3,128,5,108,282,6514345,6514348,6514355,7,10,"SFIX",6514358,-3
"385",3,102,3,109,557,6523549,6523552,6523558,6,9,"SFIX",6523554,4
"386",3,123,6,110,370,6530389,6530391,6530395,4,6,"SFIX",6530393,2
"387",3,126,3,111,469,6539000,6539003,6539006,3,6,"SFIX",6539007,-1
"388",3,98,5,112,579,6548076,6548079,6548096,17,20,"SFIX",6548086,10
"389",3,41,2,113,348,6555375,6555377,6555380,3,5,"EFIX",6555376,655
"390",3,52,1,114,370,6565655,6565658,6565662,4,7,"SFIX",6565668,-6
"391",3,9,6,115,667,6577092,6577095,6577112,17,20,"SFIX",6577104,8
"392",3,90,3,116,238,6585988,6585991,6585995,4,7,"SFIX",6585999,-4
"393",3,125,2,117,260,6592038,6592041,6592046,5,8,"SFIX",6592047,-1
"394",3,136,1,118,436,6599153,6599156,6599164,8,11,"SFIX",6599162,2
"395",3,133,4,119,392,6606513,6606516,6606521,5,8,"SFIX",6606524,-3
"396",3,86,5,120,282,6612705,6612708,6612712,4,7,"SFIX",6612709,3
"397",3,26,5,121,249,6618353,6618357,6618363,6,10,"SFIX",6618361,2
"398",3,137,2,122,249,6629424,6629427,6629432,5,8,"SFIX",6629433,-1
"399",3,10,1,123,656,6636484,6636487,6636490,3,6,"SFIX",6636492,-2
"400",3,100,1,124,414,6647239,6647242,6647259,17,20,"SFIX",6647249,10
"401",3,99,6,125,194,6652680,6652683,6652690,7,10,"SFIX",6652689,1
"402",3,28,1,126,271,6660030,6660033,6660034,1,4,"SFIX",6660054,-20
"403",3,132,3,127,458,6672114,6672117,6672123,6,9,"SFIX",6672126,-3
"404",3,84,3,128,425,6678468,6678471,6678474,3,6,"SFIX",6678477,-3
"405",3,97,4,129,689,6687047,6687050,6687071,21,24,"SFIX",6687058,13
"406",3,31,4,130,315,6694546,6694549,6694569,20,23,"SFIX",6694561,8
"407",3,68,5,131,634,6708045,6708048,6708050,2,5,"SFIX",6708053,-3
"408",3,37,4,132,678,6715241,6715244,6715247,3,6,"SFIX",6715246,1
"409",3,116,5,133,414,6727136,6727140,6727143,3,7,"SFIX",6727150,-7
"410",3,2,5,134,359,6733652,6733655,6733661,6,9,"SFIX",6733663,-2
"411",3,119,2,135,502,6746048,6746051,6746070,19,22,"SFIX",6746058,12
"412",3,63,6,136,403,6751860,6751863,6751867,4,7,"SFIX",6751872,-5
"413",3,103,4,137,458,6759953,6759957,6759964,7,11,"SFIX",6759962,2
"414",3,82,1,138,436,6767705,6767708,6767728,20,23,"SFIX",6767710,18
"415",4,121,5,1,436,8108832,8108835,8108841,6,9,"SFIX",8108840,1
"416",4,30,4,2,315,8115022,8115026,8115032,6,10,"SFIX",8115029,3
"417",4,73,5,3,524,8126061,8126064,8126068,4,7,"SFIX",8126069,-1
"418",4,107,3,4,436,8133471,8133474,8133478,4,7,"SFIX",8133475,3
"419",4,113,3,5,513,8140247,8140250,8140256,6,9,"SFIX",8140250,6
"420",4,7,5,6,513,8146981,8146985,8146987,2,6,"SFIX",8146990,-3
"421",4,31,5,7,315,8159747,8159750,8159755,5,8,"SFIX",8159755,0
"422",4,86,6,8,282,8171729,8171732,8171738,6,9,"SFIX",8171740,-2
"423",4,81,1,9,700,8180498,8180501,8180508,7,10,"SFIX",8180513,-5
"424",4,101,3,10,359,8185879,8185882,8185886,4,7,"SFIX",8185888,-2
"425",4,104,6,11,601,8194088,8194092,8194096,4,8,"SFIX",8194104,-8
"426",4,21,1,12,656,8201479,8201482,8201487,5,8,"SFIX",8201490,-3
"427",4,13,5,13,271,8210065,8210068,8210070,2,5,"SFIX",8210074,-4
"428",4,82,2,14,436,8221234,8221237,8221239,2,5,"SFIX",8221246,-7
"429",4,109,5,15,381,8226402,8226405,8226411,6,9,"SFIX",8226405,6
"430",4,33,1,16,502,8235106,8235109,8235114,5,8,"SFIX",8235119,-5
"431",4,10,2,17,656,8246417,8246419,8246424,5,7,"SFIX",8246431,-7
"432",4,55,5,18,579,8255529,8255532,8255534,2,5,"SFIX",8255539,-5
"433",4,137,3,19,249,8260235,8260238,8260245,7,10,"SFIX",8260243,2
"434",4,72,4,20,337,8265784,8265787,8265790,3,6,"SFIX",8265795,-5
"435",4,67,5,21,414,8272188,8272191,8272194,3,6,"SFIX",8272194,0
"436",4,44,6,22,381,8278226,8278229,8278232,3,6,"SFIX",8278236,-4
"437",4,97,5,23,689,8288144,8288146,8288148,2,4,"EFIX",8288141,687
"438",4,34,2,24,425,8293651,8293653,8293660,7,9,"SFIX",8293659,1
"439",4,20,6,25,502,8305285,8305288,8305295,7,10,"SFIX",8305292,3
"440",4,94,2,26,293,8316144,8316147,8316151,4,7,"SFIX",8316156,-5
"441",4,87,1,27,524,8323632,8323635,8323642,7,10,"SFIX",8323647,-5
"442",4,61,5,28,513,8329984,8329987,8329993,6,9,"SFIX",8330002,-9
"443",4,43,5,29,216,8335742,8335745,8335751,6,9,"SFIX",8335750,1
"444",4,60,4,30,304,8348226,8348229,8348233,4,7,"SFIX",8348232,1
"445",4,59,3,31,249,8355827,8355831,8355837,6,10,"SFIX",8355837,0
"446",4,62,6,32,546,8364113,8364116,8364120,4,7,"SFIX",8364126,-6
"447",4,29,3,33,480,8370973,8370975,8370978,3,5,"SFIX",8370982,-4
"448",4,17,3,34,315,8379900,8379903,8379908,5,8,"SFIX",8379906,2
"449",4,132,4,35,458,8390093,8390096,8390104,8,11,"SFIX",8390106,-2
"450",4,93,1,36,502,8397292,8397295,8397301,6,9,"SFIX",8397301,0
"451",4,14,6,37,480,8403321,8403324,8403326,2,5,"SFIX",8403332,-6
"452",4,110,6,38,414,8413195,8413198,8413202,4,7,"EFIX",8413195,497
"453",4,42,4,39,480,8420374,8420377,8420380,3,6,"SFIX",8420380,0
"454",4,116,6,40,414,8430953,8430956,8430962,6,9,"SFIX",8430964,-2
"455",4,106,2,41,403,8437721,8437724,8437726,2,5,"SFIX",8437732,-6
"456",4,118,2,42,315,8443575,8443578,8443584,6,9,"SFIX",8443585,-1
"457",4,51,1,43,634,8450778,8450780,8450782,2,4,"SFIX",8450783,-1
"458",4,3,1,44,260,8458213,8458216,8458219,3,6,"SFIX",8458220,-1
"459",4,80,6,45,414,8467855,8467858,8467862,4,7,"SFIX",8467862,0
"460",4,27,1,46,304,8474001,8474003,8474006,3,5,"SFIX",8474003,3
"461",4,18,4,47,381,8483471,8483474,8483476,2,5,"SFIX",8483475,1
"462",4,74,6,48,315,8493200,8493203,8493206,3,6,"SFIX",8493206,0
"463",4,79,5,49,579,8500895,8500898,8500903,5,8,"SFIX",8500906,-3
"464",4,135,1,50,293,8506844,8506847,8506854,7,10,"SFIX",8506854,0
"465",4,19,5,51,359,8513351,8513354,8513359,5,8,"SFIX",8513361,-2
"466",4,124,2,52,513,8525116,8525119,8525121,2,5,"SFIX",8525124,-3
"467",4,102,4,53,557,8531299,8531302,8531305,3,6,"SFIX",8531307,-2
"468",4,127,5,54,513,8537047,8537050,8537057,7,10,"SFIX",8537053,4
"469",4,57,1,55,381,8542392,8542395,8542401,6,9,"SFIX",8542404,-3
"470",4,89,3,56,700,8549138,8549141,8549145,4,7,"EFIX",8549140,457
"471",4,16,2,57,502,8556264,8556267,8556270,3,6,"SFIX",8556274,-4
"472",4,36,4,58,392,8565432,8565435,8565439,4,7,"SFIX",8565442,-3
"473",4,83,3,59,491,8575164,8575167,8575169,2,5,"SFIX",8575172,-3
"474",4,76,2,60,458,8580823,8580826,8580834,8,11,"SFIX",8580834,0
"475",4,88,2,61,667,8588088,8588091,8588098,7,10,"SFIX",8588095,3
"476",4,128,6,62,282,8592414,8592430,8592436,6,22,"EFIX",8592384,539
"477",4,98,6,63,579,8601861,8601864,8601866,2,5,"SFIX",8601874,-8
"478",4,24,4,64,480,8608600,8608603,8608610,7,10,"SFIX",8608610,0
"479",4,75,1,65,249,8619209,8619211,8619213,2,4,"SFIX",8619220,-7
"480",4,6,4,66,502,8650877,8650881,8650888,7,11,"SFIX",8650887,1
"481",4,41,3,67,348,8660372,8660375,8660378,3,6,"SFIX",8660382,-4
"482",4,47,3,68,425,8670075,8670078,8670081,3,6,"SFIX",8670085,-4
"483",4,123,1,69,370,8680554,8680557,8680564,7,10,"EFIX",8680554,391
"484",4,26,6,70,249,8686750,8686754,8686761,7,11,"SFIX",8686757,4
"485",4,1,5,71,513,8697305,8697307,8697311,4,6,"SFIX",8697307,4
"486",4,8,6,72,612,8707646,8707649,8707654,5,8,"SFIX",8707660,-6
"487",4,28,2,73,271,8716384,8716387,8716390,3,6,"SFIX",8716391,-1
"488",4,11,3,74,293,8726198,8726202,8726207,5,9,"SFIX",8726206,1
"489",4,2,6,75,359,8735364,8735367,8735370,3,6,"SFIX",8735373,-3
"490",4,50,6,76,458,8745413,8745416,8745420,4,7,"SFIX",8745424,-4
"491",4,77,3,77,414,8755661,8755664,8755669,5,8,"SFIX",8755670,-1
"492",4,90,4,78,238,8760991,8760994,8761001,7,10,"SFIX",8760999,2
"493",4,134,6,79,348,8766972,8766974,8766979,5,7,"EFIX",8766973,389
"494",4,15,1,80,227,8773530,8773533,8773536,3,6,"SFIX",8773537,-1
"495",4,64,2,81,623,8782810,8782813,8782819,6,9,"SFIX",8782818,1
"496",4,131,3,82,447,8788186,8788189,8788191,2,5,"SFIX",8788196,-5
"497",4,52,2,83,370,8793054,8793057,8793062,5,8,"SFIX",8793065,-3
"498",4,92,6,84,546,8802749,8802752,8802759,7,10,"SFIX",8802760,-1
"499",4,9,1,85,667,8810081,8810084,8810089,5,8,"SFIX",8810087,2
"500",4,136,2,86,436,8818283,8818286,8818293,7,10,"SFIX",8818288,5
"501",4,63,1,87,403,8824819,8824822,8824824,2,5,"SFIX",8824825,-1
"502",4,71,3,88,403,NA,8830618,8830622,4,NA,"SFIX",8830620,2
"503",4,25,5,89,337,8836563,8836566,8836573,7,10,"SFIX",8836573,0
"504",4,5,3,90,480,8846107,8846110,8846116,6,9,"SFIX",8846118,-2
"505",4,65,3,91,502,8855482,8855485,8855493,8,11,"EFIX",8855476,485
"506",4,111,1,92,348,8861356,8861359,8861364,5,8,"SFIX",8861367,-3
"507",4,100,2,93,414,8867122,8867125,8867128,3,6,"SFIX",8867132,-4
"508",4,37,5,94,678,8872697,8872700,8872706,6,9,"SFIX",8872708,-2
"509",4,115,5,95,447,8881381,8881385,8881390,5,9,"SFIX",8881391,-1
"510",4,4,2,96,480,8887323,8887326,8887327,1,4,"SFIX",8887327,0
"511",4,39,1,97,436,8895785,8895788,8895791,3,6,"SFIX",8895793,-2
"512",4,130,2,98,535,8904821,8904824,8904828,4,7,"SFIX",8904829,-1
"513",4,103,5,99,458,8912319,8912322,8912325,3,6,"SFIX",8912322,3
"514",4,126,4,100,469,8919080,8919083,8919089,6,9,"SFIX",8919087,2
"515",4,99,1,101,194,8924953,8924957,8924960,3,7,"SFIX",8924965,-5
"516",4,48,4,102,282,8930139,8930142,8930145,3,6,"SFIX",8930146,-1
"517",4,108,4,103,326,8939367,8939370,8939375,5,8,"SFIX",8939371,4
"518",4,112,2,104,216,8945104,8945107,8945113,6,9,"SFIX",8945109,4
"519",4,38,6,105,447,8951623,8951626,8951631,5,8,"SFIX",8951633,-2
"520",4,32,6,106,370,8960814,8960817,8960820,3,6,"SFIX",8960819,1
"521",4,133,5,107,392,8971301,8971305,8971310,5,9,"SFIX",8971308,2
"522",4,105,1,108,315,8976891,8976894,8976901,7,10,"SFIX",8976903,-2
"523",4,45,1,109,469,8981978,8981981,8981986,5,8,"SFIX",8981999,-13
"524",4,23,3,110,370,8990701,8990704,8990709,5,8,"SFIX",8990709,0
"525",4,119,3,111,502,9000445,9000448,9000453,5,8,"SFIX",9000457,-4
"526",4,85,5,112,436,9007647,9007650,9007657,7,10,"SFIX",9007656,1
"527",4,22,2,113,557,9015270,9015273,9015280,7,10,"SFIX",9015283,-3
"528",4,54,4,114,535,9024738,9024741,9024744,3,6,"SFIX",9024752,-8
"529",4,46,2,115,271,9033804,9033807,9033814,7,10,"SFIX",9033815,-1
"530",4,84,4,116,425,9043331,9043334,9043337,3,6,"SFIX",9043336,1
"531",4,120,4,117,403,9049902,9049905,9049908,3,6,"SFIX",9049917,-9
"532",4,12,4,118,590,9055786,9055789,9055792,3,6,"EFIX",9055786,466
"533",4,66,4,119,524,9064392,9064395,9064402,7,10,"SFIX",9064400,2
"534",4,125,3,120,260,9069643,9069646,9069654,8,11,"SFIX",9069651,3
"535",4,96,4,121,359,9075382,9075385,9075392,7,10,"SFIX",9075390,2
"536",4,95,3,122,425,9081635,9081638,9081643,5,8,"SFIX",9081644,-1
"537",4,49,5,123,513,9088432,9088435,9088440,5,8,"SFIX",9088445,-5
"538",4,91,5,124,216,9097637,9097640,9097643,3,6,"SFIX",9097646,-3
"539",4,78,4,125,546,9105463,9105466,9105474,8,11,"SFIX",9105474,0
"540",4,117,1,126,337,9113603,9113606,9113624,18,21,"SFIX",9113612,12
"541",4,138,4,127,524,9120738,9120741,9120748,7,10,"SFIX",9120752,-4
"542",4,70,2,128,733,9126696,9126699,9126706,7,10,"SFIX",9126704,2
"543",4,53,3,129,326,9133562,9133565,9133570,5,8,"SFIX",9133571,-1
"544",4,122,6,130,403,9142293,9142296,9142300,4,7,"SFIX",9142305,-5
"545",4,69,1,131,381,9146810,9146813,9146819,6,9,"EFIX",9146812,440
"546",4,35,3,132,469,9152386,9152389,9152397,8,11,"SFIX",9152401,-4
"547",4,56,6,133,480,9161716,9161719,9161727,8,11,"SFIX",9161726,1
"548",4,114,4,134,271,9167720,9167723,9167731,8,11,"SFIX",9167735,-4
"549",4,58,2,135,403,9174704,9174707,9174708,1,4,"SFIX",9174709,-1
"550",4,68,6,136,634,9182331,9182334,9182353,19,22,"EFIX",9182331,412
"551",4,40,2,137,513,9189030,9189033,9189036,3,6,"SFIX",9189039,-3
"552",4,129,1,138,271,9197255,9197258,9197260,2,5,"SFIX",9197264,-4
