"","sub","cond","item","seq","start_time","end_time","duration_ms"
"10",1,2,128,1,428630,437564,8934
"11",1,2,80,2,439931,443558,3627
"12",1,3,45,3,446049,449467,3418
"14",1,4,52,4,454925,457964,3039
"16",1,4,16,5,463540,469710,6170
"18",1,1,85,6,475450,479678,4228
"19",1,2,62,7,482045,485803,3758
"20",1,1,7,8,488104,491352,3248
"22",1,3,15,9,498654,501320,2666
"24",1,3,3,10,507099,511667,4568
"26",1,2,98,11,517760,520700,2940
"27",1,5,101,12,523145,526949,3804
"28",1,2,26,13,529348,533034,3686
"30",1,6,54,14,538617,541355,2738
"32",1,5,107,15,547879,550820,2941
"33",1,5,47,16,553258,556382,3124
"35",1,2,2,17,561488,564644,3156
"37",1,5,59,18,570861,578331,7470
"38",1,2,44,19,580678,582796,2118
"40",1,3,105,20,587777,590999,3222
"41",1,4,58,21,593477,596097,2620
"42",1,6,102,22,598392,601516,3124
"43",1,6,126,23,603778,608699,4921
"44",1,5,23,24,610922,613307,2385
"46",1,1,25,25,619145,622190,3045
"48",1,1,49,26,627080,629334,2254
"50",1,5,131,27,635329,638106,2777
"51",1,5,53,28,640466,644205,3739
"53",1,5,95,29,649317,652708,3391
"54",1,3,69,30,655095,658748,3653
"55",1,5,11,31,661246,665605,4359
"57",1,3,123,32,673802,677475,3673
"58",1,3,117,33,679959,682050,2091
"59",1,2,32,34,684332,687881,3549
"61",1,2,104,35,694248,700555,6307
"62",1,6,66,36,702967,706562,3595
"63",1,6,60,37,708863,712660,3797
"64",1,3,135,38,715001,718066,3065
"65",1,6,42,39,720406,724079,3673
"67",1,6,138,40,729832,732616,2784
"68",1,2,134,41,734963,738224,3261
"69",1,3,129,42,740610,744296,3686
"70",1,5,83,43,746656,751460,4804
"71",1,2,110,44,753716,756081,2365
"72",1,4,40,45,758363,762689,4326
"74",1,5,71,46,768703,772625,3922
"75",1,4,76,47,775142,778645,3503
"76",1,2,122,48,780900,785050,4150
"77",1,4,118,49,787332,789528,2196
"78",1,4,100,50,791862,794561,2699
"79",1,1,37,51,796901,800097,3196
"81",1,5,17,52,806993,811719,4726
"83",1,1,61,53,816687,821131,4444
"84",1,4,4,54,823583,825942,2359
"86",1,4,64,55,831498,836119,4621
"87",1,4,22,56,838505,841472,2967
"89",1,4,88,57,846878,850440,3562
"90",1,5,125,58,852938,856042,3104
"91",1,5,89,59,858408,866291,7883
"92",1,6,36,60,868585,871520,2935
"94",1,3,33,61,877625,882141,4516
"96",1,1,19,62,888620,892234,3614
"98",1,5,65,63,898228,903182,4954
"99",1,2,92,64,905575,909607,4032
"100",1,5,41,65,912013,914385,2372
"102",1,1,121,66,946662,950205,3543
"103",1,4,28,67,952807,956244,3437
"105",1,4,70,68,962964,967474,4510
"106",1,1,109,69,969755,973284,3529
"107",1,3,39,70,975599,978396,2797
"109",1,2,14,71,983436,986272,2836
"111",1,4,112,72,992182,994750,2568
"112",1,3,87,73,998208,1002064,3856
"113",1,6,48,74,1004464,1006738,2274
"115",1,1,13,75,1013765,1016941,3176
"117",1,5,119,76,1021837,1029478,7641
"118",1,4,136,77,1031916,1035955,4039
"119",1,1,67,78,1038283,1040844,2561
"120",1,1,133,79,1043198,1045720,2522
"121",1,3,93,80,1048342,1051871,3529
"122",1,3,51,81,1054264,1057519,3255
"124",1,5,113,82,1062676,1066441,3765
"125",1,6,114,83,1068860,1073892,5032
"126",1,2,20,84,1076200,1079246,3046
"128",1,4,82,85,1085521,1088475,2954
"129",1,5,35,86,1090979,1093619,2640
"131",1,1,55,87,1100169,1103110,2941
"132",1,2,38,88,1105444,1107672,2228
"134",1,5,137,89,1112837,1116281,3444
"135",1,1,43,90,1118602,1121176,2574
"137",1,4,124,91,1125811,1128759,2948
"138",1,2,68,92,1131361,1134334,2973
"139",1,1,73,93,1136694,1143380,6686
"140",1,6,90,94,1145871,1148766,2895
"141",1,3,9,95,1151571,1154760,3189
"143",1,2,56,96,1160343,1164179,3836
"144",1,4,34,97,1166781,1170127,3346
"146",1,3,75,98,1177488,1181285,3797
"147",1,1,115,99,1183527,1187540,4013
"148",1,4,94,100,1190116,1193900,3784
"149",1,5,5,101,1196038,1202319,6281
"151",1,3,57,102,1208340,1211790,3450
"152",1,6,120,103,1214248,1218908,4660
"153",1,6,24,104,1221210,1225137,3927
"155",1,5,29,105,1233433,1238020,4587
"157",1,3,27,106,1243191,1245433,2242
"159",1,6,78,107,1251093,1253414,2321
"160",1,6,30,108,1255820,1258989,3169
"162",1,1,79,109,1263833,1266637,2804
"163",1,3,21,110,1270259,1275703,5444
"165",1,6,18,111,1281331,1284906,3575
"167",1,6,108,112,1290770,1293978,3208
"168",1,2,74,113,1296306,1301881,5575
"169",1,4,46,114,1304130,1309542,5412
"171",1,6,132,115,1315360,1319170,3810
"172",1,1,97,116,1321464,1325582,4118
"173",1,1,103,117,1328060,1331582,3522
"174",1,4,130,118,1333831,1336387,2556
"175",1,3,99,119,1338511,1344184,5673
"176",1,1,31,120,1346649,1349505,2856
"178",1,6,6,121,1354231,1358218,3987
"180",1,2,116,122,1363559,1369225,5666
"181",1,2,50,123,1373069,1377186,4117
"183",1,6,72,124,1381972,1385912,3940
"184",1,5,77,125,1388129,1391076,2947
"185",1,6,84,126,1393450,1397966,4516
"186",1,4,10,127,1400241,1403149,2908
"188",1,3,111,128,1409895,1414986,5091
"189",1,1,127,129,1417327,1420287,2960
"190",1,4,106,130,1423471,1426915,3444
"191",1,3,81,131,1429125,1431876,2751
"192",1,3,63,132,1434145,1436569,2424
"193",1,2,8,133,1438740,1441864,3124
"195",1,1,1,134,1448571,1454348,5777
"197",1,6,12,135,1463768,1468748,4980
"199",1,6,96,136,1475050,1478827,3777
"200",1,1,91,137,1482625,1486651,4026
"201",1,2,86,138,1488874,1492946,4072
"101",2,4,57,1,2700666,2704718,4052
"1110",2,5,136,2,2707294,2710829,3535
"123",2,3,20,3,2713360,2716215,2855
"1410",2,3,38,4,2721380,2724340,2960
"164",2,1,6,5,2729151,2734785,5634
"1810",2,6,17,6,2740198,2744930,4732
"202",2,5,70,7,2749918,2754349,4431
"21",2,2,55,8,2756598,2759663,3065
"221",2,3,86,9,2761768,2768212,6444
"23",2,3,122,10,2770350,2775847,5497
"241",2,4,39,11,2778213,2782645,4432
"261",2,6,101,12,2787796,2791887,4091
"271",2,2,115,13,2794587,2797914,3327
"281",2,5,130,14,2800045,2805829,5784
"29",2,4,33,15,2807947,2813908,5961
"31",2,5,124,16,2820092,2825098,5006
"321",2,5,64,17,2827262,2833569,6307
"331",2,3,50,18,2836139,2839988,3849
"351",2,6,35,19,2845087,2849106,4019
"371",2,2,37,20,2854670,2859761,5091
"39",2,5,58,21,2865847,2870873,5026
"401",2,2,25,22,2873298,2878082,4784
"421",2,3,26,23,2883613,2890514,6901
"441",2,4,27,24,2896228,2901574,5346
"461",2,4,75,25,2906758,2913660,6902
"47",2,3,80,26,2915863,2921085,5222
"481",2,1,72,27,2923471,2929001,5530
"49",2,4,21,28,2931184,2937531,6347
"511",2,3,98,29,2944662,2957552,12890
"52",2,6,65,30,2959696,2965728,6032
"531",2,2,31,31,2968638,2973984,5346
"551",2,3,116,32,2979076,2983945,4869
"56",2,1,30,33,2986659,2990083,3424
"581",2,2,73,34,2995659,3000496,4837
"591",2,4,81,35,3002725,3007496,4771
"60",2,5,4,36,3010262,3016111,5849
"621",2,5,112,37,3021596,3026641,5045
"631",2,5,82,38,3028799,3034027,5228
"641",2,1,60,39,3036335,3042243,5908
"651",2,2,79,40,3044715,3050996,6281
"66",2,6,71,41,3053310,3060414,7104
"671",2,3,68,42,3062827,3067905,5078
"681",2,3,32,43,3070311,3075795,5484
"701",2,3,104,44,3081822,3089547,7725
"711",2,6,107,45,3091999,3097986,5987
"721",2,1,66,46,3100339,3103770,3431
"73",2,3,8,47,3105902,3111241,5339
"751",2,1,18,48,3116308,3119366,3058
"771",2,1,114,49,3123740,3128491,4751
"781",2,4,117,50,3130577,3133328,2751
"791",2,2,121,51,3135858,3140191,4333
"80",2,6,131,52,3142486,3148113,5627
"811",2,6,119,53,3150480,3156002,5522
"82",2,6,29,54,3158415,3164964,6549
"841",2,1,42,55,3172037,3177906,5869
"861",2,4,111,56,3183874,3188789,4915
"871",2,5,118,57,3191267,3195129,3862
"88",2,1,12,58,3197457,3203025,5568
"901",2,4,69,59,3207908,3211503,3595
"911",2,3,44,60,3213608,3219327,5719
"93",2,1,36,61,3224812,3227968,3156
"95",2,5,22,62,3233158,3240263,7105
"97",2,5,46,63,3245244,3250381,5137
"991",2,5,76,64,3255716,3260898,5182
"1001",2,4,9,65,3263415,3271736,8321
"1021",2,1,138,66,3302300,3305463,3163
"1031",2,3,14,67,3307817,3314948,7131
"1051",2,6,95,68,3322295,3329040,6745
"1061",2,2,19,69,3331525,3335655,4130
"108",2,5,34,70,3344558,3348695,4137
"110",2,4,15,71,3353702,3357937,4235
"1121",2,4,3,72,3363063,3366598,3535
"114",2,6,59,73,3371128,3378573,7445
"1151",2,3,74,74,3380796,3387188,6392
"116",2,5,10,75,3389607,3394548,4941
"1181",2,5,106,76,3400830,3404261,3431
"1191",2,2,133,77,3406647,3411398,4751
"1201",2,1,54,78,3413608,3417621,4013
"1221",2,6,11,79,3423805,3427609,3804
"1241",2,2,13,80,3432505,3439446,6941
"1261",2,4,105,81,3445218,3449388,4170
"127",2,3,128,82,3453951,3461578,7627
"1281",2,1,132,83,3463677,3467709,4032
"1291",2,2,127,84,3469900,3473468,3568
"130",2,4,123,85,3476057,3482495,6438
"1311",2,3,92,86,3484855,3494443,9588
"1321",2,4,63,87,3496888,3501823,4935
"133",2,6,53,88,3504176,3511242,7066
"1351",2,5,52,89,3516262,3521203,4941
"1371",2,1,96,90,3525845,3530204,4359
"1381",2,5,40,91,3532427,3537557,5130
"1401",2,6,83,92,3543918,3549244,5326
"1411",2,1,84,93,3551533,3557676,6143
"142",2,3,56,94,3559893,3565435,5542
"1431",2,3,110,95,3567972,3574030,6058
"1441",2,4,93,96,3576743,3580227,3484
"145",2,5,100,97,3582639,3587149,4510
"1461",2,2,1,98,3589712,3594659,4947
"1481",2,3,62,99,3600810,3606849,6039
"1491",2,2,109,100,3609105,3613869,4764
"150",2,2,103,101,3617079,3621700,4621
"1511",2,1,90,102,3623936,3630799,6863
"1521",2,1,48,103,3633218,3636093,2875
"154",2,6,23,104,3641630,3648630,7000
"156",2,5,16,105,3653317,3659918,6601
"158",2,6,5,106,3665161,3671128,5967
"1601",2,4,87,107,3677103,3682416,5313
"161",2,6,125,108,3684979,3690593,5614
"1621",2,1,126,109,3692790,3698444,5654
"1631",2,6,41,110,3700915,3706405,5490
"1651",2,1,24,111,3711602,3716379,4777
"1671",2,1,78,112,3722413,3725302,2889
"1681",2,1,102,113,3727936,3730642,2706
"1691",2,1,120,114,3733067,3736119,3052
"170",2,3,2,115,3738558,3744146,5588
"1721",2,4,51,116,3749670,3754768,5098
"1741",2,3,134,117,3760102,3766049,5947
"1751",2,6,137,118,3768377,3773377,5000
"1761",2,1,108,119,3776123,3782626,6503
"177",2,6,113,120,3785182,3790496,5314
"1781",2,4,99,121,3792640,3798581,5941
"179",2,5,28,122,3801157,3804915,3758
"1811",2,4,129,123,3809929,3815386,5457
"182",2,4,135,124,3817844,3822105,4261
"1831",2,6,77,125,3825113,3828243,3130
"1841",2,2,61,126,3830446,3834864,4418
"1851",2,5,88,127,3837251,3843035,5784
"1861",2,2,91,128,3845715,3850035,4320
"187",2,6,47,129,3852258,3855441,3183
"1891",2,2,49,130,3860220,3864880,4660
"1911",2,4,45,131,3869201,3873383,4182
"1931",2,2,85,132,3878777,3884946,6169
"194",2,2,43,133,3887241,3892273,5032
"196",2,2,97,134,3897837,3901457,3620
"1971",2,2,67,135,3903608,3906810,3202
"198",2,2,7,136,3909478,3915314,5836
"2001",2,6,89,137,3922054,3926576,4522
"2011",2,5,94,138,3928989,3935486,6497
"104",3,4,116,1,5013296,5017224,3928
"1111",3,4,20,2,5019826,5023414,3588
"13",3,2,102,3,5030794,5033820,3026
"1412",3,4,110,4,5036206,5039480,3274
"15",3,1,17,5,5041782,5045344,3562
"17",3,2,138,6,5050763,5053678,2915
"1812",3,4,68,7,5055966,5059763,3797
"1910",3,5,51,8,5062090,5065901,3811
"211",3,6,82,9,5070790,5073744,2954
"222",3,1,53,10,5076046,5079999,3953
"242",3,2,72,11,5085759,5088366,2607
"25",3,3,133,12,5090870,5094262,3392
"262",3,6,16,13,5096792,5100811,4019
"282",3,1,107,14,5106303,5109903,3600
"291",3,1,131,15,5112146,5114740,2594
"301",3,4,8,16,5117218,5121277,4059
"322",3,4,80,17,5127003,5130964,3961
"332",3,6,70,18,5133258,5136840,3582
"34",3,1,113,19,5139285,5142781,3496
"352",3,6,58,20,5145018,5148867,3849
"36",3,2,6,21,5151868,5155488,3620
"381",3,2,114,22,5160711,5164136,3425
"391",3,3,31,23,5166882,5170986,4104
"411",3,4,98,24,5177222,5181660,4438
"422",3,1,83,25,5184014,5187516,3502
"431",3,4,44,26,5189857,5192530,2673
"45",3,6,10,27,5197479,5201223,3744
"471",3,4,56,28,5206989,5210786,3797
"482",3,3,1,29,5213087,5216348,3261
"501",3,5,45,30,5221519,5224793,3274
"521",3,5,69,31,5229513,5232415,2902
"532",3,5,3,32,5234801,5238095,3294
"552",3,4,92,33,5243344,5247435,4091
"561",3,3,25,34,5250018,5253501,3483
"582",3,2,90,35,5258705,5261547,2842
"592",3,4,86,36,5264777,5267548,2771
"601",3,1,119,37,5269895,5273293,3398
"611",3,1,71,38,5275758,5278509,2751
"622",3,2,24,39,5280883,5283941,3058
"642",3,3,127,40,5289524,5293157,3633
"652",3,6,88,41,5295681,5299334,3653
"661",3,5,57,42,5301858,5305034,3176
"672",3,2,12,43,5307597,5310812,3215
"691",3,6,46,44,5315911,5319845,3934
"712",3,6,64,45,5325912,5329964,4052
"722",3,3,61,46,5332481,5335905,3424
"731",3,1,29,47,5338606,5342801,4195
"752",3,3,67,48,5348292,5351266,2974
"761",3,4,74,49,5353737,5356430,2693
"772",3,2,42,50,5358809,5361456,2647
"792",3,3,73,51,5366921,5370483,3562
"801",3,5,21,52,5372765,5376307,3542
"821",3,6,4,53,5381634,5384549,2915
"842",3,1,23,54,5389648,5392484,2836
"862",3,2,66,55,5397250,5399864,2614
"872",3,2,78,56,5402152,5405021,2869
"881",3,5,9,57,5407407,5410021,2614
"902",3,1,137,58,5415068,5418257,3189
"912",3,1,47,59,5420519,5423369,2850
"931",3,1,65,60,5428272,5431356,3084
"941",3,2,126,61,5433939,5436912,2973
"951",3,1,11,62,5439207,5442122,2915
"971",3,3,55,63,5447600,5449946,2346
"981",3,5,111,64,5452286,5454763,2477
"992",3,2,96,65,5457117,5460247,3130
"1002",3,4,2,66,5488550,5491824,3274
"1022",3,5,129,67,5497172,5500596,3424
"1032",3,6,52,68,5503100,5506394,3294
"1052",3,5,105,69,5511565,5514976,3411
"1062",3,3,121,70,5517238,5521231,3993
"1071",3,1,41,71,5523631,5526291,2660
"1091",3,4,26,72,5531599,5534474,2875
"1112",3,3,7,73,5539822,5543671,3849
"1131",3,5,39,74,5548835,5551351,2516
"1152",3,5,75,75,5556404,5558907,2503
"1161",3,3,19,76,5561169,5564064,2895
"1182",3,3,43,77,5570379,5573241,2862
"1202",3,1,5,78,5578000,5580615,2615
"1222",3,1,125,79,5586432,5588478,2046
"1231",3,6,106,80,5590760,5593818,3058
"1242",3,4,62,81,5596544,5599871,3327
"1251",3,6,28,82,5602303,5604969,2666
"1271",3,2,48,83,5611205,5613270,2065
"1292",3,6,22,84,5618284,5621441,3157
"1312",3,1,59,85,5626546,5629409,2863
"1322",3,4,122,86,5631906,5635147,3241
"1331",3,5,33,87,5637789,5640749,2960
"1352",3,5,99,88,5646155,5649776,3621
"136",3,2,54,89,5652221,5655391,3170
"1382",3,3,13,90,5660294,5662992,2698
"1402",3,5,117,91,5667719,5669888,2169
"1413",3,4,128,92,5672105,5674987,2882
"1421",3,4,32,93,5677249,5680131,2882
"1442",3,4,14,94,5685452,5688216,2764
"1462",3,5,135,95,5693989,5696688,2699
"1471",3,6,100,96,5699113,5701727,2614
"1482",3,6,136,97,5704153,5707250,3097
"1492",3,4,134,98,5709571,5712656,3085
"1501",3,5,123,99,5715448,5718362,2914
"1512",3,2,120,100,5720683,5722800,2117
"1522",3,2,18,101,5725174,5727337,2163
"1541",3,3,109,102,5733043,5735690,2647
"1551",3,6,124,103,5738129,5740893,2764
"1561",3,2,60,104,5743129,5745782,2653
"1571",3,3,79,105,5748352,5750776,2424
"1581",3,4,38,106,5753110,5755522,2412
"1602",3,5,87,107,5760738,5763614,2876
"1611",3,1,89,108,5767477,5770379,2902
"1622",3,6,94,109,5772811,5775608,2797
"1632",3,2,84,110,5778197,5780530,2333
"1641",3,6,34,111,5783086,5785582,2496
"166",3,3,49,112,5792015,5795224,3209
"1682",3,4,104,113,5800009,5802884,2875
"1692",3,1,95,114,5805414,5808519,3105
"1701",3,5,81,115,5810944,5814029,3085
"1711",3,2,108,116,5816317,5819604,3287
"1722",3,6,76,117,5822200,5825226,3026
"1731",3,1,77,118,5827540,5830415,2875
"1742",3,3,115,119,5832821,5835448,2627
"1752",3,6,118,120,5837848,5840213,2365
"1762",3,4,50,121,5842462,5845286,2824
"1782",3,3,97,122,5850953,5853136,2183
"1791",3,1,101,123,5855476,5857862,2386
"1801",3,2,30,124,5860274,5862607,2333
"1821",3,3,37,125,5867582,5869503,1921
"1842",3,2,36,126,5874393,5876445,2052
"1862",3,1,35,127,5881589,5883935,2346
"1881",3,3,85,128,5889675,5892759,3084
"1892",3,6,40,129,5895303,5897982,2679
"1912",3,6,112,130,5903610,5906022,2412
"1921",3,5,27,131,5908526,5911369,2843
"1941",3,6,130,132,5916683,5919447,2764
"1951",3,5,63,133,5921664,5923729,2065
"1961",3,5,93,134,5925984,5928572,2588
"1972",3,3,91,135,5930965,5933912,2947
"1981",3,5,15,136,5936181,5938619,2438
"2002",3,2,132,137,5943829,5946462,2633
"2012",3,3,103,138,5949012,5951090,2078
"1010",4,3,30,1,8523573,8528841,5268
"1210",4,1,100,2,8536750,8543646,6896
"1310",4,2,137,3,8546359,8552058,5699
"1414",4,6,117,4,8555019,8557810,2791
"1510",4,4,31,5,8560693,8565601,4908
"1710",4,5,8,6,8574799,8580086,5287
"1913",4,5,26,7,8596074,8601028,4954
"212",4,5,2,8,8610396,8614088,3692
"231",4,1,46,9,8621560,8626226,4666
"251",4,4,97,10,8634044,8638462,4418
"263",4,6,21,11,8641313,8644842,3529
"283",4,4,121,12,8650791,8655882,5091
"292",4,4,127,13,8658758,8661666,2908
"302",4,3,84,14,8664255,8669281,5026
"311",4,1,16,15,8671877,8675935,4058
"333",4,5,92,16,8681394,8685478,4084
"341",4,1,4,17,8688185,8694074,5889
"361",4,1,22,18,8699774,8706748,6974
"382",4,2,125,19,8712402,8715199,2797
"392",4,5,32,20,8717671,8721265,3594
"412",4,5,74,21,8726861,8729246,2385
"423",4,3,42,22,8733803,8737443,3640
"442",4,2,5,23,8747621,8751071,3450
"462",4,5,80,24,8759870,8763307,3437
"472",4,1,40,25,8765720,8768896,3176
"491",4,3,72,26,8777760,8780053,2293
"502",4,1,136,27,8782923,8786257,3334
"512",4,4,67,28,8797114,8800395,3281
"522",4,4,91,29,8808605,8812239,3634
"533",4,4,73,30,8835260,8839286,4026
"541",4,6,75,31,8841816,8845711,3895
"553",4,1,70,32,8848431,8852934,4503
"562",4,5,110,33,8855203,8858634,3431
"571",4,6,27,34,8862014,8864896,2882
"593",4,6,105,35,8872099,8874942,2843
"602",4,6,3,36,8877498,8880544,3046
"623",4,3,6,37,8888264,8891564,3300
"643",4,4,19,38,8897055,8900532,3477
"662",4,4,85,39,8909069,8912572,3503
"673",4,5,122,40,8914978,8917311,2333
"682",4,1,88,41,8925665,8928410,2745
"692",4,5,98,42,8931038,8934090,3052
"702",4,5,38,43,8936555,8939613,3058
"723",4,6,93,44,8945013,8947868,2855
"732",4,5,68,45,8950373,8953823,3450
"741",4,1,52,46,8956360,8958856,2496
"762",4,2,77,47,8964609,8969399,4790
"773",4,1,94,48,8973100,8976596,3496
"782",4,5,134,49,8979139,8982524,3385
"793",4,6,123,50,8985107,8988950,3843
"802",4,4,13,51,8991630,8997166,5536
"822",4,4,61,52,9001997,9005644,3647
"831",4,1,28,53,9009435,9012265,2830
"85",4,4,115,54,9018978,9022677,3699
"863",4,4,43,55,9025299,9027776,2477
"882",4,6,15,56,9036078,9039227,3149
"903",4,1,58,57,9082924,9085767,2843
"913",4,3,18,58,9088009,9090780,2771
"932",4,3,114,59,9099631,9104631,5000
"942",4,4,1,60,9109285,9114899,5614
"961",4,5,20,61,9162968,9164948,1980
"982",4,5,86,62,9175120,9177465,2345
"993",4,4,7,63,9179682,9182780,3098
"1011",4,2,95,64,9189316,9193421,4105
"1023",4,4,79,65,9195899,9199683,3784
"1033",4,1,76,66,9214593,9219141,4548
"1041",4,5,50,67,9225057,9227730,2673
"1063",4,2,83,68,9232509,9235345,2836
"1072",4,6,51,69,9239908,9242163,2255
"1092",4,3,36,70,9248791,9253281,4490
"1113",4,1,106,71,9260995,9263138,2143
"1122",4,6,69,72,9265609,9268524,2915
"1132",4,4,49,73,9270936,9273982,3046
"1153",4,4,103,74,9279035,9282577,3542
"1162",4,6,111,75,9285447,9288362,2915
"1171",4,3,12,76,9291121,9294290,3169
"1192",4,2,11,77,9306919,9309638,2719
"1211",4,6,129,78,9315501,9318802,3301
"1223",4,3,96,79,9322293,9325828,3535
"1232",4,2,53,80,9329960,9334332,4372
"1252",4,3,54,81,9341333,9344914,3581
"1272",4,4,109,82,9350347,9353444,3097
"1282",4,3,60,83,9355622,9358392,2770
"1293",4,3,108,84,9362648,9365530,2882
"1301",4,4,37,85,9376375,9378256,1881
"1323",4,1,64,86,9392454,9395434,2980
"1332",4,4,25,87,9412299,9415037,2738
"1353",4,5,104,88,9419815,9422096,2281
"1361",4,3,66,89,9424613,9428208,3595
"1372",4,6,87,90,9430529,9432691,2162
"1383",4,2,89,91,9435385,9438738,3353
"1391",4,2,65,92,9442091,9443908,1817
"1403",4,1,112,93,9446124,9449196,3072
"1415",4,5,44,94,9451759,9454033,2274
"1432",4,6,57,95,9460589,9463452,2863
"1443",4,2,35,96,9466407,9469406,2999
"1463",4,6,33,97,9477636,9480132,2496
"1483",4,5,128,98,9485571,9488839,3268
"1493",4,2,113,99,9491154,9493395,2241
"1502",4,1,124,100,9496520,9500082,3562
"1513",4,2,41,101,9502435,9506441,4006
"1531",4,6,135,102,9511828,9515383,3555
"1542",4,3,90,103,9518038,9520031,1993
"1552",4,2,131,104,9522613,9525508,2895
"1562",4,3,126,105,9527862,9529927,2065
"1572",4,3,102,106,9532385,9534123,1738
"1582",4,1,34,107,9536490,9538463,1973
"1603",4,3,138,108,9543895,9546104,2209
"1612",4,6,39,109,9548647,9550921,2274
"1633",4,3,48,110,9556020,9558190,2170
"1652",4,1,130,111,9564439,9566766,2327
"1661",4,6,45,112,9569270,9571642,2372
"1683",4,2,17,113,9577205,9581826,4621
"1702",4,5,56,114,9587428,9590199,2771
"1712",4,3,120,115,9592507,9595591,3084
"1723",4,6,99,116,9597925,9600938,3013
"1732",4,2,59,117,9603363,9605847,2484
"1743",4,4,55,118,9609488,9611344,1856
"1753",4,2,29,119,9613913,9616083,2170
"1771",4,2,71,120,9622149,9624560,2411
"1783",4,6,63,121,9627280,9629874,2594
"1792",4,1,118,122,9632418,9635247,2829
"1802",4,4,133,123,9637673,9640751,3078
"1813",4,5,14,124,9643137,9646117,2980
"1832",4,6,9,125,9651615,9654334,2719
"1852",4,3,132,126,9659923,9663354,3431
"1863",4,6,81,127,9666159,9669223,3064
"1871",4,2,119,128,9671675,9675178,3503
"1882",4,3,78,129,9677519,9680035,2516
"1893",4,2,101,130,9682205,9684970,2765
"1901",4,2,47,131,9687598,9689761,2163
"1922",4,5,62,132,9696102,9698356,2254
"1932",4,2,23,133,9700867,9703017,2150
"1952",4,1,10,134,9708377,9711030,2653
"1973",4,3,24,135,9716103,9721410,5307
"1991",4,2,107,136,9727842,9730685,2843
"2003",4,1,82,137,9733026,9735136,2110
"2013",4,5,116,138,9738059,9740575,2516
"1012",5,3,113,1,7425993,7429933,3940
"1114",5,4,102,2,7433693,7437261,3568
"1212",5,1,135,3,7444791,7451608,6817
"1313",5,1,69,4,7455158,7459007,3849
"1416",5,5,61,5,7463002,7468047,5045
"1514",5,2,10,6,7475493,7479041,3548
"1713",5,2,100,7,7485356,7489415,4059
"1814",5,3,125,8,7492925,7496977,4052
"1914",5,2,22,9,7500664,7504585,3921
"213",5,5,7,10,7511645,7515383,3738
"232",5,5,109,11,7522358,7528835,6477
"243",5,3,53,12,7531313,7535156,3843
"264",5,6,98,13,7542327,7547529,5202
"272",5,2,28,14,7550099,7554020,3921
"293",5,6,116,15,7559766,7567243,7477
"303",5,6,44,16,7571976,7576773,4797
"323",5,3,41,17,7583173,7587068,3895
"342",5,4,60,18,7592487,7597180,4693
"353",5,1,117,19,7600795,7603814,3019
"362",5,4,72,20,7606554,7610200,3646
"372",5,1,33,21,7612587,7617684,5097
"393",5,6,128,22,7624646,7630267,5621
"402",5,2,136,23,7632758,7637411,4653
"413",5,4,108,24,7640307,7644503,4196
"424",5,3,65,25,7647713,7651739,4026
"432",5,5,127,26,7654184,7658132,3948
"443",5,5,55,27,7662466,7665890,3424
"451",5,6,8,28,7668715,7673394,4679
"473",5,4,36,29,7679134,7682643,3509
"492",5,4,66,30,7689383,7692258,2875
"503",5,5,25,31,7694919,7698056,3137
"523",5,2,16,32,7705403,7709253,3850
"542",5,1,27,33,7715391,7718286,2895
"563",5,5,43,34,7723110,7726731,3621
"583",5,6,134,35,7731928,7736163,4235
"594",5,1,87,36,7739536,7746013,6477
"603",5,3,47,37,7748360,7751948,3588
"624",5,2,76,38,7756845,7760910,4065
"632",5,2,130,39,7763388,7768270,4882
"644",5,2,58,40,7770748,7775257,4509
"653",5,2,64,41,7777911,7785650,7739
"663",5,5,97,42,7790651,7796468,5817
"674",5,1,15,43,7800259,7803246,2987
"693",5,3,89,44,7809201,7813534,4333
"703",5,2,4,45,7819842,7823169,3327
"724",5,4,24,46,7830170,7834575,4405
"742",5,5,91,47,7840589,7845510,4921
"753",5,6,110,48,7848916,7852779,3863
"763",5,4,84,49,7855492,7862367,6875
"774",5,6,26,50,7865146,7869812,4666
"794",5,6,38,51,7876212,7880042,3830
"812",5,6,86,52,7885644,7888428,2784
"823",5,3,29,53,7891533,7896768,5235
"843",5,2,106,54,7904201,7908939,4738
"851",5,3,83,55,7913731,7917979,4248
"864",5,3,11,56,7920457,7925476,5019
"883",5,6,92,57,7931320,7938059,6739
"891",5,5,85,58,7940981,7945105,4124
"904",5,4,18,59,7948714,7952942,4228
"921",5,2,88,60,7958884,7963616,4732
"933",5,2,124,61,7966251,7970296,4045
"943",5,6,56,62,7975264,7981251,5987
"952",5,4,12,63,7987932,7992285,4353
"972",5,6,50,64,7999063,8004409,5346
"994",5,6,62,65,8009613,8015031,5418
"1003",5,3,17,66,8052289,8056531,4242
"1024",5,1,57,67,8062499,8066002,3503
"1034",5,4,96,68,8068434,8072839,4405
"1042",5,5,13,69,8075480,8079905,4425
"1064",5,3,95,70,8084945,8089258,4313
"1073",5,3,71,71,8091821,8095435,3614
"1081",5,1,39,72,8097992,8101651,3659
"1101",5,1,21,73,8107025,8112665,5640
"1123",5,3,5,74,8118777,8121953,3176
"1141",5,3,131,75,8128092,8132255,4163
"1154",5,4,114,76,8134831,8141713,6882
"1163",5,4,132,77,8144524,8149759,5235
"1172",5,2,82,78,8152335,8156805,4470
"1183",5,1,3,79,8159355,8164982,5627
"1203",5,5,37,80,8170304,8175127,4823
"1224",5,5,133,81,8180729,8183885,3156
"1233",5,4,6,82,8186475,8192167,5692
"1253",5,1,45,83,8197848,8202351,4503
"1273",5,5,49,84,8208208,8212057,3849
"1294",5,4,120,85,8216973,8219809,2836
"1302",5,6,74,86,8222738,8229379,6641
"1314",5,1,63,87,8232386,8237817,5431
"1324",5,1,129,88,8240661,8244504,3843
"1333",5,5,1,89,8246930,8251256,4326
"1354",5,3,77,90,8256616,8260472,3856
"1362",5,1,99,91,8263205,8266218,3013
"1373",5,5,31,92,8268911,8276839,7928
"1392",5,3,137,93,8282899,8285892,2993
"1404",5,6,122,94,8289501,8294527,5026
"1417",5,5,67,95,8297279,8301194,3915
"1422",5,1,81,96,8303744,8308757,5013
"1433",5,2,70,97,8311699,8317077,5378
"1444",5,3,107,98,8320202,8325013,4811
"1451",5,6,14,99,8329719,8337576,7857
"1472",5,1,111,100,8348446,8353681,5235
"1484",5,4,30,101,8356394,8359721,3327
"1503",5,4,48,102,8365042,8367512,2470
"1523",5,5,79,103,8372703,8375938,3235
"1532",5,4,54,104,8378729,8382670,3941
"1553",5,5,121,105,8389972,8396893,6921
"1563",5,6,80,106,8399548,8403351,3803
"1573",5,6,68,107,8406012,8409495,3483
"1583",5,3,23,108,8412254,8415633,3379
"1604",5,2,94,109,8420882,8428131,7249
"1613",5,1,9,110,8430693,8434771,4078
"1634",5,4,42,111,8440067,8444896,4829
"1653",5,6,104,112,8452799,8458263,5464
"1662",5,6,20,113,8460807,8467597,6790
"1684",5,2,112,114,8474324,8479572,5248
"1693",5,3,35,115,8482200,8485435,3235
"1714",5,5,73,116,8491429,8494279,2850
"1724",5,5,19,117,8496822,8499024,2202
"1744",5,6,2,118,8510973,8515293,4320
"1763",5,1,75,119,8521876,8531039,9163
"1772",5,3,119,120,8533877,8538909,5032
"1784",5,3,101,121,8542766,8548635,5869
"1793",5,4,90,122,8551747,8557623,5876
"1803",5,2,46,123,8560166,8564427,4261
"1822",5,5,103,124,8572036,8579860,7824
"1833",5,2,52,125,8582488,8586605,4117
"1853",5,1,51,126,8592266,8595645,3379
"1872",5,2,118,127,8601365,8605299,3934
"1883",5,2,34,128,8607810,8611430,3620
"1902",5,1,105,129,8618549,8621993,3444
"1915",5,4,78,130,8624425,8628007,3582
"1923",5,1,123,131,8630903,8637890,6987
"1933",5,6,32,132,8641263,8644511,3248
"1953",5,5,115,133,8650662,8654348,3686
"1962",5,4,126,134,8656937,8663545,6608
"1974",5,2,40,135,8665925,8672899,6974
"1992",5,4,138,136,8679331,8684265,4934
"2004",5,3,59,137,8686730,8690978,4248
"2014",5,1,93,138,8693384,8697587,4203
"1013",6,3,94,1,9977332,9979920,2588
"1115",6,1,104,2,9986163,9988489,2326
"1213",6,6,61,3,9990804,9992490,1686
"1315",6,4,65,4,9994732,9997026,2294
"1418",6,3,46,5,9999367,10001863,2496
"1610",6,5,132,6,10007550,10009824,2274
"1715",6,3,124,7,10012557,10014262,1705
"1815",6,4,17,8,10016538,10018583,2045
"203",6,4,137,9,10027937,10029799,1862
"214",6,6,73,10,10031918,10033617,1699
"223",6,1,92,11,10036199,10037728,1529
"233",6,5,84,12,10040069,10042349,2280
"244",6,5,120,13,10044592,10046879,2287
"252",6,4,77,14,10049677,10051369,1692
"265",6,2,123,15,10053736,10055768,2032
"273",6,3,34,16,10058174,10060671,2497
"294",6,1,56,17,10068790,10072011,3221
"304",6,5,78,18,10074417,10075685,1268
"312",6,6,31,19,10077797,10079567,1770
"334",6,2,75,20,10087588,10089581,1993
"343",6,2,45,21,10091974,10093503,1529
"363",6,6,49,22,10098432,10100216,1784
"383",6,5,138,23,10105223,10108118,2895
"394",6,3,118,24,10110211,10112171,1960
"403",6,1,134,25,10114459,10116367,1908
"414",6,4,29,26,10119067,10120328,1261
"433",6,4,89,27,10125859,10127852,1993
"444",6,2,15,28,10130225,10132054,1829
"463",6,5,30,29,10136983,10138539,1556
"483",6,2,57,30,10144428,10146147,1719
"493",6,1,68,31,10148448,10150173,1725
"504",6,2,51,32,10153213,10154964,1751
"524",6,1,122,33,10160711,10162351,1640
"534",6,2,69,34,10164966,10166586,1620
"543",6,2,129,35,10169456,10171194,1738
"554",6,1,62,36,10173522,10174750,1228
"564",6,3,82,37,10178359,10179894,1535
"572",6,4,47,38,10182320,10183653,1333
"595",6,2,21,39,10189732,10191660,1928
"612",6,4,131,40,10196347,10197954,1607
"625",6,2,9,41,10201236,10202660,1424
"645",6,5,24,42,10208322,10209903,1581
"664",6,2,105,43,10216067,10217563,1496
"675",6,5,12,44,10221094,10222904,1810
"694",6,3,4,45,10228924,10230434,1510
"713",6,3,106,46,10235042,10236650,1608
"725",6,6,97,47,10239670,10241016,1346
"733",6,4,41,48,10243696,10245474,1778
"754",6,1,38,49,10250756,10252827,2071
"775",6,4,11,50,10259436,10261579,2143
"795",6,5,90,51,10267136,10268697,1561
"803",6,1,8,52,10271175,10273090,1915
"824",6,6,55,53,10279823,10281594,1771
"832",6,2,63,54,10284098,10285535,1437
"844",6,6,43,55,10289582,10291614,2032
"865",6,1,2,56,10296229,10297386,1157
"884",6,2,33,57,10303047,10305223,2176
"905",6,3,40,58,10310884,10312988,2104
"922",6,6,127,59,10318963,10320603,1640
"934",6,3,10,60,10322937,10325035,2098
"953",6,2,135,61,10330970,10333506,2536
"962",6,5,54,62,10336271,10337898,1627
"983",6,6,13,63,10343684,10345369,1685
"1004",6,4,53,64,10350658,10352481,1823
"1025",6,3,70,65,10362044,10363442,1398
"1035",6,1,26,66,10367410,10369691,2281
"1053",6,6,133,67,10374607,10376502,1895
"1065",6,2,27,68,10378869,10380705,1836
"1082",6,4,101,69,10407799,10409851,2052
"1093",6,6,91,70,10412394,10413844,1450
"1102",6,2,117,71,10416329,10417518,1189
"1116",6,6,103,72,10419904,10421721,1817
"1124",6,4,107,73,10424290,10426368,2078
"1133",6,3,52,74,10428741,10430558,1817
"1155",6,4,119,75,10435382,10436872,1490
"1164",6,1,74,76,10440154,10441742,1588
"1173",6,5,60,77,10445246,10447010,1764
"1184",6,4,59,78,10449377,10451481,2104
"1193",6,3,64,79,10454292,10456403,2111
"1204",6,3,58,80,10459626,10461259,1633
"1214",6,4,35,81,10463691,10466037,2346
"1234",6,1,80,82,10470862,10472495,1633
"1243",6,1,116,83,10475084,10476868,1784
"1254",6,5,72,84,10479627,10481699,2072
"1262",6,3,28,85,10484216,10486954,2738
"1283",6,3,130,86,10491373,10494105,2732
"1295",6,3,16,87,10496484,10497674,1190
"1316",6,5,42,88,10502138,10503805,1667
"1334",6,2,87,89,10508616,10510204,1588
"1341",6,4,113,90,10513231,10515047,1816
"1355",6,6,121,91,10518721,10520394,1673
"1363",6,5,108,92,10522793,10524937,2144
"1374",6,5,18,93,10527670,10529087,1417
"1393",6,5,96,94,10534683,10536565,1882
"1405",6,5,66,95,10543213,10544892,1679
"1419",6,6,85,96,10547677,10549690,2013
"1423",6,1,98,97,10552181,10554135,1954
"1434",6,4,23,98,10556992,10558161,1169
"1452",6,1,50,99,10563214,10564854,1640
"1473",6,1,86,100,10570339,10571737,1398
"1485",6,2,81,101,10574686,10576090,1404
"1494",6,6,7,102,10579111,10580842,1731
"1515",6,1,44,103,10585765,10587111,1346
"1533",6,2,99,104,10592105,10593556,1451
"1543",6,1,20,105,10596419,10598066,1647
"1564",6,4,95,106,10603139,10604635,1496
"1574",6,3,88,107,10607008,10609596,2588
"1584",6,1,110,108,10611897,10613478,1581
"1591",6,5,126,109,10615728,10617930,2202
"1605",6,5,102,110,10623898,10625551,1653
"1614",6,5,6,111,10629323,10631140,1817
"1635",6,6,79,112,10635696,10637434,1738
"1642",6,2,3,113,10640697,10642154,1457
"1663",6,6,67,114,10646808,10648801,1993
"1672",6,2,111,115,10653946,10655900,1954
"1685",6,6,115,116,10659214,10660750,1536
"1694",6,3,100,117,10663299,10665103,1804
"1703",6,5,36,118,10668097,10669391,1294
"1725",6,5,114,119,10675150,10676921,1771
"1733",6,1,32,120,10680013,10681666,1653
"1754",6,6,1,121,10686543,10688059,1516
"1773",6,3,136,122,10692445,10694549,2104
"1785",6,1,128,123,10697302,10698929,1627
"1794",6,4,83,124,10703943,10706282,2339
"1804",6,3,112,125,10708904,10710191,1287
"1816",6,3,22,126,10713244,10715302,2058
"1834",6,5,48,127,10720107,10721087,980
"1854",6,2,39,128,10726637,10728016,1379
"1873",6,2,93,129,10734082,10735166,1084
"1884",6,1,14,130,10737520,10740049,2529
"1903",6,6,19,131,10744985,10746651,1666
"1924",6,4,125,132,10752711,10754560,1849
"1934",6,3,76,133,10757502,10759174,1672
"1942",6,6,25,134,10763247,10765090,1843
"1963",6,6,109,135,10769751,10771862,2111
"1975",6,4,5,136,10774751,10776391,1640
"1993",6,6,37,137,10782157,10783856,1699
"2015",6,4,71,138,10788589,10790118,1529
"1014",7,2,56,1,12165013,12170719,5706
"1117",7,1,73,2,12174360,12179073,4713
"1215",7,4,70,3,12181694,12185472,3778
"1317",7,4,10,4,12189505,12194707,5202
"1516",7,2,134,5,12201819,12205591,3772
"1615",7,3,27,6,12208095,12211519,3424
"1817",7,4,106,7,12217553,12222474,4921
"1916",7,6,30,8,12225017,12228984,3967
"215",7,2,116,9,12234645,12240390,5745
"224",7,1,7,10,12243195,12250345,7150
"245",7,3,117,11,12259647,12262071,2424
"253",7,6,66,12,12264523,12270562,6039
"266",7,3,135,13,12273066,12278386,5320
"274",7,4,118,14,12281060,12285014,3954
"284",7,3,81,15,12287433,12290714,3281
"295",7,5,137,16,12293061,12297329,4268
"305",7,1,49,17,12299545,12303591,4046
"324",7,4,88,18,12309343,12313990,4647
"335",7,2,104,19,12316461,12322585,6124
"344",7,1,91,20,12324926,12329481,4555
"354",7,3,69,21,12333044,12335782,2738
"364",7,5,125,22,12338214,12341737,3523
"373",7,4,82,23,12344110,12346678,2568
"384",7,1,97,24,12349156,12353006,3850
"395",7,5,77,25,12355366,12360830,5464
"404",7,3,105,26,12363229,12365889,2660
"415",7,4,46,27,12368138,12370621,2483
"434",7,6,42,28,12378485,12383504,5019
"452",7,4,76,29,12391368,12395512,4144
"464",7,1,37,30,12397957,12404002,6045
"484",7,4,22,31,12410258,12414624,4366
"505",7,4,28,32,12420043,12424259,4216
"525",7,3,129,33,12430070,12434129,4059
"535",7,2,98,34,12437894,12441972,4078
"544",7,3,57,35,12444457,12447953,3496
"555",7,6,108,36,12450431,12455405,4974
"565",7,4,94,37,12457967,12462255,4288
"573",7,5,5,38,12465269,12469399,4130
"596",7,5,17,39,12475799,12481341,5542
"613",7,6,78,40,12487094,12489786,2692
"626",7,2,92,41,12492283,12496793,4510
"633",7,1,133,42,12502330,12508761,6431
"646",7,1,43,43,12511520,12514781,3261
"665",7,3,39,44,12523240,12527292,4052
"683",7,5,29,45,12532946,12537142,4196
"704",7,3,75,46,12543372,12547541,4169
"714",7,3,87,47,12549882,12552823,2941
"726",7,1,61,48,12555399,12560013,4614
"734",7,5,101,49,12562589,12565758,3169
"743",7,4,124,50,12568112,12570125,2013
"755",7,5,119,51,12573269,12577916,4647
"764",7,6,48,52,12580198,12582112,1914
"783",7,6,36,53,12588028,12590904,2876
"804",7,4,112,54,12597421,12599839,2418
"813",7,5,71,55,12602232,12608036,5804
"825",7,5,65,56,12610670,12612755,2085
"833",7,4,58,57,12616416,12621886,5470
"845",7,5,107,58,12624338,12627076,2738
"852",7,3,21,59,12629534,12632606,3072
"873",7,6,12,60,12638136,12640044,1908
"892",7,2,50,61,12646307,12649574,3267
"914",7,1,85,62,12654641,12656947,2306
"923",7,2,80,63,12659556,12662020,2464
"935",7,4,34,64,12664530,12667491,2961
"954",7,3,45,65,12675054,12677282,2228
"973",7,2,2,66,12733136,12737038,3902
"995",7,4,130,67,12742725,12746090,3365
"1005",7,1,109,68,12748444,12752555,4111
"1015",7,2,128,69,12755203,12758006,2803
"1026",7,5,53,70,12760582,12765092,4510
"1043",7,2,74,71,12770825,12776001,5176
"1054",7,6,18,72,12778420,12783570,5150
"1074",7,6,120,73,12789029,12792002,2973
"1083",7,6,138,74,12794402,12799094,4692
"1094",7,6,72,75,12801598,12805271,3673
"1103",7,2,20,76,12807710,12812056,4346
"1125",7,2,44,77,12818462,12820540,2078
"1142",7,6,6,78,12826338,12830482,4144
"1165",7,4,136,79,12835718,12839535,3817
"1174",7,1,103,80,12841875,12843849,1974
"1185",7,4,64,81,12846209,12850195,3986
"1194",7,3,51,82,12852536,12855013,2477
"1216",7,1,25,83,12861092,12864203,3111
"1235",7,1,31,84,12870132,12874132,4000
"1255",7,1,79,85,12880348,12883002,2654
"1263",7,2,26,86,12885329,12891813,6484
"1284",7,5,35,87,12897408,12899905,2497
"1303",7,4,40,88,12906853,12909866,3013
"1325",7,4,100,89,12915939,12919625,3686
"1335",7,3,93,90,12922181,12924841,2660
"1342",7,6,24,91,12927436,12931724,4288
"1364",7,1,13,92,12939888,12944542,4654
"1384",7,2,62,93,12950294,12953947,3653
"1394",7,1,115,94,12956543,12960523,3980
"1406",7,6,132,95,12963380,12966733,3353
"14110",7,4,16,96,12969387,12972759,3372
"1435",7,6,84,97,12979309,12983472,4163
"1445",7,5,59,98,12986898,12990139,3241
"1453",7,3,63,99,12993081,12995421,2340
"1464",7,3,9,100,13001370,13007912,6542
"1486",7,2,86,101,13013488,13015899,2411
"1495",7,4,4,102,13018802,13021704,2902
"1517",7,2,8,103,13028633,13031351,2718
"1534",7,5,11,104,13037241,13039352,2111
"1554",7,6,54,105,13046771,13049535,2764
"1575",7,5,41,106,13055942,13059000,3058
"1592",7,6,60,107,13065812,13070034,4222
"1606",7,6,96,108,13072877,13075563,2686
"1616",7,3,33,109,13079375,13082708,3333
"1636",7,1,1,110,13089454,13093015,3561
"1654",7,1,19,111,13097984,13101395,3411
"1673",7,2,32,112,13108586,13111716,3130
"1695",7,5,83,113,13117554,13121906,4352
"1704",7,6,126,114,13124371,13127835,3464
"1716",7,3,15,115,13130273,13134175,3902
"1734",7,5,89,116,13141268,13146431,5163
"1745",7,4,52,117,13150007,13152392,2385
"1764",7,6,102,118,13162557,13166654,4097
"1774",7,5,23,119,13170060,13173138,3078
"1795",7,3,111,120,13178721,13183897,5176
"1805",7,2,68,121,13187349,13191852,4503
"1818",7,3,3,122,13204834,13212651,7817
"1835",7,2,14,123,13220554,13225743,5189
"1855",7,5,47,124,13232313,13234777,2464
"1874",7,1,55,125,13240627,13243542,2915
"1885",7,2,122,126,13245935,13249026,3091
"1894",7,5,95,127,13252601,13256105,3504
"1904",7,5,131,128,13258622,13261674,3052
"1917",7,6,90,129,13725361,13727762,2401
"1925",7,1,67,130,13731947,13734813,2866
"1935",7,2,38,131,13737815,13740282,2467
"1954",7,2,110,132,13808053,13810937,2884
"1964",7,1,121,133,13813571,13815788,2217
"1976",7,1,127,134,13822507,13824691,2184
"1982",7,5,113,135,13827526,13829826,2300
"1994",7,3,123,136,13836061,13838545,2484
"2005",7,6,114,137,13842780,13844930,2150
"2016",7,3,99,138,13848232,13849748,1516
"1016",8,3,104,1,1096949,1100858,3909
"1118",8,2,67,2,1103263,1105472,2209
"1217",8,6,59,3,1108368,1111493,3125
"1318",8,4,39,4,1113950,1117996,4046
"1518",8,6,23,5,1123761,1127245,3484
"1717",8,5,64,6,1182287,1187084,4797
"1819",8,6,83,7,1189366,1194771,5405
"1918",8,4,9,8,1198484,1203072,4588
"216",8,2,19,9,1210381,1213707,3326
"234",8,4,129,10,1220440,1223714,3274
"246",8,6,113,11,1226342,1228812,2470
"254",8,3,98,12,1231179,1234081,2902
"267",8,5,124,13,1237278,1241114,3836
"275",8,4,45,14,1244069,1246892,2823
"296",8,5,4,15,1252233,1255076,2843
"313",8,2,7,16,1259985,1263298,3313
"336",8,4,27,17,1269084,1272136,3052
"355",8,4,3,18,1278679,1282979,4300
"374",8,2,13,19,1288523,1291111,2588
"396",8,5,34,20,1296556,1299281,2725
"416",8,1,114,21,1304798,1308615,3817
"425",8,6,35,22,1310910,1313328,2418
"445",8,3,44,23,1320460,1323145,2685
"465",8,3,38,24,1327545,1330022,2477
"485",8,1,48,25,1334696,1336146,1450
"506",8,1,96,26,1342193,1345193,3000
"513",8,3,62,27,1347553,1350664,3111
"526",8,4,81,28,1352958,1356376,3418
"536",8,3,122,29,1358763,1360984,2221
"545",8,6,89,30,1363475,1367802,4327
"556",8,1,12,31,1370411,1372632,2221
"574",8,5,94,32,1378548,1382411,3863
"584",8,3,32,33,1384640,1387378,2738
"604",8,4,75,34,1392556,1396444,3888
"614",8,4,93,35,1398844,1401118,2274
"627",8,2,127,36,1403851,1405961,2110
"634",8,1,66,37,1408570,1411602,3032
"647",8,2,109,38,1418682,1421250,2568
"654",8,3,8,39,1423969,1428191,4222
"676",8,5,46,40,1434049,1436845,2796
"695",8,5,82,41,1442114,1444232,2118
"705",8,5,70,42,1446507,1451311,4804
"715",8,1,84,43,1453808,1457023,3215
"727",8,6,53,44,1459298,1462376,3078
"744",8,4,63,45,1467306,1470867,3561
"756",8,1,138,46,1474548,1477077,2529
"765",8,5,40,47,1479548,1483110,3562
"784",8,5,76,48,1489209,1492385,3176
"796",8,1,72,49,1498321,1500497,2176
"805",8,4,135,50,1503125,1506582,3457
"814",8,2,61,51,1509191,1512308,3117
"826",8,4,105,52,1514779,1517191,2412
"834",8,1,36,53,1519387,1522217,2830
"853",8,3,80,54,1527551,1531080,3529
"866",8,5,100,55,1533356,1535747,2391
"874",8,6,101,56,1538539,1541806,3267
"885",8,1,60,57,1544546,1547245,2699
"893",8,2,133,58,1549487,1551997,2510
"906",8,2,73,59,1554259,1557036,2777
"915",8,6,65,60,1559580,1561546,1966
"924",8,3,116,61,1563782,1567037,3255
"936",8,5,88,62,1569593,1572397,2804
"944",8,2,31,63,1575378,1580018,4640
"963",8,2,49,64,1584836,1588332,3496
"984",8,2,121,65,1593033,1595437,2404
"996",8,3,56,66,1647677,1651663,3986
"1006",8,3,2,67,1653899,1656598,2699
"1027",8,4,123,68,1661887,1665409,3522
"1036",8,6,77,69,1669404,1672155,2751
"1044",8,4,57,70,1674685,1677482,2797
"1055",8,2,115,71,1679757,1682410,2653
"1066",8,4,15,72,1699732,1701732,2000
"1084",8,5,130,73,1706628,1709098,2470
"1095",8,4,21,74,1712047,1714942,2895
"1119",8,5,112,75,1719936,1722282,2346
"1126",8,1,24,76,1724741,1727779,3038
"1143",8,4,111,77,1734336,1737381,3045
"1156",8,2,25,78,1740330,1742355,2025
"1175",8,1,90,79,1747788,1750617,2829
"1186",8,6,131,80,1753592,1755873,2281
"1195",8,3,92,81,1758795,1762298,3503
"1205",8,2,43,82,1764854,1767592,2738
"1225",8,1,30,83,1772534,1775201,2667
"1244",8,5,16,84,1780051,1782182,2131
"1264",8,6,47,85,1787725,1789653,1928
"1285",8,5,28,86,1794843,1797686,2843
"1304",8,1,132,87,1803046,1805804,2758
"1319",8,3,110,88,1808491,1811667,3176
"1326",8,2,1,89,1814067,1816602,2535
"1343",8,2,55,90,1821394,1823321,1927
"1356",8,5,58,91,1825891,1829080,3189
"1365",8,4,51,92,1831551,1834995,3444
"1385",8,3,26,93,1840604,1843218,2614
"1407",8,6,71,94,1848722,1851049,2327
"14111",8,6,29,95,1853938,1856435,2497
"1436",8,3,50,96,1861847,1865429,3582
"1454",8,1,78,97,1870606,1872625,2019
"1465",8,1,18,98,1875031,1877521,2490
"1487",8,6,125,99,1883012,1885463,2451
"1496",8,1,102,100,1887869,1890156,2287
"1504",8,6,41,101,1892314,1895123,2809
"1524",8,5,10,102,1900726,1904163,3437
"1544",8,5,52,103,1909243,1911850,2607
"1565",8,6,119,104,1917034,1919922,2888
"1576",8,2,91,105,1922590,1926060,3470
"1585",8,1,126,106,1928597,1931655,3058
"1593",8,2,37,107,1933944,1936394,2450
"1617",8,6,95,108,1941519,1945186,3667
"1623",8,4,69,109,1947788,1949826,2038
"1637",8,4,117,110,1952311,1954376,2065
"1643",8,6,137,111,1958063,1960383,2320
"1655",8,6,17,112,1962789,1965324,2535
"1674",8,1,42,113,1970162,1973462,3300
"1696",8,2,85,114,1978339,1982018,3679
"1705",8,3,68,115,1985058,1988306,3248
"1718",8,6,11,116,1992052,1995006,2954
"1735",8,1,54,117,2003549,2005582,2033
"1755",8,6,5,118,2011491,2014419,2928
"1775",8,4,87,119,2021871,2024687,2816
"1786",8,3,14,120,2028551,2031400,2849
"1806",8,3,20,121,2037277,2038930,1653
"1823",8,4,33,122,2043807,2046663,2856
"1843",8,1,120,123,2052200,2055114,2914
"1856",8,1,108,124,2057684,2061376,3692
"1864",8,4,99,125,2063815,2065939,2124
"1875",8,2,103,126,2068658,2073305,4647
"1886",8,5,118,127,2075476,2077985,2509
"1895",8,5,22,128,2080293,2083266,2973
"1919",8,3,86,129,2088431,2090280,1849
"1926",8,6,107,130,2092601,2095182,2581
"1936",8,5,106,131,2097784,2099692,1908
"1943",8,1,6,132,2102190,2105758,3568
"1965",8,2,97,133,2112256,2114733,2477
"1977",8,3,134,134,2117034,2119792,2758
"1983",8,2,79,135,2122825,2125687,2862
"1995",8,5,136,136,2128250,2130655,2405
"2006",8,3,128,137,2133937,2138061,4124
"2017",8,3,74,138,2140741,2144114,3373
"1017",9,4,128,1,3350912,3356480,5568
"1120",9,3,109,2,3358860,3365488,6628
"1218",9,3,7,3,3367992,3376887,8895
"1420",9,3,121,4,3382287,3387522,5235
"1519",9,3,115,5,3389830,3393313,3483
"1618",9,6,94,6,3396294,3401895,5601
"1719",9,1,53,7,3404262,3407856,3594
"1920",9,2,18,8,3412681,3415615,2934
"217",9,3,61,9,3420551,3424812,4261
"225",9,6,124,10,3427178,3430140,2962
"235",9,6,70,11,3432610,3437427,4817
"247",9,6,106,12,3440166,3443042,2876
"255",9,6,46,13,3445683,3449663,3980
"276",9,4,32,14,3454932,3458598,3666
"297",9,1,107,15,3464599,3467906,3307
"306",9,3,55,16,3470292,3473129,2837
"314",9,4,116,17,3475685,3480443,4758
"325",9,3,133,18,3483267,3486097,2830
"337",9,5,99,19,3488581,3492051,3470
"345",9,1,137,20,3494542,3497294,2752
"356",9,5,81,21,3499667,3502634,2967
"365",9,2,66,22,3505445,3509046,3601
"375",9,1,11,23,3511459,3515295,3836
"397",9,3,37,24,3521159,3526890,5731
"417",9,5,111,25,3532159,3535610,3451
"426",9,1,35,26,3538179,3543349,5170
"446",9,6,136,27,3548860,3552271,3411
"453",9,4,92,28,3554742,3561579,6837
"466",9,2,6,29,3564004,3567710,3706
"486",9,5,129,30,3573783,3577992,4209
"494",9,2,120,31,3581176,3584528,3352
"507",9,4,110,32,3624662,3628394,3732
"514",9,4,134,33,3630937,3633976,3039
"527",9,4,44,34,3636349,3639238,2889
"546",9,6,118,35,3645291,3649598,4307
"557",9,2,54,36,3651958,3655565,3607
"575",9,6,34,37,3662364,3666161,3797
"597",9,4,86,38,3672417,3675711,3294
"605",9,3,79,39,3678064,3681312,3248
"615",9,5,135,40,3683594,3688849,5255
"628",9,5,87,41,3691333,3695503,4170
"635",9,1,77,42,3697954,3701673,3719
"648",9,2,90,43,3704053,3708432,4379
"655",9,4,56,44,3710707,3715399,4692
"666",9,4,80,45,3717825,3720949,3124
"677",9,5,69,46,3723459,3726309,2850
"684",9,2,114,47,3728800,3732544,3744
"696",9,2,84,48,3735009,3739381,4372
"706",9,2,132,49,3741676,3745382,3706
"716",9,5,21,50,3748010,3751212,3202
"735",9,6,40,51,3756095,3759396,3301
"757",9,2,78,52,3764364,3767501,3137
"766",9,1,17,53,3769639,3773540,3901
"785",9,2,138,54,3778254,3781744,3490
"797",9,3,25,55,3784581,3787672,3091
"815",9,4,74,56,3792346,3795496,3150
"827",9,4,98,57,3797928,3802072,4144
"835",9,6,16,58,3804955,3808477,3522
"854",9,1,5,59,3814602,3818811,4209
"875",9,2,102,60,3824276,3827760,3484
"886",9,3,43,61,3830022,3832564,2542
"907",9,3,19,62,3837336,3840734,3398
"925",9,1,71,63,3846716,3850278,3562
"937",9,6,76,64,3853429,3858533,5104
"945",9,6,10,65,3861115,3865082,3967
"964",9,2,30,66,3921969,3924805,2836
"985",9,3,49,67,3930336,3933871,3535
"1007",9,4,26,68,3938460,3941467,3007
"1028",9,2,60,69,3946977,3950251,3274
"1037",9,3,13,70,3952690,3956330,3640
"1056",9,4,2,71,3963116,3966409,3293
"1075",9,1,29,72,3971848,3975658,3810
"1096",9,5,123,73,3980842,3987502,6660
"1104",9,5,3,74,3989895,3992594,2699
"1127",9,3,103,75,3997484,4002627,5143
"1134",9,5,117,76,4005452,4007909,2457
"1144",9,3,73,77,4010354,4014393,4039
"1157",9,2,108,78,4017988,4020982,2994
"1166",9,6,64,79,4023381,4026707,3326
"1176",9,5,93,80,4029087,4032486,3399
"1187",9,2,36,81,4034996,4037917,2921
"1206",9,1,23,82,4043317,4045715,2398
"1226",9,5,105,83,4050272,4053088,2816
"1236",9,5,75,84,4055416,4059043,3627
"1245",9,1,83,85,4061514,4064716,3202
"1256",9,3,1,86,4067724,4071900,4176
"1274",9,6,82,87,4078287,4080868,2581
"1286",9,6,112,88,4084235,4086587,2352
"1296",9,2,48,89,4089359,4091940,2581
"13110",9,2,12,90,4098477,4101248,2771
"1336",9,1,89,91,4106909,4109837,2928
"1344",9,2,96,92,4112276,4114994,2718
"1357",9,1,95,93,4117485,4121354,3869
"1366",9,4,38,94,4124303,4127185,2882
"1386",9,6,58,95,4132349,4135394,3045
"1395",9,6,22,96,4137715,4141957,4242
"14112",9,1,41,97,4147278,4150474,3196
"1437",9,4,50,98,4155697,4158226,2529
"1455",9,6,100,99,4162880,4166409,3529
"1466",9,1,125,100,4168887,4171273,2386
"1474",9,6,28,101,4173907,4179018,5111
"1497",9,3,85,102,4184437,4188803,4366
"1505",9,3,31,103,4191934,4195457,3523
"1525",9,1,131,104,4200014,4203137,3123
"1535",9,3,97,105,4206713,4209765,3052
"1545",9,4,14,106,4213028,4216628,3600
"1566",9,2,126,107,4221518,4224616,3098
"1577",9,4,20,108,4227394,4229956,2562
"1594",9,4,62,109,4235558,4238734,3176
"1607",9,3,91,110,4241193,4245970,4777
"1619",9,4,8,111,4248429,4252036,3607
"1638",9,2,72,112,4257161,4259847,2686
"1644",9,5,51,113,4262606,4266246,3640
"1664",9,1,101,114,4271777,4275462,3685
"1675",9,4,68,115,4278071,4281299,3228
"1686",9,1,59,116,4284294,4287888,3594
"1697",9,3,67,117,4292503,4295111,2608
"1706",9,6,52,118,4297759,4301072,3313
"1726",9,6,4,119,4305772,4308615,2843
"1746",9,5,45,120,4312975,4315295,2320
"1765",9,3,127,121,4320479,4323629,3150
"1776",9,5,39,122,4326035,4328629,2594
"1796",9,1,65,123,4334362,4337107,2745
"1807",9,6,88,124,4339539,4342813,3274
"18110",9,4,104,125,4345370,4349866,4496
"1824",9,2,24,126,4352279,4354749,2470
"1844",9,4,122,127,4359482,4361658,2176
"1857",9,5,9,128,4365044,4368887,3843
"1876",9,1,119,129,4374849,4377933,3084
"1887",9,5,33,130,4380444,4385574,5130
"1905",9,6,130,131,4392124,4395954,3830
"19110",9,1,113,132,4398700,4401065,2365
"1927",9,5,57,133,4403569,4406752,3183
"1937",9,5,15,134,4409263,4411641,2378
"1955",9,2,42,135,4416498,4419786,3288
"1978",9,5,27,136,4428375,4432362,3987
"1996",9,1,47,137,4437349,4439761,2412
"2018",9,5,63,138,4444442,4446513,2071
"1018",10,6,123,1,1179230,1189504,10274
"1128",10,6,99,2,1192760,1199897,7137
"1219",10,5,32,3,1202401,1210303,7902
"1424",10,1,40,4,1218847,1230134,11287
"1620",10,1,22,5,1238658,1247122,8464
"1820",10,1,34,6,1257673,1268712,11039
"204",10,5,92,7,1276811,1285792,8981
"218",10,4,91,8,1288753,1296459,7706
"226",10,2,119,9,1298963,1306741,7778
"236",10,1,112,10,1309735,1316114,6379
"248",10,4,127,11,1318860,1325533,6673
"256",10,2,35,12,1327913,1334331,6418
"277",10,3,6,13,1341796,1352887,11091
"298",10,4,121,14,1360653,1367993,7340
"307",10,4,55,15,1370563,1376242,5679
"315",10,6,3,16,1380445,1386798,6353
"338",10,3,96,17,1394924,1403374,8450
"346",10,1,136,18,1406140,1413369,7229
"357",10,5,68,19,1415899,1425121,9222
"366",10,1,16,20,1427887,1434586,6699
"385",10,6,135,21,1442221,1452763,10542
"398",10,6,69,22,1455535,1459783,4248
"405",10,4,115,23,1463444,1469869,6425
"418",10,2,11,24,1474066,1480916,6850
"435",10,2,101,25,1493982,1500773,6791
"447",10,3,54,26,1506375,1512499,6124
"467",10,6,105,27,1520285,1525271,4986
"474",10,3,30,28,1527815,1532814,4999
"495",10,4,133,29,1539842,1546312,6470
"508",10,6,45,30,1549770,1558228,8458
"528",10,2,77,31,1565713,1573085,7372
"537",10,3,60,32,1578008,1585844,7836
"547",10,2,113,33,1588204,1594387,6183
"558",10,5,74,34,1597087,1605898,8811
"566",10,3,78,35,1609245,1615375,6130
"576",10,3,72,36,1618069,1625847,7778
"585",10,5,62,37,1628220,1634638,6418
"598",10,1,70,38,1637018,1644390,7372
"606",10,6,129,39,1647770,1653567,5797
"616",10,2,107,40,1656542,1663705,7163
"629",10,5,134,41,1667504,1673268,5764
"636",10,6,51,42,1676713,1683373,6660
"656",10,6,33,43,1690518,1698518,8000
"678",10,4,7,44,1708944,1715761,6817
"697",10,5,86,45,1724756,1730461,5705
"707",10,4,103,46,1732815,1741972,9157
"717",10,5,38,47,1745319,1751966,6647
"736",10,1,100,48,1759935,1772778,12843
"745",10,1,58,49,1775295,1781635,6340
"758",10,1,76,50,1784184,1794269,10085
"767",10,6,81,51,1797734,1806205,8471
"776",10,2,89,52,1808774,1816761,7987
"786",10,3,42,53,1819631,1828187,8556
"806",10,1,28,54,1836730,1847371,10641
"828",10,5,128,55,1855660,1871569,15909
"836",10,2,17,56,1874138,1879988,5850
"855",10,2,131,57,1886368,1892799,6431
"867",10,2,41,58,1895296,1902244,6948
"887",10,3,120,59,1910761,1917428,6667
"894",10,2,47,60,1921148,1928821,7673
"916",10,6,111,61,1938652,1951633,12981
"926",10,5,98,62,1954973,1960359,5386
"938",10,5,80,63,1963151,1974347,11196
"946",10,5,14,64,1977014,1983635,6621
"965",10,1,46,65,2012226,2019003,6777
"986",10,5,56,66,2068889,2076935,8046
"997",10,6,63,67,2080747,2087746,6999
"1008",10,5,104,68,2092179,2099629,7450
"1019",10,6,93,69,2102578,2107872,5294
"1029",10,6,117,70,2110611,2115474,4863
"1038",10,5,8,71,2118331,2124527,6196
"1057",10,4,67,72,2132469,2139077,6608
"1067",10,3,84,73,2142574,2150607,8033
"1076",10,3,90,74,2152967,2159209,6242
"1085",10,4,97,75,2161732,2169863,8131
"1097",10,3,138,76,2172523,2180805,8282
"1105",10,2,83,77,2183263,2189733,6470
"11110",10,2,59,78,2192963,2200074,7111
"1129",10,1,106,79,2203173,2210480,7307
"1135",10,4,79,80,2223867,2229233,5366
"1145",10,2,5,81,2232234,2237645,5411
"1167",10,3,48,82,2245110,2248711,3601
"1188",10,3,108,83,2257039,2263143,6104
"1196",10,2,53,84,2265615,2273249,7634
"12110",10,2,29,85,2279714,2287086,7372
"1237",10,6,21,86,2298872,2305277,6405
"1257",10,4,25,87,2312755,2318664,5909
"1275",10,1,52,88,2325384,2332331,6947
"1297",10,4,109,89,2339940,2347574,7634
"1305",10,4,37,90,2350019,2359006,8987
"1327",10,1,64,91,2366380,2375118,8738
"1337",10,4,31,92,2377485,2385269,7784
"1358",10,4,49,93,2394708,2409951,15243
"1375",10,6,27,94,2416841,2424076,7235
"1396",10,5,110,95,2432292,2438580,6288
"1408",10,4,61,96,2441731,2450130,8399
"14113",10,1,88,97,2458229,2465725,7496
"1425",10,5,50,98,2468628,2474987,6359
"1446",10,6,87,99,2481583,2494433,12850
"1456",10,5,26,100,2497107,2503878,6771
"1475",10,4,43,101,2514226,2520245,6019
"1498",10,1,124,102,2526769,2533089,6320
"1506",10,1,94,103,2535476,2547136,11660
"15110",10,4,19,104,2555386,2560189,4803
"1536",10,3,102,105,2576831,2589564,12733
"1546",10,5,44,106,2592852,2599453,6601
"1567",10,1,130,107,2606154,2617049,10895
"1578",10,6,15,108,2620292,2624795,4503
"1595",10,4,73,109,2631319,2639018,7699
"1608",10,4,1,110,2641738,2647587,5849
"1624",10,2,125,111,2654458,2663588,9130
"1639",10,3,36,112,2666406,2672884,6478
"1656",10,5,116,113,2685597,2694780,9183
"1665",10,1,82,114,2697199,2703225,6026
"1676",10,2,71,115,2705624,2711010,5386
"1687",10,2,23,116,2713193,2718696,5503
"1707",10,3,126,117,2725064,2731939,6875
"17110",10,2,137,118,2734986,2740868,5882
"1727",10,2,65,119,2743699,2749529,5830
"1736",10,5,2,120,2752255,2758313,6058
"1756",10,3,132,121,2767262,2775576,8314
"1766",10,3,114,122,2777949,2783047,5098
"1777",10,1,4,123,2785603,2791714,6111
"1797",10,3,18,124,2797924,2803611,5687
"18111",10,4,85,125,2814912,2824017,9105
"1825",10,6,75,126,2827508,2836037,8529
"1836",10,3,24,127,2838561,2848627,10066
"1858",10,2,95,128,2856595,2862523,5928
"1865",10,6,39,129,2865197,2871491,6294
"1888",10,4,13,130,2879806,2885322,5516
"1906",10,6,9,131,2892584,2899937,7353
"1928",10,3,66,132,2907585,2916239,8654
"1938",10,5,20,133,2921057,2927311,6254
"1956",10,6,57,134,2935803,2943986,8183
"1966",10,5,122,135,2946823,2952856,6033
"1979",10,1,10,136,2955602,2961882,6280
"1997",10,3,12,137,2969426,2977093,7667
"2019",10,1,118,138,2983767,2990773,7006
"1020",11,1,123,1,3688558,3691551,2993
"1130",11,1,99,2,3693977,3696271,2294
"1220",11,6,32,3,3699834,3702134,2300
"1426",11,2,40,4,3709520,3712729,3209
"1625",11,2,22,5,3718436,3721710,3274
"1826",11,2,34,6,3729835,3734169,4334
"205",11,6,92,7,3744896,3750098,5202
"219",11,5,91,8,3752530,3755909,3379
"227",11,3,119,9,3759007,3763353,4346
"237",11,2,112,10,3766420,3768870,2450
"249",11,5,127,11,3771394,3774014,2620
"257",11,3,35,12,3777244,3779524,2280
"278",11,4,6,13,3785316,3789551,4235
"299",11,5,121,14,3794591,3798055,3464
"308",11,5,55,15,3800422,3803199,2777
"316",11,1,3,16,3805664,3808278,2614
"339",11,4,96,17,3814207,3819037,4830
"347",11,2,136,18,3821312,3825815,4503
"358",11,6,68,19,3828620,3831469,2849
"367",11,2,16,20,3835261,3837476,2215
"386",11,1,135,21,3843425,3847313,3888
"399",11,1,69,22,3849837,3852019,2182
"406",11,5,115,23,3855883,3858523,2640
"419",11,3,11,24,3861903,3864236,2333
"436",11,3,101,25,3871119,3875629,4510
"448",11,4,54,26,3878440,3880740,2300
"468",11,1,105,27,3887774,3890859,3085
"475",11,4,30,28,3893238,3895624,2386
"496",11,5,133,29,3901435,3904637,3202
"509",11,1,45,30,3908501,3911638,3137
"529",11,3,77,31,3918286,3922651,4365
"538",11,4,60,32,3925639,3927979,2340
"548",11,3,113,33,3931012,3933208,2196
"559",11,6,74,34,3935954,3938646,2692
"567",11,4,78,35,3941130,3943483,2353
"577",11,4,72,36,3946601,3949549,2948
"586",11,6,62,37,3951929,3953823,1894
"599",11,2,70,38,3956380,3959615,3235
"607",11,1,129,39,3962485,3965164,2679
"617",11,3,107,40,3968270,3971563,3293
"6210",11,6,134,41,3973989,3977655,3666
"637",11,1,51,42,3980375,3983035,2660
"657",11,1,33,43,3988826,3992780,3954
"679",11,5,7,44,4000036,4002519,2483
"698",11,6,86,45,4008527,4010880,2353
"708",11,5,103,46,4013109,4017586,4477
"718",11,6,38,47,4020299,4022645,2346
"737",11,2,100,48,4029110,4032345,3235
"746",11,2,58,49,4034862,4038790,3928
"759",11,2,76,50,4042425,4047764,5339
"768",11,1,81,51,4052386,4055634,3248
"777",11,3,89,52,4064720,4069903,5183
"787",11,4,42,53,4074067,4077086,3019
"807",11,2,28,54,4083297,4086649,3352
"829",11,6,128,55,4092147,4095964,3817
"837",11,3,17,56,4098768,4102147,3379
"856",11,3,131,57,4108168,4110769,2601
"868",11,3,41,58,4113273,4116292,3019
"888",11,4,120,59,4123842,4126364,2522
"895",11,3,47,60,4128829,4132763,3934
"917",11,1,111,61,4137699,4140980,3281
"927",11,6,98,62,4143405,4150921,7516
"939",11,6,80,63,4153393,4156405,3012
"947",11,6,14,64,4160315,4164053,3738
"966",11,2,46,65,4169570,4173472,3902
"987",11,6,56,66,4217364,4221305,3941
"998",11,1,63,67,4223750,4226717,2967
"1009",11,6,104,68,4228953,4231450,2497
"10110",11,1,93,69,4234673,4237476,2803
"10210",11,1,117,70,4240673,4242875,2202
"1039",11,6,8,71,4245458,4248699,3241
"1058",11,5,67,72,4253922,4256353,2431
"1068",11,4,84,73,4260047,4263876,3829
"1077",11,4,90,74,4266426,4269367,2941
"1086",11,5,97,75,4271675,4274250,2575
"1098",11,4,138,76,4276878,4279276,2398
"1106",11,3,83,77,4281565,4284407,2842
"11111",11,3,59,78,4286787,4288859,2072
"11210",11,2,106,79,4291265,4293146,1881
"1136",11,5,79,80,4295827,4298291,2464
"1146",11,3,5,81,4300775,4302977,2202
"1168",11,4,48,82,4309122,4310860,1738
"1189",11,4,108,83,4317763,4320174,2411
"1197",11,3,53,84,4322646,4325240,2594
"12111",11,3,29,85,4330947,4333260,2313
"1238",11,1,21,86,4340124,4343235,3111
"1258",11,5,25,87,4349164,4351810,2646
"1276",11,2,52,88,4359106,4362262,3156
"1298",11,5,109,89,4366871,4369753,2882
"1306",11,5,37,90,4372832,4376034,3202
"1328",11,2,64,91,4383107,4386166,3059
"1338",11,5,31,92,4388513,4393062,4549
"1359",11,5,49,93,4401233,4403794,2561
"1376",11,1,27,94,4408272,4411219,2947
"1397",11,6,110,95,4416593,4419030,2437
"1409",11,5,61,96,4421312,4423815,2503
"14114",11,2,88,97,4426358,4428600,2242
"1427",11,6,50,98,4431359,4433679,2320
"1447",11,1,87,99,4439758,4443830,4072
"1457",11,6,26,100,4446321,4449601,3280
"1476",11,5,43,101,4455543,4457438,1895
"1499",11,2,124,102,4462243,4464315,2072
"1507",11,2,94,103,4468694,4472289,3595
"15111",11,5,19,104,4474460,4477015,2555
"1537",11,4,102,105,4484689,4486839,2150
"1547",11,6,44,106,4489506,4491826,2320
"1568",11,2,130,107,4497598,4500448,2850
"1579",11,1,15,108,4503082,4505618,2536
"1596",11,5,73,109,4511926,4515141,3215
"1609",11,5,1,110,4517750,4520377,2627
"1626",11,3,125,111,4526751,4528724,1973
"16310",11,4,36,112,4531241,4533397,2156
"1657",11,6,116,113,4539411,4544241,4830
"1666",11,2,82,114,4546765,4549268,2503
"1677",11,3,71,115,4551961,4554471,2510
"1688",11,3,23,116,4556877,4559210,2333
"1708",11,4,126,117,4564753,4567406,2653
"17111",11,3,137,118,4569897,4572701,2804
"1728",11,3,65,119,4576355,4578969,2614
"1737",11,6,2,120,4581963,4584120,2157
"1757",11,4,132,121,4589343,4591957,2614
"1767",11,4,114,122,4594363,4597036,2673
"1778",11,2,4,123,4600076,4602206,2130
"1798",11,4,18,124,4608717,4611507,2790
"18112",11,5,85,125,4616894,4619201,2307
"1827",11,1,75,126,4621574,4624488,2914
"1837",11,4,24,127,4626875,4630044,3169
"1859",11,3,95,128,4639091,4642078,2987
"1866",11,1,39,129,4644693,4647523,2830
"1889",11,5,13,130,4653406,4655471,2065
"1907",11,1,9,131,4661145,4663308,2163
"1929",11,4,66,132,4669309,4671661,2352
"1939",11,6,20,133,4674512,4676511,1999
"1957",11,1,57,134,4684748,4687120,2372
"1967",11,6,122,135,4690598,4692846,2248
"19710",11,2,10,136,4695487,4698219,2732
"1998",11,4,12,137,4705239,4707330,2091
"20110",11,2,118,138,4713148,4715664,2516
"1030",12,2,123,1,5506527,5510429,3902
"1137",12,2,99,2,5513103,5516226,3123
"1227",12,1,32,3,5518508,5522887,4379
"1428",12,3,40,4,5528169,5531581,3412
"1627",12,3,22,5,5536928,5540692,3764
"1828",12,3,34,6,5548432,5552235,3803
"206",12,1,92,7,5558897,5562164,3267
"2110",12,6,91,8,5565276,5569635,4359
"228",12,4,119,9,5572152,5575708,3556
"238",12,3,112,10,5578133,5581172,3039
"2410",12,6,127,11,5583258,5588323,5065
"258",12,4,35,12,5590918,5593931,3013
"279",12,5,6,13,5599945,5604102,4157
"2910",12,6,121,14,5609383,5612279,2896
"309",12,6,55,15,5614515,5617305,2790
"317",12,2,3,16,5619567,5622299,2732
"3310",12,5,96,17,5627993,5631678,3685
"348",12,3,136,18,5633882,5638398,4516
"359",12,1,68,19,5640614,5643790,3176
"368",12,3,16,20,5646268,5649634,3366
"387",12,2,135,21,5655641,5659066,3425
"3910",12,2,69,22,5661505,5663609,2104
"407",12,6,115,23,5665884,5669067,3183
"4110",12,4,11,24,5671832,5675165,3333
"437",12,4,101,25,5681578,5684257,2679
"449",12,5,54,26,5686643,5689166,2523
"469",12,2,105,27,5695088,5697853,2765
"476",12,5,30,28,5700180,5703160,2980
"497",12,6,133,29,5708658,5710906,2248
"5010",12,2,45,30,5713260,5716200,2940
"5210",12,4,77,31,5722241,5724835,2594
"539",12,5,60,32,5727267,5730848,3581
"549",12,4,113,33,5733346,5737483,4137
"5510",12,1,74,34,5739993,5742673,2680
"568",12,5,78,35,5744961,5746817,1856
"578",12,5,72,36,5749471,5752052,2581
"587",12,1,62,37,5754681,5757007,2326
"5910",12,3,70,38,5759720,5762733,3013
"608",12,2,129,39,5765668,5768295,2627
"618",12,4,107,40,5770943,5773858,2915
"6211",12,1,134,41,5776682,5779917,3235
"638",12,2,51,42,5782205,5784388,2183
"658",12,2,33,43,5789617,5792552,2935
"6710",12,6,7,44,5798076,5800944,2868
"699",12,1,86,45,5807044,5810520,3476
"709",12,6,103,46,5813358,5816305,2947
"719",12,1,38,47,5818881,5821338,2457
"738",12,3,100,48,5827038,5829874,2836
"747",12,3,58,49,5832274,5835385,3111
"7510",12,3,76,50,5837974,5841378,3404
"769",12,2,81,51,5843614,5846608,2994
"778",12,4,89,52,5848844,5851791,2947
"788",12,5,42,53,5854386,5856987,2601
"808",12,3,28,54,5862616,5865380,2764
"8210",12,1,128,55,5871459,5873864,2405
"838",12,4,17,56,5876421,5879924,3503
"857",12,4,131,57,5885310,5888395,3085
"869",12,4,41,58,5890690,5893271,2581
"889",12,5,120,59,5898834,5901722,2888
"896",12,4,47,60,5904187,5906154,1967
"918",12,2,111,61,5911037,5914344,3307
"928",12,1,98,62,5916593,5919710,3117
"9310",12,1,80,63,5922064,5924998,2934
"948",12,1,14,64,5927293,5929789,2496
"967",12,3,46,65,5935183,5938032,2849
"988",12,1,56,66,5971557,5974727,3170
"999",12,2,63,67,5977440,5979642,2202
"10010",12,1,104,68,5982107,5984349,2242
"10111",12,2,93,69,5987095,5989695,2600
"10211",12,2,117,70,5991971,5993833,1862
"10310",12,1,8,71,5995932,5998330,2398
"1059",12,6,67,72,6004004,6006389,2385
"1069",12,5,84,73,6008867,6011945,3078
"1078",12,5,90,74,6014024,6016351,2327
"1087",12,6,97,75,6018619,6021737,3118
"1099",12,5,138,76,6024607,6027495,2888
"1107",12,4,83,77,6029940,6033287,3347
"11112",12,4,59,78,6035490,6038640,3150
"11211",12,3,106,79,6041059,6043333,2274
"1138",12,6,79,80,6045536,6049359,3823
"1147",12,4,5,81,6051641,6054216,2575
"1169",12,5,48,82,6060027,6062596,2569
"11810",12,5,108,83,6069812,6072577,2765
"1198",12,4,53,84,6075015,6078100,3085
"12112",12,4,29,85,6083101,6086264,3163
"1239",12,2,21,86,6091807,6094238,2431
"1259",12,6,25,87,6099514,6103036,3522
"1277",12,3,52,88,6107776,6110461,2685
"1299",12,6,109,89,6115913,6119854,3941
"1307",12,6,37,90,6122188,6125358,3170
"1329",12,3,64,91,6131326,6134705,3379
"1339",12,6,31,92,6137902,6141588,3686
"13510",12,6,49,93,6147556,6151176,3620
"1377",12,2,27,94,6155975,6159157,3182
"1398",12,1,110,95,6164139,6167557,3418
"14010",12,6,61,96,6170152,6172648,2496
"14115",12,3,88,97,6175394,6178989,3595
"1429",12,1,50,98,6181369,6184368,2999
"1448",12,2,87,99,6189722,6193663,3941
"1458",12,1,26,100,6196324,6198944,2620
"1477",12,6,43,101,6204331,6206991,2660
"14910",12,3,124,102,6211854,6214775,2921
"1508",12,3,94,103,6217547,6221148,3601
"15112",12,6,19,104,6223515,6226208,2693
"1538",12,5,102,105,6233352,6236280,2928
"1548",12,1,44,106,6239033,6241084,2051
"1569",12,3,130,107,6247445,6252098,4653
"15710",12,2,15,108,6254334,6257020,2686
"1597",12,6,73,109,6262112,6265099,2987
"16010",12,6,1,110,6267760,6270524,2764
"1628",12,4,125,111,6277911,6281270,3359
"16311",12,5,36,112,6283689,6285872,2183
"1658",12,1,116,113,6292546,6295859,3313
"1667",12,3,82,114,6298134,6300487,2353
"1678",12,4,71,115,6303396,6305821,2425
"1689",12,4,23,116,6308429,6311102,2673
"1709",12,5,126,117,6316678,6319318,2640
"17112",12,4,137,118,6321940,6324358,2418
"1729",12,4,65,119,6326934,6329953,3019
"1738",12,1,2,120,6332633,6335143,2510
"1758",12,5,132,121,6341255,6344836,3581
"1768",12,5,114,122,6347216,6350170,2954
"1779",12,3,4,123,6352811,6355889,3078
"1799",12,5,18,124,6361773,6364164,2391
"18113",12,6,85,125,6368773,6371531,2758
"1829",12,2,75,126,6373858,6376675,2817
"1838",12,5,24,127,6379421,6382185,2764
"18510",12,4,95,128,6387794,6391584,3790
"1867",12,2,39,129,6393801,6396938,3137
"18810",12,6,13,130,6402481,6405657,3176
"1908",12,2,9,131,6410410,6413442,3032
"19210",12,5,66,132,6418907,6421488,2581
"19310",12,1,20,133,6423711,6425920,2209
"1958",12,2,57,134,6431575,6434182,2607
"1968",12,1,122,135,6436601,6438424,1823
"19711",12,3,10,136,6440542,6444124,3582
"1999",12,5,12,137,6449929,6452288,2359
"20111",12,3,118,138,6458073,6460955,2882
"1040",13,2,20,1,8125802,8130011,4209
"1228",13,4,16,2,8136071,8139960,3889
"1430",13,4,124,3,8144738,8148450,3712
"1520",13,4,28,4,8150739,8157392,6653
"1720",13,5,113,5,8162465,8166249,3784
"1830",13,4,88,6,8168733,8172007,3274
"1930",13,2,8,7,8174577,8178269,3692
"2111",13,1,43,8,8185303,8189093,3790
"239",13,4,100,9,8193552,8197826,4274
"2411",13,2,86,10,8200206,8203781,3575
"259",13,3,87,11,8206076,8212553,6477
"268",13,2,74,12,8214782,8218599,3817
"2710",13,2,56,13,8220998,8226638,5640
"285",13,2,98,14,8229064,8234887,5823
"2911",13,2,110,15,8237202,8241058,3856
"3010",13,2,32,16,8243398,8248182,4784
"326",13,5,29,17,8253399,8256961,3562
"349",13,5,41,18,8262583,8266948,4365
"369",13,5,35,19,8271648,8275158,3510
"388",13,1,97,20,8280721,8285923,5202
"3911",13,2,128,21,8288192,8295015,6823
"408",13,5,53,22,8297350,8301238,3888
"427",13,6,138,23,8306507,8310670,4163
"438",13,1,85,24,8313043,8317004,3961
"4410",13,4,10,25,8319318,8323815,4497
"4610",13,1,55,26,8329057,8332913,3856
"477",13,3,3,27,8335104,8338933,3829
"498",13,1,115,28,8344215,8348084,3869
"5011",13,1,37,29,8350752,8355653,4901
"5211",13,3,9,30,8360975,8366085,5110
"5410",13,1,67,31,8370858,8374243,3385
"5511",13,4,112,32,8376649,8380315,3666
"569",13,6,72,33,8382806,8387734,4928
"579",13,3,39,34,8390846,8396427,5581
"5911",13,1,127,35,8401010,8405323,4313
"609",13,6,42,36,8407618,8411755,4137
"6212",13,5,5,37,8417828,8422639,4811
"649",13,1,73,38,8427574,8432044,4470
"659",13,1,25,39,8434391,8441260,6869
"6711",13,5,125,40,8446078,8451607,5529
"685",13,3,33,41,8454353,8458536,4183
"7010",13,1,13,42,8464151,8468138,3987
"728",13,1,109,43,8473224,8477099,3875
"739",13,2,62,44,8479937,8483191,3254
"748",13,4,118,45,8485512,8490178,4666
"7511",13,1,91,46,8492800,8497087,4287
"7610",13,5,137,47,8500108,8504996,4888
"779",13,6,18,48,8507638,8514402,6764
"798",13,6,132,49,8519560,8525037,5477
"809",13,3,105,50,8527325,8532109,4784
"816",13,6,120,51,8534417,8539809,5392
"8211",13,2,134,52,8542169,8548908,6739
"839",13,5,89,53,8551170,8556843,5673
"846",13,4,64,54,8559576,8565458,5882
"858",13,6,126,55,8567739,8572158,4419
"8610",13,4,22,56,8574753,8580021,5268
"8810",13,5,47,57,8585329,8589865,4536
"908",13,4,130,58,8595382,8602872,7490
"919",13,3,123,59,8605657,8611441,5784
"929",13,2,116,60,8614096,8620077,5981
"9311",13,6,90,61,8622900,8626586,3686
"949",13,4,58,62,8628894,8632946,4052
"955",13,5,59,63,8635711,8640692,4981
"968",13,5,23,64,8643065,8646685,3620
"989",13,3,21,65,8651856,8659118,7262
"10011",13,3,27,66,8726371,8732233,5862
"10212",13,1,31,67,8737646,8742594,4948
"1045",13,5,77,68,8748189,8754241,6052
"10510",13,2,104,69,8756700,8765314,8614
"10610",13,6,108,70,8767701,8771458,3757
"1079",13,5,83,71,8773727,8779067,5340
"1088",13,5,101,72,8781414,8785910,4496
"10910",13,6,102,73,8788434,8795362,6928
"1108",13,4,70,74,8797644,8804271,6627
"11113",13,3,81,75,8806853,8810716,3863
"11212",13,1,79,76,8813187,8817697,4510
"1139",13,4,46,77,8820188,8824743,4555
"1158",13,2,44,78,8831090,8835129,4039
"1177",13,3,69,79,8840764,8846176,5412
"11811",13,3,111,80,8848752,8854777,6025
"1199",13,5,17,81,8857654,8863366,5712
"12113",13,3,57,82,8868707,8871759,3052
"1229",13,4,34,83,8874237,8878393,4156
"1246",13,2,68,84,8884505,8888472,3967
"12510",13,3,93,85,8891088,8896238,5150
"1265",13,3,51,86,8898683,8903983,5300
"1287",13,1,1,87,8908866,8913807,4941
"1308",13,6,78,88,8919011,8923318,4307
"13111",13,6,48,89,8925724,8929109,3385
"13310",13,4,76,90,8934574,8940221,5647
"1345",13,2,80,91,8942758,8946849,4091
"13511",13,1,49,92,8949222,8952673,3451
"1378",13,6,60,93,8957556,8962249,4693
"1387",13,3,63,94,8964563,8969079,4516
"1399",13,5,11,95,8971505,8977256,5751
"14116",13,4,106,96,8984192,8988002,3810
"14210",13,6,6,97,8990356,8999591,9235
"1449",13,3,15,98,9004664,9009127,4463
"1467",13,4,4,99,9014305,9018311,4006
"1488",13,2,50,100,9023776,9026704,2928
"1509",13,3,45,101,9031763,9036162,4399
"1526",13,1,121,102,9041117,9047646,6529
"1539",13,3,117,103,9050425,9054065,3640
"1549",13,1,7,104,9056327,9061621,5294
"15610",13,3,99,105,9067217,9072641,5424
"15711",13,2,122,106,9074969,9077550,2581
"1586",13,6,54,107,9079884,9083766,3882
"16011",13,4,82,108,9089571,9092963,3392
"16110",13,6,30,109,9095121,9099427,4306
"16312",13,5,119,110,9104670,9109742,5072
"1645",13,6,36,111,9111998,9117703,5705
"1668",13,5,107,112,9123031,9127632,4601
"1679",13,6,114,113,9130012,9135717,5705
"16810",13,4,136,114,9138032,9142045,4013
"1698",13,2,92,115,9144490,9148012,3522
"17010",13,4,40,116,9150771,9154784,4013
"17210",13,1,133,117,9160524,9163347,2823
"1739",13,6,24,118,9165753,9169628,3875
"1759",13,1,61,119,9175002,9179871,4869
"1769",13,4,94,120,9182342,9185714,3372
"17710",13,2,14,121,9188643,9193120,4477
"17910",13,2,26,122,9198140,9201486,3346
"18114",13,3,135,123,9206265,9214311,8046
"18210",13,3,129,124,9216547,9221873,5326
"1839",13,6,66,125,9224305,9231050,6745
"1845",13,5,65,126,9233437,9236972,3535
"18511",13,6,12,127,9239365,9242437,3072
"1877",13,1,103,128,9247483,9250627,3144
"18811",13,5,71,129,9252895,9256582,3687
"1896",13,5,131,130,9259269,9261948,2679
"1909",13,1,19,131,9264419,9267863,3444
"19211",13,2,38,132,9273250,9276857,3607
"1944",13,5,95,133,9282839,9286211,3372
"1959",13,3,75,134,9288970,9293466,4496
"1969",13,4,52,135,9295983,9300722,4739
"1984",13,2,2,136,9305291,9312324,7033
"2007",13,6,96,137,9317704,9322102,4398
"20112",13,6,84,138,9325319,9330358,5039
"1046",14,1,30,1,10672152,10676184,4032
"1230",14,5,100,2,10681603,10685982,4379
"1320",14,6,137,3,10688251,10692139,3888
"1438",14,4,117,4,10694585,10699610,5025
"1527",14,2,31,5,10701964,10707075,5111
"1730",14,3,8,6,10715932,10720416,4484
"1940",14,3,26,7,10726828,10732711,5883
"2112",14,3,2,8,10738934,10744306,5372
"2310",14,5,46,9,10751235,10756509,5274
"2510",14,2,97,10,10762497,10765870,3373
"269",14,4,21,11,10768432,10773177,4745
"286",14,2,121,12,10779133,10784577,5444
"2912",14,2,127,13,10787251,10791100,3849
"3011",14,1,84,14,10793493,10799421,5928
"318",14,5,16,15,10801814,10807140,5326
"3311",14,3,92,16,10813475,10818566,5091
"3410",14,5,4,17,10821096,10824854,3758
"3610",14,5,22,18,10830208,10834142,3934
"389",14,6,125,19,10840849,10848202,7353
"3912",14,3,32,20,10850647,10856222,5575
"4111",14,3,74,21,10862458,10866889,4431
"428",14,1,42,22,10869576,10873994,4418
"4411",14,6,5,23,10880440,10889440,9000
"4611",14,3,80,24,10896761,10901898,5137
"478",14,5,40,25,10904363,10909520,5157
"499",14,1,72,26,10916292,10919821,3529
"5012",14,5,136,27,10922233,10926750,4517
"515",14,2,67,28,10929162,10933220,4058
"5212",14,2,91,29,10935875,10939986,4111
"5310",14,2,73,30,10942568,10948221,5653
"5411",14,4,75,31,10950601,10954921,4320
"5512",14,5,70,32,10957478,10963530,6052
"5610",14,3,110,33,10965798,10969844,4046
"5710",14,4,27,34,10972230,10976884,4654
"5912",14,4,105,35,10982558,10986204,3646
"6010",14,4,3,36,10988604,10993290,4686
"6213",14,1,6,37,10998997,11003826,4829
"6410",14,2,19,38,11009370,11014141,4771
"667",14,2,85,39,11021894,11025978,4084
"6712",14,3,122,40,11028293,11031907,3614
"686",14,5,88,41,11034613,11038731,4118
"6910",14,3,98,42,11041248,11047679,6431
"7011",14,3,38,43,11050020,11053856,3836
"729",14,4,93,44,11059321,11063739,4418
"7310",14,3,68,45,11066243,11074393,8150
"749",14,5,52,46,11076806,11080537,3731
"7611",14,6,77,47,11086068,11091584,5516
"7710",14,5,94,48,11093996,11099624,5628
"789",14,3,134,49,11102141,11108297,6156
"799",14,4,123,50,11110828,11115612,4784
"8010",14,2,13,51,11118357,11122985,4628
"8212",14,2,61,52,11128051,11132711,4660
"8310",14,5,28,53,11135457,11139646,4189
"859",14,2,115,54,11145869,11149849,3980
"8611",14,2,43,55,11152412,11156712,4300
"8811",14,4,15,56,11164576,11168569,3993
"909",14,5,58,57,11174315,11177400,3085
"9110",14,1,18,58,11179682,11183694,4012
"9312",14,1,114,59,11189336,11193649,4313
"9410",14,2,1,60,11196147,11200225,4078
"969",14,3,20,61,11205585,11210023,4438
"9810",14,3,86,62,11216508,11220429,3921
"9910",14,2,7,63,11222979,11226763,3784
"10112",14,6,95,64,11232365,11237064,4699
"10213",14,2,79,65,11239365,11244712,5347
"10311",14,5,76,66,11276191,11280629,4438
"1047",14,3,50,67,11283447,11287610,4163
"10611",14,6,83,68,11293624,11298604,4980
"10710",14,4,51,69,11301173,11306010,4837
"10911",14,1,36,70,11311913,11315755,3842
"11114",14,5,106,71,11321443,11325403,3960
"11213",14,4,69,72,11327835,11330953,3118
"11310",14,2,49,73,11333339,11338848,5509
"1159",14,2,103,74,11343575,11349477,5902
"11610",14,4,111,75,11352438,11356464,4026
"1178",14,1,12,76,11359092,11363412,4320
"11910",14,6,11,77,11369485,11373171,3686
"12114",14,4,129,78,11382283,11386348,4065
"12210",14,1,96,79,11388689,11392878,4189
"12310",14,6,53,80,11395598,11399709,4111
"12511",14,1,54,81,11404925,11407899,2974
"1278",14,2,109,82,11414109,11420037,5928
"1288",14,1,60,83,11422319,11427403,5084
"12910",14,1,108,84,11429829,11434920,5091
"1309",14,2,37,85,11437411,11442640,5229
"13210",14,5,64,86,11451523,11456444,4921
"13311",14,2,25,87,11459092,11463478,4386
"13512",14,3,104,88,11468603,11472851,4248
"1367",14,1,66,89,11475531,11479747,4216
"1379",14,4,87,90,11482270,11488715,6445
"1388",14,6,89,91,11491421,11496454,5033
"13910",14,6,65,92,11498755,11504042,5287
"14011",14,5,112,93,11506442,11510435,3993
"14117",14,3,44,94,11512985,11518919,5934
"1439",14,4,57,95,11524548,11528946,4398
"14410",14,6,35,96,11531751,11537012,5261
"1468",14,4,33,97,11542941,11547699,4758
"1489",14,3,128,98,11553942,11562850,8908
"14911",14,6,113,99,11565119,11570282,5163
"15010",14,5,124,100,11572551,11578060,5509
"15113",14,6,41,101,11580290,11585518,5228
"15310",14,4,135,102,11591559,11596865,5306
"15410",14,1,90,103,11599285,11603134,3849
"1555",14,6,131,104,11605475,11610579,5104
"15611",14,1,126,105,11613089,11619017,5928
"15712",14,1,102,106,11621384,11626965,5581
"1587",14,5,34,107,11629398,11634084,4686
"16012",14,1,138,108,11639987,11644483,4496
"16111",14,4,39,109,11646856,11650961,4105
"16313",14,1,48,110,11656229,11658693,2464
"1659",14,5,130,111,11665027,11670785,5758
"1669",14,4,45,112,11673132,11678178,5046
"16811",14,6,17,113,11684231,11687976,3745
"17011",14,3,56,114,11694317,11700356,6039
"17113",14,1,120,115,11702788,11707677,4889
"17211",14,4,99,116,11710318,11715651,5333
"17310",14,6,59,117,11718083,11722684,4601
"1747",14,2,55,118,11725319,11728626,3307
"17510",14,6,29,119,11731241,11736855,5614
"17711",14,6,71,120,11743176,11747261,4085
"1787",14,4,63,121,11749785,11752928,3143
"17911",14,5,118,122,11755661,11759340,3679
"1808",14,2,133,123,11761818,11765537,3719
"18115",14,3,14,124,11768243,11772877,4634
"18310",14,4,9,125,11778872,11784401,5529
"18512",14,1,132,126,11791526,11795480,3954
"1868",14,4,81,127,11797938,11802657,4719
"1878",14,6,119,128,11805416,11811121,5705
"18812",14,1,78,129,11813599,11817599,4000
"1897",14,6,101,130,11820096,11823671,3575
"19010",14,6,47,131,11825979,11830404,4425
"19212",14,3,62,132,11835882,11841522,5640
"19311",14,6,23,133,11843771,11848908,5137
"19510",14,5,10,134,11855426,11860046,4620
"19712",14,1,24,135,11866341,11870204,3863
"19910",14,6,107,136,11877126,11880355,3229
"2008",14,5,82,137,11882793,11887068,4275
"20113",14,3,116,138,11889578,11894558,4980
"1048",15,5,57,1,1719486,1727362,7876
"1140",15,4,116,2,1730415,1737258,6843
"1240",15,2,54,3,1739670,1744101,4431
"1440",15,4,98,4,1749821,1755435,5614
"1528",15,1,77,5,1759096,1763691,4595
"1629",15,3,133,6,1766045,1774535,8490
"1740",15,1,107,7,1778405,1783019,4614
"1840",15,2,138,8,1786347,1791020,4673
"1945",15,3,55,9,1793360,1798059,4699
"207",15,5,111,10,1800622,1805223,4601
"2113",15,1,89,11,1807891,1814760,6869
"229",15,3,103,12,1817447,1825434,7987
"2311",15,3,121,13,1827676,1834075,6399
"2412",15,5,3,14,1836729,1841284,4555
"2610",15,1,119,15,1848050,1861312,13262
"2711",15,5,129,16,1865117,1869887,4770
"287",15,4,92,17,1873392,1879228,5836
"2913",15,3,67,18,1883079,1887438,4359
"3012",15,5,93,19,1890857,1895353,4496
"319",15,2,12,20,1900439,1906465,6026
"3312",15,3,1,21,1912937,1917302,4365
"3510",15,1,113,22,1924016,1931643,7627
"3611",15,1,29,23,1934036,1940415,6379
"3810",15,6,22,24,1945723,1951272,5549
"409",15,2,90,25,1957502,1964600,7098
"4112",15,4,8,26,1966927,1974267,7340
"439",15,4,104,27,1980438,1987170,6732
"4412",15,6,34,28,1989805,1994687,4882
"4612",15,3,73,29,2003400,2008622,5222
"479",15,5,21,30,2012767,2018897,6130
"4910",15,1,125,31,2029213,2035369,6156
"5013",15,5,45,32,2039344,2043448,4104
"5213",15,4,68,33,2050312,2054841,4529
"5311",15,6,112,34,2059228,2063724,4496
"5412",15,6,88,35,2066843,2072378,5535
"5513",15,1,53,36,2075118,2080496,5378
"5711",15,2,72,37,2087046,2091033,3987
"588",15,3,91,38,2093459,2097818,4359
"5913",15,4,32,39,2100283,2104393,4110
"619",15,5,105,40,2113231,2116224,2993
"6214",15,1,5,41,2119624,2123257,3633
"6411",15,2,96,42,2129030,2135101,6071
"6510",15,1,17,43,2137560,2142272,4712
"6713",15,4,56,44,2150770,2156279,5509
"687",15,6,46,45,2160071,2166973,6902
"7012",15,6,58,46,2172823,2177568,4745
"7110",15,5,9,47,2180177,2184745,4568
"7311",15,1,65,48,2191406,2194517,3111
"7410",15,5,75,49,2197446,2204701,7255
"7512",15,1,95,50,2207375,2210597,3222
"7612",15,3,25,51,2213303,2216806,3503
"7810",15,4,62,52,2225794,2228748,2954
"7910",15,6,76,53,2232952,2238683,5731
"8011",15,5,51,54,2242521,2245259,2738
"8213",15,2,114,55,2256620,2261070,4450
"8311",15,3,13,56,2265065,2270339,5274
"8510",15,6,64,57,2276255,2282235,5980
"8612",15,4,26,58,2286217,2290412,4195
"8812",15,4,134,59,2295877,2301492,5615
"897",15,4,2,60,2304087,2308224,4137
"9111",15,6,94,61,2314519,2320630,6111
"9210",15,4,14,62,2323533,2328702,5169
"9411",15,3,79,63,2334128,2338246,4118
"956",15,6,118,64,2340573,2343436,2863
"9610",15,5,87,65,2346188,2352828,6640
"974",15,4,128,66,2449502,2454900,5398
"9811",15,2,60,67,2457365,2463045,5680
"9911",15,5,63,68,2465327,2468810,3483
"10012",15,6,82,69,2471124,2476980,5856
"10113",15,1,41,70,2479302,2482334,3032
"10312",15,1,35,71,2488165,2492446,4281
"10511",15,4,20,72,2499375,2502394,3019
"10711",15,4,110,73,2513925,2516421,2496
"1089",15,5,15,74,2518709,2521768,3059
"1109",15,6,28,75,2527939,2533690,5751
"11214",15,6,124,76,2539090,2543998,4908
"11311",15,1,71,77,2546875,2550306,3431
"1148",15,6,40,78,2552862,2558816,5954
"11611",15,4,86,79,2564536,2568235,3699
"1179",15,5,99,80,2570562,2576242,5680
"11812",15,5,27,81,2578838,2583563,4725
"1207",15,2,102,82,2589727,2592648,2921
"12115",15,6,4,83,2595074,2599440,4366
"12311",15,3,7,84,2604663,2610401,5738
"12512",15,3,31,85,2616226,2621402,5176
"1279",15,2,48,86,2626860,2630233,3373
"12911",15,3,85,87,2635711,2640913,5202
"13010",15,4,50,88,2643783,2651391,7608
"13211",15,5,81,89,2656777,2662744,5967
"13312",15,1,137,90,2665347,2669202,3855
"1346",15,2,126,91,2671687,2675687,4000
"13513",15,5,33,92,2678217,2683831,5614
"13710",15,5,39,93,2690486,2694767,4281
"13911",15,6,10,94,2700342,2704028,3686
"14118",15,2,132,95,2709271,2712343,3072
"14211",15,6,70,96,2714827,2720650,5823
"14310",15,2,78,97,2723122,2725716,2594
"14411",15,6,130,98,2728384,2732488,4104
"1459",15,4,122,99,2734783,2737691,2908
"1469",15,2,84,100,2740371,2746789,6418
"1478",15,4,38,101,2749221,2752012,2791
"14912",15,6,16,102,2758314,2761294,2980
"15114",15,3,97,103,2790597,2794766,4169
"1529",15,2,108,104,2798264,2801793,3529
"15311",15,3,43,105,2804905,2807355,2450
"1556",15,4,80,106,2812370,2815840,3470
"15612",15,4,74,107,2820514,2826095,5581
"15713",15,2,36,108,2828534,2833351,4817
"1598",15,2,18,109,2839920,2843743,3823
"16112",15,3,49,110,2849267,2853738,4471
"16314",15,5,117,111,2859765,2862496,2731
"1646",15,6,100,112,2864654,2870026,5372
"16510",15,4,44,113,2873838,2877282,3444
"16710",15,1,131,114,2894133,2900983,6850
"16812",15,1,11,115,2903434,2906552,3118
"17012",15,3,19,116,2912285,2914748,2463
"17212",15,1,23,117,2920056,2923357,3301
"1748",15,2,42,118,2928730,2933325,4595
"17610",15,3,37,119,2939090,2944031,4941
"1788",15,2,6,120,2950385,2953888,3503
"1809",15,2,120,121,2960674,2965105,4431
"18116",15,3,61,122,2968112,2973680,5568
"18211",15,6,52,123,2977773,2981740,3967
"1846",15,2,24,124,2987094,2991753,4659
"1869",15,5,123,125,2997833,3003408,5575
"1879",15,5,69,126,3006690,3009160,2470
"18813",15,1,59,127,3013207,3016775,3568
"1898",15,3,115,128,3019749,3023592,3843
"19011",15,6,136,129,3026541,3031240,4699
"19111",15,1,101,130,3034639,3038306,3667
"19213",15,3,109,131,3041306,3046927,5621
"19312",15,1,47,132,3050621,3055640,5019
"19511",15,2,30,133,3061099,3063307,2208
"19713",15,1,83,134,3068583,3071844,3261
"1985",15,2,66,135,3076721,3079485,2764
"19911",15,6,106,136,3082675,3085701,3026
"2009",15,5,135,137,3088493,3094231,5738
"20114",15,3,127,138,3096853,3101238,4385
"1049",16,4,73,1,4461140,4466617,5477
"1149",16,3,54,2,4469245,4475572,6327
"1330",16,5,98,3,4483344,4490220,6876
"1450",16,4,61,4,4492770,4497939,5169
"1530",16,1,10,5,4500358,4505260,4902
"1749",16,3,84,6,4511157,4515692,4535
"1847",16,5,74,7,4518569,4523098,4529
"1946",16,4,67,8,4525792,4530046,4254
"208",16,6,123,9,4532870,4537249,4379
"2114",16,4,121,10,4540427,4545550,5123
"2210",16,4,13,11,4550375,4554995,4620
"2413",16,1,112,12,4561127,4564807,3680
"2511",16,2,83,13,4567252,4571480,4228
"2611",16,1,106,14,4574363,4577474,3111
"2712",16,1,76,15,4580848,4585370,4522
"288",16,5,68,16,4588384,4592155,3771
"2914",16,5,38,17,4594737,4598201,3464
"3110",16,3,96,18,4603803,4607816,4013
"327",16,2,77,19,4610294,4613771,3477
"3313",16,5,86,20,4616582,4619314,2732
"3411",16,6,3,21,4622073,4626294,4221
"3612",16,3,42,22,4631674,4636472,4798
"3811",16,5,20,23,4642270,4645354,3084
"4010",16,3,114,24,4651225,4654976,3751
"4113",16,2,113,25,4657421,4661839,4418
"429",16,2,95,26,4664448,4668755,4307
"4310",16,6,15,27,4671239,4673526,2287
"454",16,6,27,28,4679691,4683154,3463
"4710",16,2,47,29,4695352,4698508,3156
"4911",16,3,90,30,4704372,4708653,4281
"5014",16,2,101,31,4711549,4714954,3405
"516",16,3,108,32,4717314,4720954,3640
"5214",16,1,46,33,4723700,4726929,3229
"5413",16,5,110,34,4732230,4735197,2967
"5514",16,3,138,35,4737982,4741452,3470
"5611",16,2,23,36,4743656,4747348,3692
"589",16,1,64,37,4752643,4755846,3203
"5914",16,2,89,38,4758337,4762232,3895
"6011",16,5,92,39,4765324,4769951,4627
"6110",16,5,116,40,4772501,4776527,4026
"6215",16,6,117,41,4778992,4781998,3006
"639",16,5,56,42,4784378,4789116,4738
"6412",16,4,103,43,4792189,4797718,5529
"6511",16,2,137,44,4800483,4803927,3444
"668",16,5,14,45,4806588,4810398,3810
"688",16,4,109,46,4815746,4819471,3725
"6911",16,2,107,47,4821981,4826229,4248
"7013",16,1,40,48,4828557,4831550,2993
"7210",16,2,11,49,4837054,4840100,3046
"7411",16,4,55,50,4846192,4851185,4993
"7513",16,2,131,51,4853886,4859604,5718
"7613",16,3,120,52,4862546,4868984,6438
"7711",16,6,93,53,4871495,4876089,4594
"7811",16,3,48,54,4878828,4881808,2980
"8012",16,6,135,55,4888777,4893574,4797
"817",16,1,124,56,4896058,4900816,4758
"8214",16,2,53,57,4903562,4907411,3849
"847",16,4,43,58,4913543,4917621,4078
"8613",16,5,32,59,4924975,4928315,3340
"8813",16,4,49,60,4933512,4938485,4973
"9010",16,5,134,61,4943774,4946139,2365
"9112",16,2,17,62,4948768,4953231,4463
"9313",16,3,60,63,4959298,4964807,5509
"9412",16,3,66,64,4967240,4970762,3522
"957",16,6,105,65,4973122,4976926,3804
"9611",16,6,45,66,5074234,5078181,3947
"9812",16,2,5,67,5083391,5086639,3248
"10013",16,1,58,68,5091954,5095607,3653
"10114",16,2,59,69,5098085,5100993,2908
"10214",16,2,65,70,5103425,5106902,3477
"10313",16,3,6,71,5109628,5113883,4255
"10512",16,3,30,72,5122636,5125681,3045
"10712",16,2,125,73,5130342,5135159,4817
"10810",16,3,72,74,5137937,5142375,4438
"10912",16,2,35,75,5145245,5149853,4608
"11115",16,4,1,76,5155847,5158670,2823
"11312",16,4,133,77,5164253,5166978,2725
"11410",16,2,41,78,5169573,5173854,4281
"11612",16,6,81,79,5179025,5181580,2555
"11710",16,2,119,80,5183973,5187156,3183
"11813",16,4,19,81,5189934,5192398,2464
"1208",16,1,94,82,5205334,5209393,4059
"12116",16,5,104,83,5212504,5217583,5079
"12211",16,1,118,84,5220198,5223537,3339
"12312",16,4,91,85,5226061,5229485,3424
"1247",16,1,4,86,5232179,5235754,3575
"1266",16,6,87,87,5241846,5245179,3333
"12710",16,6,63,88,5247657,5250814,3157
"1289",16,5,122,89,5253239,5255075,1836
"12912",16,4,127,90,5257468,5259997,2529
"13011",16,4,79,91,5262344,5265893,3549
"13112",16,5,128,92,5268384,5273011,4627
"13212",16,5,50,93,5275633,5280201,4568
"1347",16,6,9,94,5285908,5289836,3928
"1368",16,4,25,95,5295706,5298464,2758
"1389",16,4,97,96,5303099,5308765,5666
"13912",16,6,39,97,5311047,5314628,3581
"14119",16,1,82,98,5320231,5322792,2561
"14212",16,4,7,99,5325375,5328316,2941
"14412",16,6,51,100,5334918,5337885,2967
"14610",16,5,8,101,5342670,5345872,3202
"14810",16,4,85,102,5351409,5355069,3660
"14913",16,2,29,103,5357704,5361560,3856
"15115",16,6,57,104,5366796,5371743,4947
"15210",16,6,21,105,5374071,5380136,6065
"15411",16,6,69,106,5385196,5387797,2601
"1557",16,5,62,107,5390340,5393242,2902
"15613",16,3,24,108,5395824,5400222,4398
"1588",16,6,129,109,5405759,5409177,3418
"1599",16,6,99,110,5411551,5415772,4221
"16013",16,3,132,111,5418486,5422433,3947
"16113",16,5,2,112,5425002,5429891,4889
"16315",16,3,102,113,5435755,5438892,3137
"1647",16,1,100,114,5441631,5445323,3692
"16511",16,5,80,115,5448200,5451879,3679
"16610",16,3,126,116,5454710,5458305,3595
"16711",16,1,34,117,5461044,5463998,2954
"1699",16,4,37,118,5469326,5472730,3404
"17114",16,4,31,119,5478078,5483947,5869
"17311",16,5,44,120,5499053,5501778,2725
"17511",16,6,111,121,5507622,5511439,3817
"17611",16,1,52,122,5514760,5519158,4398
"1789",16,1,130,123,5524258,5528473,4215
"17912",16,1,28,124,5530996,5533911,2915
"18117",16,1,88,125,5539938,5543003,3065
"18212",16,3,36,126,5545749,5548690,2941
"1848",16,3,18,127,5553835,5556913,3078
"18610",16,3,12,128,5561698,5564181,2483
"18814",16,4,115,129,5569417,5573626,4209
"1899",16,1,16,130,5576411,5581006,4595
"19112",16,3,78,131,5585994,5588843,2849
"19214",16,1,70,132,5591210,5596118,4908
"19313",16,2,71,133,5598779,5601478,2699
"1947",16,1,22,134,5604080,5607341,3261
"19610",16,5,26,135,5613244,5616688,3444
"1986",16,1,136,136,5622552,5625401,2849
"19912",16,6,33,137,5628225,5631578,3353
"20115",16,6,75,138,5636919,5641317,4398
"1050",17,3,65,1,6471864,6475007,3143
"1150",17,3,23,2,6478067,6480622,2555
"1340",17,3,17,3,6485551,6488518,2967
"1540",17,3,119,4,6494310,6497577,3267
"1630",17,2,4,5,6500075,6503296,3221
"1849",17,5,7,6,6508278,6512219,3941
"209",17,2,82,7,6518181,6520814,2633
"2115",17,4,138,8,6523534,6525808,2274
"2211",17,5,61,9,6528671,6531743,3072
"2312",17,1,75,10,6534129,6537273,3144
"2414",17,2,40,11,6539855,6544554,4699
"2612",17,1,45,12,6551228,6553470,2242
"289",17,5,91,13,6558072,6561797,3725
"2915",17,1,87,14,6567661,6570687,3026
"3013",17,5,103,15,6573282,6576145,2863
"3111",17,5,85,16,6578583,6581413,2830
"328",17,6,8,17,6584819,6587269,2450
"3412",17,3,5,18,6598486,6600970,2484
"3613",17,4,54,19,6608742,6610853,2111
"3812",17,4,12,20,6616808,6618736,1928
"4011",17,4,36,21,6624443,6626605,2162
"4210",17,4,84,22,6631580,6634096,2516
"4311",17,4,126,23,6640757,6642986,2229
"4413",17,6,116,24,6645784,6648117,2333
"455",17,2,106,25,6650425,6652398,1973
"4613",17,1,105,26,6654941,6657366,2425
"4711",17,1,93,27,6659759,6662614,2855
"487",17,1,111,28,6667465,6670425,2960
"4912",17,6,122,29,6673112,6675413,2301
"5015",17,1,33,30,6677668,6679929,2261
"5215",17,6,104,31,6685839,6688440,2601
"5312",17,5,73,32,6692794,6696205,3411
"5414",17,4,60,33,6698480,6702454,3974
"5515",17,5,31,34,6704879,6707447,2568
"5712",17,3,53,35,6714311,6717958,3647
"5915",17,1,9,36,6722410,6725566,3156
"6111",17,1,39,37,6730724,6732848,2124
"6310",17,2,46,38,6738025,6741103,3078
"6512",17,3,35,39,6747745,6750444,2699
"6714",17,5,67,40,6757628,6760379,2751
"689",17,6,68,41,6762935,6766027,3092
"6912",17,1,135,42,6768831,6772798,3967
"7014",17,1,81,43,6775426,6778138,2712
"7111",17,5,37,44,6780479,6783355,2876
"7312",17,1,117,45,6788898,6790786,1888
"7412",17,1,129,46,6792931,6795551,2620
"7514",17,5,109,47,6797872,6801251,3379
"7614",17,1,63,48,6804023,6807232,3209
"7712",17,2,112,49,6809867,6811892,2025
"7812",17,3,131,50,6814057,6816710,2653
"7911",17,6,38,51,6820443,6823331,2888
"818",17,3,113,52,6993304,6996473,3169
"8215",17,3,83,53,6998860,7002088,3228
"8312",17,5,97,54,7004638,7006337,1699
"848",17,2,28,55,7008749,7011010,2261
"8614",17,4,108,56,7016260,7018187,1927
"876",17,3,29,57,7020881,7022893,2012
"898",17,4,18,58,7028679,7030064,1385
"9113",17,5,43,59,7038954,7041045,2091
"9314",17,6,134,60,7045660,7048176,2516
"9413",17,6,26,61,7050602,7052536,1934
"9612",17,4,78,62,7057655,7060850,3195
"975",17,6,92,63,7063452,7065694,2242
"9813",17,4,24,64,7068100,7071589,3489
"10014",17,4,30,65,7077015,7079316,2301
"10215",17,6,20,66,7091971,7093905,1934
"10410",17,6,128,67,7098853,7101683,2830
"10513",17,2,22,68,7104056,7107160,3104
"10713",17,5,25,69,7111645,7114619,2974
"10913",17,6,14,70,7119698,7122475,2777
"11116",17,1,123,71,7128672,7131594,2922
"11215",17,2,52,72,7134196,7136313,2117
"11411",17,2,94,73,7141556,7144000,2444
"11510",17,5,55,74,7146458,7148693,2235
"11613",17,3,95,75,7150994,7154124,3130
"11711",17,1,3,76,7156635,7159268,2633
"11911",17,3,71,77,7164446,7166968,2522
"1209",17,5,13,78,7169832,7172387,2555
"12212",17,3,107,79,7177499,7180139,2640
"12313",17,3,137,80,7182512,7184793,2281
"1248",17,5,127,81,7187206,7189905,2699
"12513",17,5,1,82,7192441,7195140,2699
"12711",17,1,15,83,7200298,7202095,1797
"12913",17,3,41,84,7207390,7210194,2804
"13113",17,6,32,85,7216345,7218874,2529
"13313",17,4,72,86,7223672,7226299,2627
"1348",17,6,50,87,7229202,7232796,3594
"1369",17,2,118,88,7238163,7240817,2654
"13711",17,4,102,89,7243497,7246098,2601
"13810",17,3,59,90,7249086,7252543,3457
"13913",17,4,42,91,7255250,7258314,3064
"14120",17,2,88,92,7264616,7267492,2876
"14213",17,1,69,93,7269858,7271694,1836
"14311",17,3,89,94,7274460,7279577,5117
"14413",17,4,6,95,7282532,7286650,4118
"14611",17,4,114,96,7293899,7297415,3516
"1479",17,3,47,97,7302200,7304938,2738
"14914",17,2,64,98,7310815,7313207,2392
"15011",17,2,130,99,7315587,7318606,3019
"15116",17,4,48,100,7321123,7322515,1392
"15312",17,1,51,101,7328731,7331359,2628
"1558",17,1,57,102,7357903,7359975,2072
"15614",17,6,80,103,7362570,7364942,2372
"15714",17,2,76,104,7370787,7373446,2659
"1589",17,2,70,105,7377584,7381950,4366
"15910",17,6,62,106,7385598,7389010,3412
"16014",17,2,10,107,7391219,7394278,3059
"16210",17,3,101,108,7400691,7402409,1718
"16316",17,2,58,109,7405913,7408808,2895
"1648",17,5,79,110,7411796,7414135,2339
"16512",17,3,125,111,7416665,7418319,1654
"16611",17,6,86,112,7421084,7423325,2241
"16712",17,6,98,113,7425653,7429627,3974
"16813",17,3,77,114,7432451,7434712,2261
"16910",17,4,120,115,7437451,7439836,2385
"17013",17,4,96,116,7443086,7445288,2202
"17115",17,2,16,117,7448138,7450007,1869
"17312",17,3,11,118,7455479,7457942,2463
"17512",17,6,74,119,7463662,7466773,3111
"17612",17,6,2,120,7469689,7471754,2065
"17810",17,5,133,121,7477794,7480159,2365
"17913",17,4,90,122,7483239,7485349,2110
"18010",17,5,19,123,7487494,7489461,1967
"18213",17,4,66,124,7497070,7499311,2241
"18311",17,6,56,125,7502822,7505017,2195
"18410",17,1,21,126,7508417,7511750,3333
"18611",17,2,124,127,7517058,7519077,2019
"18710",17,2,136,128,7521424,7523855,2431
"18815",17,5,115,129,7526091,7528437,2346
"18910",17,6,110,130,7531353,7534281,2928
"19012",17,2,100,131,7536615,7538934,2319
"19113",17,6,44,132,7541301,7543268,1967
"19314",17,5,121,133,7548478,7550837,2359
"1948",17,5,49,134,7553204,7555589,2385
"19611",17,2,34,135,7560538,7563132,2594
"1987",17,4,132,136,7570114,7571982,1868
"19913",17,1,99,137,7574559,7576127,1568
"20010",17,1,27,138,7578624,7580735,2111
"1060",18,6,37,1,970817,974640,3823
"1249",18,6,61,2,981256,985216,3960
"1349",18,5,72,3,987746,991282,3536
"1460",18,1,38,4,993910,997485,3575
"1640",18,5,12,5,1003407,1006655,3248
"1850",18,6,133,6,1012480,1015865,3385
"1949",18,3,88,7,1018238,1021951,3713
"2010",18,6,127,8,1024232,1027480,3248
"2116",18,5,60,9,1030206,1033369,3163
"2212",18,4,137,10,1035671,1038906,3235
"2313",18,4,83,11,1041240,1045220,3980
"2415",18,1,86,12,1047737,1051489,3752
"2512",18,6,55,13,1054404,1057273,2869
"2613",18,2,33,14,1059712,1063300,3588
"2810",18,3,10,15,1069222,1073052,3830
"3014",18,2,15,16,1078928,1081922,2994
"329",18,6,25,17,1087981,1090752,2771
"3413",18,1,116,18,1096060,1100276,4216
"3511",18,5,6,19,1102741,1107237,4496
"376",18,6,43,20,1112976,1116309,3333
"3913",18,5,84,21,1121637,1124951,3314
"4012",18,4,5,22,1127356,1132233,4877
"4211",18,5,66,23,1138841,1142788,3947
"4312",18,6,79,24,1145083,1148822,3739
"4414",18,2,69,25,1151110,1153979,2869
"456",18,2,3,26,1157007,1159632,2625
"4712",18,4,65,27,1165856,1169280,3424
"488",18,4,17,28,1171686,1175235,3549
"5016",18,2,45,29,1181151,1183843,2692
"5216",18,2,99,30,1189328,1192190,2862
"5313",18,1,110,31,1194531,1197765,3234
"5415",18,2,27,32,1200191,1203459,3268
"5612",18,4,77,33,1209238,1212741,3503
"5713",18,1,56,34,1215696,1219363,3667
"5810",18,2,39,35,1222140,1225683,3543
"6012",18,1,32,36,1231357,1234860,3503
"6216",18,6,91,37,1240652,1244331,3679
"6311",18,6,103,38,1246619,1251155,4536
"6413",18,6,1,39,1254038,1257378,3340
"669",18,1,104,40,1262503,1266391,3888
"6715",18,4,131,41,1268876,1271803,2927
"6810",18,5,96,42,1274150,1277431,3281
"6913",18,1,74,43,1279785,1283563,3778
"7015",18,2,105,44,1286622,1289596,2974
"7112",18,6,67,45,1291988,1294733,2745
"7211",18,6,19,46,1297119,1300021,2902
"7413",18,4,47,47,1308467,1311446,2979
"7615",18,5,24,48,1317042,1320153,3111
"7813",18,3,112,49,1326265,1328964,2699
"7912",18,5,30,50,1331586,1334409,2823
"819",18,3,70,51,1339795,1345860,6065
"8216",18,5,102,52,1348286,1350809,2523
"8313",18,3,34,53,1353737,1357260,3523
"8511",18,5,126,54,1362731,1365737,3006
"8615",18,1,128,55,1368470,1371843,3373
"877",18,5,78,56,1374458,1376817,2359
"8814",18,6,85,57,1379216,1382654,3438
"899",18,1,8,58,1384975,1387713,2738
"9114",18,3,64,59,1393400,1396883,3483
"9211",18,4,113,60,1399734,1403812,4078
"9315",18,4,59,61,1406257,1409518,3261
"9414",18,3,100,62,1412101,1414897,2796
"958",18,1,80,63,1417473,1420571,3098
"9613",18,6,31,64,1423069,1426500,3431
"9814",18,6,49,65,1431729,1434533,2804
"10015",18,2,57,66,1467124,1470842,3718
"10115",18,3,76,67,1473464,1477497,4033
"10216",18,3,118,68,1479968,1482843,2875
"10314",18,3,124,69,1485158,1488020,2862
"10411",18,5,36,70,1490576,1493988,3412
"10612",18,3,16,71,1499525,1503067,3542
"10811",18,1,50,72,1508630,1511532,2902
"11010",18,5,90,73,1516957,1519761,2804
"11117",18,4,125,74,1522239,1525284,3045
"11216",18,3,28,75,1527977,1531429,3452
"11412",18,2,21,76,1536945,1540416,3471
"11614",18,1,92,77,1546462,1549671,3209
"11712",18,5,138,78,1552162,1555371,3209
"11814",18,2,123,79,1557829,1561260,3431
"11912",18,2,93,80,1563692,1566626,2934
"12010",18,3,106,81,1568902,1572169,3267
"12117",18,6,73,82,1574510,1577392,2882
"12213",18,1,26,83,1579785,1582640,2855
"12410",18,3,130,84,1588321,1591994,3673
"12514",18,1,98,85,1594315,1599923,5608
"1267",18,5,18,86,1602316,1604818,2502
"12810",18,3,136,87,1610016,1613427,3411
"12914",18,4,23,88,1615670,1618702,3032
"13114",18,4,107,89,1624337,1627330,2993
"13213",18,1,44,90,1629540,1633737,4197
"13410",18,5,48,91,1640560,1643174,2614
"13610",18,2,111,92,1649750,1654110,4360
"13712",18,1,14,93,1656502,1660554,4052
"13914",18,5,108,94,1665817,1671457,5640
"14012",18,5,120,95,1673804,1676666,2862
"14121",18,6,121,96,1679242,1682549,3307
"14214",18,1,122,97,1685511,1687530,2019
"14312",18,2,117,98,1690328,1692746,2418
"14414",18,2,9,99,1695243,1698891,3648
"14612",18,1,134,100,1704303,1706734,2431
"14710",18,1,68,101,1709165,1711891,2726
"14811",18,4,89,102,1714460,1718376,3916
"14915",18,4,95,103,1720742,1724585,3843
"15012",18,6,13,104,1726971,1729885,2914
"15211",18,5,132,105,1734985,1737795,2810
"15313",18,6,97,106,1740416,1743286,2870
"15412",18,2,75,107,1745639,1748926,3287
"1559",18,4,53,108,1751280,1754214,2934
"15715",18,5,42,109,1759581,1763770,4189
"15911",18,6,115,110,1770111,1773830,3719
"16015",18,2,81,111,1776837,1780889,4052
"16114",18,6,109,112,1783177,1787387,4210
"16211",18,4,71,113,1789753,1794061,4308
"16317",18,4,29,114,1796584,1800080,3496
"16513",18,3,40,115,1805911,1810309,4398
"16713",18,4,35,116,1815617,1818604,2987
"16911",18,2,129,117,1824997,1829840,4843
"17014",18,1,2,118,1832115,1834853,2738
"17213",18,1,62,119,1841711,1845044,3333
"17313",18,3,46,120,1848456,1851757,3301
"17513",18,3,82,121,1857653,1860581,2928
"17613",18,6,7,122,1862856,1865679,2823
"17811",18,4,11,123,1871699,1874117,2418
"18011",18,2,135,124,1903826,1907923,4097
"18118",18,1,20,125,1910382,1913199,2817
"18312",18,4,101,126,1918964,1922068,3104
"18411",18,3,52,127,1924631,1927781,3150
"18612",18,4,119,128,1934305,1937638,3333
"18711",18,3,22,129,1940018,1943678,3660
"18911",18,5,114,130,1950123,1953606,3483
"19013",18,2,51,131,1955908,1958835,2927
"19215",18,3,4,132,1964817,1967595,2778
"19410",18,5,54,133,1973053,1975536,2483
"19612",18,3,94,134,1982583,1985844,3261
"19714",18,2,87,135,1988524,1992060,3536
"1988",18,3,58,136,1994708,1999459,4751
"19914",18,4,41,137,2001800,2004564,2764
"20116",18,2,63,138,2010460,2013787,3327
"1070",19,2,26,1,3363555,3369405,5850
"1250",19,2,134,2,3376092,3381301,5209
"1350",19,4,58,3,3384505,3391308,6803
"1470",19,3,129,4,3394139,3401825,7686
"1550",19,5,101,5,3405232,3411722,6490
"1649",19,4,136,6,3415108,3420350,5242
"1750",19,5,71,7,3422945,3428357,5412
"1860",19,1,7,8,3432240,3437050,4810
"2020",19,6,6,9,3448966,3455103,6137
"2213",19,4,4,10,3463170,3467647,4477
"2416",19,2,116,11,3474151,3479589,5438
"2513",19,2,86,12,3482871,3487236,4365
"2614",19,1,1,13,3490283,3493910,3627
"2811",19,2,50,14,3503186,3507100,3914
"3015",19,6,126,15,3513539,3518539,5000
"3112",19,3,57,16,3521475,3526703,5228
"3210",19,3,33,17,3529495,3537030,7535
"3414",19,3,99,18,3543541,3547247,3706
"3512",19,5,131,19,3549856,3554084,4228
"3614",19,1,109,20,3570458,3575955,5497
"377",19,5,17,21,3578812,3584014,5202
"3914",19,6,42,22,3590211,3595786,5575
"4114",19,5,95,23,3602035,3606741,4706
"4212",19,6,54,24,3632972,3636462,3490
"4415",19,6,96,25,3655614,3659084,3470
"457",19,4,118,26,3661608,3666510,4902
"4614",19,1,19,27,3668772,3671974,3202
"489",19,2,20,28,3680969,3687635,6666
"5017",19,6,60,29,3696499,3700682,4183
"517",19,3,21,30,3704055,3708218,4163
"5314",19,4,10,31,3716540,3721284,4744
"5516",19,5,65,32,3728227,3732847,4620
"5613",19,4,112,33,3735227,3738978,3751
"5714",19,1,67,34,3741685,3745267,3582
"5811",19,4,88,35,3749699,3754496,4797
"5916",19,1,121,36,3760602,3764706,4104
"6013",19,2,8,37,3767484,3772419,4935
"6217",19,3,27,38,3779622,3785139,5517
"6414",19,6,138,39,3793329,3796564,3235
"6513",19,2,98,40,3806611,3810585,3974
"6610",19,3,81,41,3813716,3817761,4045
"6716",19,1,13,42,3821586,3826507,4921
"6914",19,4,16,43,3838855,3842325,3470
"7113",19,3,39,44,3848405,3853254,4849
"7313",19,6,72,45,3860151,3867190,7039
"7414",19,2,14,46,3869805,3873674,3869
"7616",19,6,84,47,3930711,3937090,6379
"7713",19,4,22,48,3940084,3943796,3712
"7913",19,4,64,49,3950836,3956097,5261
"8013",19,3,15,50,3958654,3962039,3385
"8217",19,2,92,51,3968151,3973439,5288
"8314",19,2,122,52,3975916,3978511,2595
"849",19,5,5,53,3982584,3986681,4097
"8616",19,3,111,54,3993682,3998244,4562
"878",19,2,56,55,4000774,4005924,5150
"8815",19,5,113,56,4013396,4017690,4294
"8910",19,5,11,57,4020736,4026024,5288
"9115",19,5,77,58,4033410,4038031,4621
"9212",19,1,31,59,4040666,4045136,4470
"9415",19,1,25,60,4051150,4054986,3836
"9614",19,1,85,61,4062445,4070465,8020
"976",19,1,73,62,4073210,4077831,4621
"9815",19,6,108,63,4080348,4084400,4052
"9912",19,3,105,64,4090754,4093486,2732
"10016",19,4,52,65,4095768,4098604,2836
"10217",19,1,115,66,4181688,4185309,3621
"10315",19,5,89,67,4187931,4193453,5522
"10412",19,2,32,68,4196114,4199800,3686
"10613",19,3,69,69,4205023,4211520,6497
"10714",19,1,127,70,4214612,4217657,3045
"10812",19,6,78,71,4221044,4224704,3660
"10914",19,5,83,72,4227384,4232750,5366
"11011",19,1,49,73,4235202,4239136,3934
"11217",19,5,53,74,4245575,4248744,3169
"11413",19,6,12,75,4255079,4258836,3757
"11615",19,3,93,76,4265570,4268373,2803
"11713",19,5,35,77,4271165,4274204,3039
"11913",19,4,70,78,4282898,4289989,7091
"12011",19,3,9,79,4293755,4297336,3581
"12214",19,5,41,80,4303108,4306925,3817
"12411",19,4,28,81,4312873,4318579,5706
"1268",19,6,90,82,4324410,4330181,5771
"12712",19,3,117,83,4332940,4337992,5052
"12811",19,5,137,84,4341052,4348980,7928
"12915",19,6,132,85,4351425,4356438,5013
"13012",19,6,24,86,4359654,4365582,5928
"13214",19,3,45,87,4376577,4381348,4771
"13411",19,6,120,88,4387852,4392407,4555
"13514",19,6,36,89,4400075,4403925,3850
"13713",19,1,79,90,4409867,4414710,4843
"13811",19,2,2,91,4417305,4420403,3098
"14013",19,3,135,92,4425953,4429619,3666
"14122",19,4,46,93,4432457,4437463,5006
"14313",19,1,37,94,4443902,4450843,6941
"14510",19,6,102,95,4458007,4462523,4516
"14613",19,5,107,96,4465276,4468099,2823
"14711",19,1,91,97,4470825,4474596,3771
"14812",19,1,55,98,4476858,4481002,4144
"14916",19,6,66,99,4483721,4488322,4601
"15013",19,2,44,100,4491408,4501251,9843
"15212",19,5,125,101,4510148,4514403,4255
"15314",19,6,114,102,4516933,4521436,4503
"15413",19,2,38,103,4529927,4533038,3111
"15615",19,4,76,104,4541536,4546653,5117
"15716",19,1,97,105,4549523,4553006,3483
"15810",19,5,59,106,4555347,4559098,3751
"15912",19,2,104,107,4561295,4565766,4471
"16016",19,2,62,108,4568158,4571145,2987
"16115",19,3,51,109,4577505,4581021,3516
"16318",19,3,87,110,4587369,4595369,8000
"16410",19,4,100,111,4598285,4602578,4293
"16514",19,2,128,112,4605004,4609670,4666
"16612",19,1,103,113,4612285,4618651,6366
"16714",19,4,130,114,4621136,4628763,7627
"16814",19,4,94,115,4631679,4637790,6111
"16912",19,5,23,116,4640830,4643849,3019
"17116",19,5,29,117,4649896,4656059,6163
"17314",19,4,124,118,4663197,4667445,4248
"17410",19,4,82,119,4669747,4672838,3091
"17514",19,3,75,120,4675466,4683577,8111
"17614",19,5,47,121,4686330,4689656,3326
"17812",19,3,123,122,4696448,4702121,5673
"17914",19,2,110,123,4705030,4710331,5301
"18012",19,2,74,124,4712802,4717965,5163
"18119",19,2,68,125,4720613,4724312,3699
"18214",19,1,43,126,4727385,4730868,3483
"18412",19,1,133,127,4736882,4740294,3412
"18513",19,4,106,128,4742987,4750869,7882
"18613",19,4,34,129,4754288,4760491,6203
"18816",19,4,40,130,4771264,4777021,5757
"19014",19,1,61,131,4783617,4789127,5510
"19114",19,5,119,132,4791683,4796042,4359
"19216",19,6,18,133,4799416,4802703,3287
"19411",19,6,30,134,4817672,4820730,3058
"19613",19,3,3,135,4826908,4832234,5326
"1989",19,3,63,136,4842438,4851164,8726
"19915",19,6,48,137,4854099,4859975,5876
"20117",19,2,80,138,4866512,4875924,9412
"1080",20,2,103,1,5738681,5743831,5150
"1160",20,1,42,2,5746355,5749694,3339
"1360",20,1,120,3,5756539,5759571,3032
"1480",20,4,93,4,5761859,5764787,2928
"1560",20,3,8,5,5767481,5771428,3947
"1760",20,4,39,6,5776684,5779775,3091
"1950",20,2,31,7,5785809,5789658,3849
"2117",20,1,6,8,5797352,5802920,5568
"2314",20,6,71,9,5808523,5811633,3110
"2417",20,4,87,10,5814275,5817137,2862
"2514",20,4,129,11,5819798,5823098,3300
"2615",20,1,54,12,5825726,5828223,2497
"2812",20,4,9,13,5835407,5838713,3306
"3016",20,4,63,14,5846067,5849244,3177
"3113",20,4,21,15,5851708,5855800,4092
"3314",20,2,109,16,5861565,5865571,4006
"3415",20,5,124,17,5868474,5871912,3438
"3513",20,1,90,18,5875324,5878435,3111
"3615",20,4,99,19,5881168,5884357,3189
"378",20,2,55,20,5887443,5889985,2542
"3813",20,4,69,21,5892855,5895397,2542
"3915",20,1,126,22,5898672,5902626,3954
"4013",20,3,62,23,5905699,5909306,3607
"4115",20,6,41,24,5912072,5914542,2470
"4313",20,3,104,25,5920569,5924255,3686
"4416",20,6,23,26,5926910,5929563,2653
"4615",20,6,101,27,5934969,5938799,3830
"4713",20,2,133,28,5941362,5944328,2966
"4810",20,5,130,29,5946787,5951159,4372
"4913",20,4,105,30,5953741,5956401,2660
"5018",20,2,19,31,5959134,5961702,2568
"5217",20,2,1,32,5970024,5972618,2594
"5416",20,4,27,33,5978514,5981880,3366
"5614",20,6,95,34,5987541,5991423,3882
"5715",20,2,97,35,5993921,5996463,2542
"5812",20,1,114,36,5998999,6002496,3497
"5917",20,1,18,37,6005228,6008169,2941
"6112",20,6,65,38,6013366,6015941,2575
"6218",20,6,5,39,6018765,6022294,3529
"6415",20,1,72,40,6028125,6031354,3229
"6514",20,3,98,41,6033845,6036988,3143
"6611",20,6,29,42,6039577,6042518,2941
"6811",20,5,10,43,6048565,6051983,3418
"7016",20,2,73,44,6058003,6061735,3732
"7114",20,1,48,45,6064585,6066925,2340
"7314",20,5,22,46,6072985,6075945,2960
"7515",20,4,135,47,6081090,6084756,3666
"7617",20,6,35,48,6087208,6090449,3241
"7814",20,5,82,49,6096829,6099424,2595
"7914",20,1,60,50,6102026,6106300,4274
"8014",20,4,45,51,6109000,6112176,3176
"8218",20,4,57,52,6117563,6120758,3195
"8315",20,4,33,53,6123596,6126582,2986
"8512",20,2,79,54,6131949,6135060,3111
"8617",20,1,24,55,6138479,6142126,3647
"8816",20,5,46,56,6148199,6151832,3633
"9011",20,6,137,57,6157441,6159996,2555
"9116",20,3,68,58,6162468,6165918,3450
"9213",20,4,117,59,6168605,6170886,2281
"9316",20,2,115,60,6173560,6175913,2353
"9416",20,1,66,61,6178528,6181116,2588
"959",20,6,53,62,6183737,6187384,3647
"977",20,5,28,63,6192627,6196424,3797
"9913",20,3,128,64,6202725,6206986,4261
"10017",20,4,51,65,6209981,6213621,3640
"10218",20,5,16,66,6243656,6246800,3144
"10413",20,6,11,67,6252480,6255029,2549
"10614",20,6,59,68,6260677,6264297,3620
"10715",20,5,58,69,6266958,6269605,2647
"10813",20,5,106,70,6272377,6274586,2209
"10915",20,2,25,71,6277168,6279959,2791
"11118",20,5,52,72,6285300,6288142,2842
"11313",20,6,113,73,6293751,6297698,3947
"11414",20,3,14,74,6300124,6303274,3150
"11616",20,6,107,75,6308961,6311837,2876
"11714",20,6,77,76,6314223,6316850,2627
"11815",20,1,132,77,6319518,6322595,3077
"11914",20,3,50,78,6324851,6327609,2758
"12118",20,3,122,79,6332976,6334858,1882
"12215",20,6,119,80,6337604,6341499,3895
"12314",20,2,121,81,6343950,6347257,3307
"12412",20,6,125,82,6349500,6351761,2261
"12515",20,2,43,83,6354428,6356742,2314
"12713",20,5,112,84,6362193,6364775,2582
"12812",20,5,136,85,6367782,6371161,3379
"12916",20,1,138,86,6373652,6376932,3280
"13013",20,4,15,87,6379430,6382011,2581
"13215",20,1,36,88,6387587,6390410,2823
"13412",20,2,13,89,6395902,6399411,3509
"13611",20,3,92,90,6404209,6407228,3019
"13714",20,4,123,91,6409896,6413137,3241
"13812",20,3,26,92,6415929,6421576,5647
"14014",20,5,70,93,6427590,6431008,3418
"14123",20,5,40,94,6433662,6438257,4595
"14314",20,3,20,95,6443617,6446512,2895
"14511",20,5,4,96,6454905,6457977,3072
"14712",20,2,37,97,6463043,6467651,4608
"14917",20,4,81,98,6474201,6477161,2960
"15014",20,3,56,99,6479992,6484312,4320
"15117",20,6,89,100,6486953,6492424,5471
"15213",20,2,91,101,6495242,6498267,3025
"15315",20,3,134,102,6500784,6503817,3033
"15414",20,1,102,103,6507079,6509451,2372
"15510",20,4,111,104,6512707,6516804,4097
"15616",20,3,44,105,6519609,6522347,2738
"15811",20,2,127,106,6527904,6530145,2241
"15913",20,2,67,107,6532636,6536146,3510
"16017",20,3,116,108,6538336,6542009,3673
"16116",20,6,17,109,6544362,6548323,3961
"16319",20,3,80,110,6554062,6557833,3771
"16411",20,6,131,111,6560664,6564697,4033
"16515",20,1,12,112,6567109,6571272,4163
"16715",20,2,85,113,6577404,6581554,4150
"16815",20,3,74,114,6584489,6587881,3392
"16913",20,6,47,115,6590385,6593058,2673
"17117",20,1,84,116,6599778,6603640,3862
"17214",20,1,108,117,6606118,6608994,2876
"17315",20,3,32,118,6611811,6616641,4830
"17515",20,3,86,119,6622093,6625295,3202
"17615",20,1,78,120,6627852,6631472,3620
"17712",20,1,96,121,6634231,6637878,3647
"17813",20,4,75,122,6640251,6644722,4471
"17915",20,2,49,123,6647180,6651055,3875
"18120",20,3,110,124,6655919,6658683,2764
"18215",20,5,88,125,6661102,6664272,3170
"18313",20,2,7,126,6666632,6669187,2555
"18514",20,3,2,127,6676411,6679587,3176
"18712",20,3,38,128,6685071,6687306,2235
"18912",20,5,100,129,6692791,6695751,2960
"19015",20,4,3,130,6698183,6700719,2536
"19217",20,1,30,131,6706099,6708575,2476
"19412",20,6,83,132,6713910,6717099,3189
"19512",20,2,61,133,6719923,6723799,3876
"19614",20,5,64,134,6726623,6730590,3967
"19715",20,5,94,135,6733623,6738362,4739
"19810",20,5,76,136,6741134,6744519,3385
"19916",20,5,118,137,6747507,6751408,3901
"20011",20,5,34,138,6754383,6757167,2784
"1090",21,4,20,1,2136572,2139598,3026
"1260",21,1,59,2,2147847,2152252,4405
"1370",21,4,92,3,2154743,2159397,4654
"1490",21,1,23,4,2162084,2165070,2986
"1650",21,6,10,5,2171248,2176561,5313
"1870",21,2,120,6,2188354,2193066,4712
"1960",21,1,5,7,2195975,2199556,3581
"2118",21,5,93,8,2205276,2207838,2562
"2214",21,5,75,9,2213146,2218407,5261
"2315",21,6,70,10,2221408,2225885,4477
"2418",21,2,138,11,2229716,2233042,3326
"2515",21,6,34,12,2239403,2242696,3293
"2713",21,6,130,13,2251331,2254194,2863
"2813",21,3,79,14,2256711,2259782,3071
"2916",21,2,90,15,2262241,2265488,3247
"3017",21,3,37,16,2268012,2271103,3091
"3211",21,3,103,17,2277712,2282529,4817
"3315",21,4,38,18,2284811,2288549,3738
"3514",21,2,114,19,2294746,2299301,4555
"3616",21,2,36,20,2303655,2305635,1980
"3814",21,4,98,21,2311231,2314851,3620
"3916",21,1,95,22,2317270,2320008,2738
"4014",21,2,18,23,2322349,2325408,3059
"4213",21,3,91,24,2330886,2334179,3293
"4314",21,2,12,25,2336605,2339683,3078
"458",21,6,106,26,2345207,2349167,3960
"4616",21,6,46,27,2351606,2354710,3104
"4811",21,2,132,28,2360561,2363704,3143
"4914",21,6,40,29,2366117,2370084,3967
"518",21,4,8,30,2375804,2379039,3235
"5315",21,6,58,31,2384654,2388307,3653
"5417",21,4,14,32,2390988,2394647,3659
"5615",21,2,102,33,2401099,2403256,2157
"5716",21,6,64,34,2405989,2409139,3150
"5813",21,3,7,35,2412218,2415146,2928
"6014",21,2,24,36,2421349,2424591,3242
"6219",21,2,78,37,2430389,2432650,2261
"6312",21,3,43,38,2434997,2437781,2784
"6515",21,5,123,39,2443050,2447461,4411
"6612",21,6,28,40,2450541,2454697,4156
"6812",21,6,4,41,2460339,2463822,3483
"7017",21,3,97,42,2469150,2471724,2574
"7115",21,2,96,43,2474405,2478522,4117
"7212",21,6,88,44,2481150,2484039,2889
"7315",21,6,16,45,2486576,2490059,3483
"7516",21,5,21,46,2495962,2499053,3091
"7714",21,1,137,47,2504793,2508217,3424
"7815",21,5,45,48,2510675,2513185,2510
"8015",21,1,119,49,2518735,2522349,3614
"8110",21,3,13,50,2524735,2528702,3967
"8316",21,1,35,51,2534056,2537801,3745
"8513",21,5,63,52,2543612,2546435,2823
"8618",21,4,122,53,2549050,2551056,2006
"879",21,2,72,54,2553554,2556129,2575
"8817",21,1,41,55,2558620,2561345,2725
"9012",21,3,67,56,2566202,2569260,3058
"9117",21,1,125,57,2572032,2575169,3137
"9214",21,6,76,58,2577719,2580980,3261
"9317",21,4,26,59,2583210,2587477,4267
"9510",21,6,82,60,2593563,2597216,3653
"9615",21,5,87,61,2599753,2603145,3392
"978",21,5,129,62,2606041,2610577,4536
"9816",21,2,84,63,2613048,2616342,3294
"9914",21,6,112,64,2619493,2622669,3176
"10018",21,2,108,65,2626160,2628839,2679
"10116",21,1,77,66,2676190,2678483,2293
"10219",21,2,30,67,2680778,2683431,2653
"10414",21,4,32,68,2689341,2692517,3176
"10615",21,1,53,69,2698433,2701184,2751
"10814",21,3,55,70,2706904,2709008,2104
"10916",21,5,111,71,2712022,2714616,2594
"11012",21,5,3,72,2717081,2721336,4255
"11218",21,6,100,73,2728134,2731369,3235
"11314",21,6,118,74,2733742,2736879,3137
"11415",21,5,9,75,2739736,2742919,3183
"11617",21,1,83,76,2748606,2751730,3124
"11715",21,2,126,77,2754371,2758247,3876
"11816",21,4,56,78,2761947,2766117,4170
"11915",21,4,74,79,2769006,2772548,3542
"12012",21,4,50,80,2775464,2778947,3483
"12216",21,4,2,81,2784046,2786830,2784
"12413",21,4,68,82,2793001,2796831,3830
"12516",21,1,11,83,2799381,2802406,3025
"12714",21,5,57,84,2807420,2811760,4340
"12813",21,1,47,85,2814146,2817054,2908
"13014",21,3,85,86,2822219,2826558,4339
"13115",21,5,51,87,2829187,2832310,3123
"13314",21,1,29,88,2837978,2841082,3104
"13515",21,1,107,89,2846116,2851102,4986
"13612",21,6,22,90,2853940,2857384,3444
"13813",21,2,60,91,2862614,2865391,2777
"13915",21,6,52,92,2868013,2871542,3529
"14124",21,5,69,93,2877373,2880242,2869
"14215",21,3,73,94,2882726,2886386,3660
"14315",21,3,121,95,2888929,2892125,3196
"14415",21,4,110,96,2894492,2897439,2947
"14512",21,4,62,97,2899871,2903282,3411
"14614",21,2,48,98,2906205,2908603,2398
"14813",21,4,80,99,2914441,2917407,2966
"14918",21,6,94,100,2919996,2923329,3333
"15015",21,4,44,101,2926343,2928559,2216
"15214",21,5,27,102,2934030,2937553,3523
"15415",21,3,133,103,2942331,2944566,2235
"15511",21,1,17,104,2947201,2949704,2503
"15717",21,4,128,105,2954528,2958129,3601
"15812",21,6,124,106,2960529,2963188,2659
"15914",21,5,105,107,2965601,2968535,2934
"16018",21,1,89,108,2970921,2975039,4118
"16117",21,5,33,109,2977687,2980601,2914
"16320",21,2,42,110,2986217,2990569,4352
"16516",21,5,99,111,2995779,2998975,3196
"16613",21,1,113,112,3001727,3004433,2706
"16716",21,5,15,113,3006747,3009047,2300
"16914",21,1,101,114,3014303,3016976,2673
"17015",21,5,135,115,3019434,3023114,3680
"17118",21,4,134,116,3025716,3029016,3300
"17215",21,5,81,117,3031298,3033814,2516
"17316",21,5,39,118,3036579,3039592,3013
"17516",21,3,1,119,3044397,3046913,2516
"17713",21,1,131,120,3052410,3056044,3634
"17814",21,4,116,121,3058339,3062973,4634
"17916",21,3,109,122,3065281,3068829,3548
"18013",21,3,127,123,3071503,3073581,2078
"18121",21,6,136,124,3076026,3079013,2987
"18216",21,2,54,125,3081445,3084020,2575
"18413",21,3,31,126,3090354,3094668,4314
"18614",21,3,25,127,3100021,3103132,3111
"18817",21,3,49,128,3108911,3112159,3248
"19016",21,3,19,129,3116637,3119172,2535
"19218",21,1,71,130,3124245,3126193,1948
"19315",21,2,6,131,3128376,3132807,4431
"19513",21,5,117,132,3138135,3140775,2640
"19615",21,1,65,133,3143018,3145318,2300
"19716",21,4,104,134,3147744,3150861,3117
"19811",21,4,86,135,3153169,3155580,2411
"19917",21,3,115,136,3158483,3161705,3222
"20012",21,2,66,137,3164294,3166398,2104
"20118",21,3,61,138,3168967,3172268,3301
"10100",22,5,92,1,4624475,4629501,5026
"1170",22,3,78,2,4632018,4637482,5464
"1269",22,2,89,3,4640149,4645757,5608
"1380",22,1,58,4,4649967,4654300,4333
"14100",22,1,28,5,4658431,4664529,6098
"1660",22,2,47,6,4675420,4678347,2927
"1880",22,6,9,7,4685323,4690047,4724
"2021",22,6,63,8,4696421,4702179,5758
"2119",22,2,125,9,4705448,4710023,4575
"2215",22,4,133,10,4712644,4716781,4137
"2316",22,4,49,11,4719730,4724187,4457
"2516",22,4,103,12,4729214,4734109,4895
"2616",22,4,31,13,4736888,4742352,5464
"2814",22,2,107,14,4750666,4756065,5399
"2917",22,4,109,15,4758419,4764791,6372
"3018",22,6,57,16,4768184,4772439,4255
"3114",22,5,98,17,4779949,4785420,5471
"3212",22,6,39,18,4788094,4793910,5816
"3416",22,4,19,19,4802095,4806421,4326
"3617",22,1,106,20,4815272,4819115,3843
"379",22,3,24,21,4821638,4826815,5177
"3917",22,3,138,22,4834136,4839639,5503
"4015",22,5,80,23,4841901,4847091,5190
"4116",22,3,12,24,4849516,4853463,3947
"4315",22,3,54,25,4858595,4863013,4418
"459",22,2,17,26,4872217,4877380,5163
"4714",22,5,74,27,4883969,4889767,5798
"4812",22,6,51,28,4894009,4897159,3150
"5019",22,2,65,29,4902343,4907245,4902
"519",22,2,119,30,4909527,4915566,6039
"5218",22,5,122,31,4918638,4922004,3366
"5316",22,6,69,32,4925129,4927985,2856
"5418",22,5,62,33,4930600,4933501,2901
"5517",22,1,124,34,4937372,4941901,4529
"5616",22,4,67,35,4945431,4949097,3666
"5717",22,5,68,36,4954556,4959490,4934
"5814",22,2,41,37,4962929,4966922,3993
"6015",22,1,64,38,4973191,4976949,3758
"6113",22,3,108,39,4980551,4985132,4581
"6220",22,3,18,40,4988937,4993231,4294
"6416",22,5,14,41,5000206,5004526,4320
"6613",22,4,91,42,5011658,5016906,5248
"6717",22,5,26,43,5019580,5024096,4516
"6915",22,6,105,44,5030450,5033560,3110
"7018",22,1,76,45,5040196,5043561,3365
"7116",22,3,66,46,5046006,5049588,3582
"7213",22,3,126,47,5053588,5058013,4425
"7316",22,2,59,48,5061354,5065203,3849
"7415",22,3,72,49,5067851,5071596,3745
"7517",22,5,128,50,5074387,5078210,3823
"7618",22,2,71,51,5082943,5087035,4092
"7715",22,6,27,52,5089826,5095761,5935
"7915",22,5,116,53,5100984,5105232,4248
"8016",22,5,104,54,5108533,5113043,4510
"8111",22,6,75,55,5119501,5124436,4935
"8219",22,1,94,56,5127371,5133306,5935
"8317",22,1,52,57,5136280,5140313,4033
"8514",22,2,95,58,5146843,5151719,4876
"8619",22,5,44,59,5154366,5158445,4079
"8818",22,2,137,60,5168309,5172354,4045
"8911",22,4,121,61,5177113,5181100,3987
"9013",22,3,36,62,5184284,5188688,4404
"9215",22,1,70,63,5196330,5201212,4882
"9318",22,6,81,64,5203592,5207833,4241
"9417",22,3,42,65,5210259,5214193,3934
"9616",22,6,45,66,5238019,5241862,3843
"9817",22,4,115,67,5249902,5253889,3987
"9915",22,5,134,68,5297082,5300075,2993
"10019",22,4,61,69,5305357,5309585,4228
"10117",22,5,8,70,5312187,5317873,5686
"10316",22,6,117,71,5323816,5326351,2535
"10415",22,1,82,72,5329156,5332561,3405
"10514",22,4,85,73,5335143,5340744,5601
"10616",22,4,73,74,5344353,5348326,3973
"10716",22,2,35,75,5350889,5357641,6752
"10917",22,5,2,76,5364354,5369792,5438
"11119",22,4,79,77,5376094,5379727,3633
"11219",22,4,25,78,5382493,5385786,3293
"11416",22,2,23,79,5391415,5394447,3032
"11618",22,1,88,80,5399716,5404781,5065
"11716",22,5,32,81,5407311,5412023,4712
"11916",22,6,93,82,5417325,5420429,3104
"12013",22,2,53,83,5422999,5426345,3346
"12217",22,1,112,84,5431999,5435790,3791
"12315",22,2,11,85,5441301,5444097,2796
"12517",22,1,118,86,5450465,5453569,3104
"12610",22,3,120,87,5457491,5461308,3817
"12715",22,1,34,88,5467753,5472812,5059
"12917",22,5,56,89,5478597,5483721,5124
"13015",22,1,10,90,5488291,5492342,4051
"13216",22,2,83,91,5499729,5506513,6784
"13315",22,1,130,92,5511750,5519233,7483
"13413",22,3,90,93,5524744,5529528,4784
"13516",22,1,16,94,5533503,5537548,4045
"13715",22,5,110,95,5544595,5549248,4653
"13814",22,2,131,96,5551765,5555621,3856
"13916",22,4,97,97,5558406,5561478,3072
"14015",22,3,84,98,5565322,5570217,4895
"14125",22,1,22,99,5572937,5578740,5803
"14316",22,1,100,100,5585284,5588748,3464
"14416",22,4,43,101,5630882,5634914,4032
"14615",22,6,21,102,5640209,5644339,4130
"14814",22,3,30,103,5649896,5653288,3392
"15016",22,5,86,104,5659041,5661877,2836
"15118",22,2,5,105,5665002,5669426,4424
"15316",22,6,3,106,5675224,5679022,3798
"15512",22,5,20,107,5686062,5690186,4124
"15718",22,6,123,108,5699213,5703971,4758
"15813",22,3,96,109,5707769,5712324,4555
"15915",22,1,40,110,5715266,5720626,5360
"16118",22,3,114,111,5727274,5732979,5705
"16212",22,5,50,112,5736595,5740195,3600
"16412",22,5,38,113,5745981,5750078,4097
"16614",22,4,13,114,5755589,5760700,5111
"16816",22,4,37,115,5766106,5771322,5216
"17016",22,4,1,116,5779055,5782669,3614
"17216",22,3,6,117,5789258,5795925,6667
"17411",22,6,111,118,5802776,5807324,4548
"17517",22,6,129,119,5814417,5819410,4993
"17616",22,2,77,120,5822228,5826142,3914
"17714",22,1,136,121,5829901,5834659,4758
"17815",22,3,48,122,5838804,5841686,2882
"18014",22,1,4,123,5847334,5851262,3928
"18217",22,2,29,124,5858112,5861824,3712
"18414",22,6,33,125,5868303,5873276,4973
"18615",22,2,101,126,5880434,5883944,3510
"18713",22,4,127,127,5889396,5893179,3783
"18818",22,4,7,128,5896546,5901010,4464
"19017",22,6,15,129,5909064,5912475,3411
"19219",22,4,55,130,5917365,5920443,3078
"19316",22,6,99,131,5922816,5926123,3307
"19413",22,6,87,132,5928794,5932816,4022
"19514",22,2,113,133,5935248,5939751,4503
"19616",22,3,60,134,5942412,5947301,4889
"19717",22,3,102,135,5950204,5954536,4332
"19812",22,6,135,136,5961132,5966250,5118
"19918",22,3,132,137,5969290,5973512,4222
"20013",22,1,46,138,5976571,5979708,3137
"10101",23,4,24,1,6976390,6979435,3045
"1270",23,5,19,2,6984730,6987448,2718
"14101",23,3,101,3,6993227,6996730,3503
"1570",23,1,3,4,6999045,7001815,2770
"1770",23,2,4,5,7007320,7010489,3169
"1970",23,3,125,6,7015222,7018712,3490
"2022",23,4,138,7,7021275,7023752,2477
"2120",23,6,86,8,7026184,7028745,2561
"2216",23,2,118,9,7030995,7033635,2640
"2317",23,5,91,10,7036217,7038785,2568
"2419",23,4,120,11,7041224,7044269,3045
"2517",23,6,80,12,7046603,7049335,2732
"2617",23,2,136,13,7051832,7054120,2288
"2714",23,6,26,14,7057140,7059774,2634
"2918",23,2,106,15,7065043,7067846,2803
"3019",23,3,59,16,7071468,7073866,2398
"3115",23,2,16,17,7076226,7079428,3202
"3316",23,3,71,18,7084279,7087887,3608
"3417",23,5,73,19,7092227,7096090,3863
"3515",23,4,90,20,7098960,7102116,3156
"3618",23,1,9,21,7104653,7107313,2660
"3815",23,4,42,22,7114137,7117300,3163
"4016",23,1,111,23,7122844,7125981,3137
"4117",23,2,88,24,7128452,7131053,2601
"4214",23,2,112,25,7133544,7136007,2463
"4316",23,4,132,26,7138283,7141720,3437
"4417",23,4,48,27,7144296,7146792,2496
"4617",23,6,92,28,7152597,7157015,4418
"4715",23,5,79,29,7159402,7162794,3392
"4813",23,4,30,30,7165370,7169134,3764
"5020",23,6,44,31,7174605,7177311,2706
"5219",23,2,94,32,7182162,7185893,3731
"5317",23,4,102,33,7188247,7190521,2274
"5419",23,6,110,34,7193025,7195796,2771
"5518",23,4,12,35,7198489,7201868,3379
"5718",23,3,83,36,7207568,7211300,3732
"5815",23,1,21,37,7213974,7216549,2575
"6016",23,1,27,38,7221680,7224942,3262
"6221",23,5,109,39,7230315,7233125,2810
"6313",23,6,14,40,7235440,7238609,3169
"6516",23,2,130,41,7245113,7249734,4621
"6614",23,2,34,42,7252447,7255617,3170
"6813",23,5,85,43,7260847,7263428,2581
"6916",23,3,35,44,7266409,7269827,3418
"7117",23,6,32,45,7275998,7278494,2496
"7317",23,6,38,46,7283331,7285678,2347
"7518",23,6,68,47,7290561,7294188,3627
"7619",23,6,98,48,7297803,7300868,3065
"7716",23,3,113,49,7304836,7307659,2823
"7816",23,2,28,50,7310275,7313621,3346
"8017",23,1,87,51,7318903,7322490,3587
"8112",23,1,99,52,7325093,7328040,2947
"8220",23,3,47,53,7330577,7333923,3346
"8410",23,3,131,54,7338826,7341309,2483
"8515",23,4,72,55,7343957,7346891,2934
"8620",23,2,40,56,7349506,7351911,2405
"8819",23,3,77,57,7357239,7359643,2404
"8912",23,1,75,58,7362664,7366284,3620
"9014",23,3,29,59,7369004,7372219,3215
"9216",23,2,58,60,7378246,7380932,2686
"9319",23,2,70,61,7383698,7386259,2561
"9418",23,3,119,62,7388626,7392208,3582
"9511",23,1,15,63,7395026,7397581,2555
"979",23,2,10,64,7402653,7405365,2712
"9916",23,1,39,65,7410314,7412908,2594
"10118",23,3,11,66,7474782,7477351,2569
"10317",23,1,69,67,7483136,7486175,3039
"10416",23,4,84,68,7488862,7492593,3731
"10515",23,6,104,69,7494869,7497914,3045
"10617",23,3,95,70,7501248,7504921,3673
"10717",23,6,50,71,7507471,7510013,2542
"10918",23,1,93,72,7514831,7516987,2156
"11013",23,4,126,73,7519883,7522746,2863
"11120",23,6,128,74,7525237,7529341,4104
"11220",23,1,63,75,7532263,7534145,1882
"11315",23,5,67,76,7537146,7539498,2352
"11417",23,3,53,77,7541767,7546048,4281
"11619",23,3,137,78,7551905,7555094,3189
"11717",23,4,54,79,7557677,7561389,3712
"11917",23,2,76,80,7567253,7570494,3241
"12014",23,5,43,81,7572848,7574769,1921
"12218",23,6,62,82,7580084,7582188,2104
"12316",23,2,46,83,7584685,7586776,2091
"12518",23,5,37,84,7591405,7593973,2568
"12716",23,6,2,85,7598529,7600581,2052
"12918",23,3,65,86,7605687,7609131,3444
"13016",23,3,107,87,7611975,7614968,2993
"13116",23,5,49,88,7617642,7620445,2803
"13316",23,1,51,89,7625106,7628367,3261
"13517",23,5,25,90,7633022,7635191,2169
"13716",23,6,74,91,7640512,7643355,2843
"13815",23,5,97,92,7646068,7648356,2288
"13917",23,5,55,93,7650585,7652480,1895
"14016",23,4,6,94,7654879,7657402,2523
"14216",23,3,89,95,7662292,7665357,3065
"14317",23,6,134,96,7667684,7670847,3163
"14417",23,6,20,97,7673077,7675893,2816
"14616",23,1,117,98,7681116,7682756,1640
"14713",23,2,52,99,7685646,7688312,2666
"14919",23,6,122,100,7695294,7697372,2078
"15017",23,4,66,101,7699902,7702228,2326
"15119",23,5,103,102,7704752,7709092,4340
"15215",23,6,116,103,7711772,7715432,3660
"15317",23,5,133,104,7717675,7720485,2810
"15416",23,3,41,105,7722864,7726237,3373
"15617",23,1,81,106,7731068,7733525,2457
"15719",23,1,105,107,7736061,7739002,2941
"15814",23,4,114,108,7742075,7744806,2731
"15916",23,5,61,109,7748258,7750859,2601
"16019",23,4,18,110,7754095,7757003,2908
"16213",23,4,78,111,7762658,7764651,1993
"16321",23,2,64,112,7767528,7770207,2679
"16413",23,5,1,113,7772796,7774854,2058
"16615",23,1,123,114,7779234,7782423,3189
"16717",23,5,127,115,7785548,7787718,2170
"16817",23,4,108,116,7790418,7793065,2647
"16915",23,4,60,117,7795641,7798287,2646
"17017",23,1,135,118,7800542,7803255,2713
"17119",23,6,56,119,7806060,7808275,2215
"17217",23,2,124,120,7810753,7812942,2189
"17317",23,1,57,121,7815178,7817785,2607
"17412",23,1,129,122,7820204,7823040,2836
"17518",23,5,31,123,7826368,7829498,3130
"17715",23,3,5,124,7836532,7838695,2163
"17917",23,3,17,125,7844683,7848094,3411
"18122",23,3,23,126,7857220,7859808,2588
"18314",23,2,22,127,7865162,7867958,2796
"18515",23,5,13,128,7872561,7874698,2137
"18714",23,2,100,129,7880914,7883633,2719
"18819",23,5,121,130,7886464,7888888,2424
"18913",23,6,8,131,7891673,7894104,2431
"19115",23,4,96,132,7900177,7902856,2679
"19220",23,4,36,133,7905811,7907961,2150
"19414",23,2,82,134,7913217,7915230,2013
"19515",23,1,33,135,7917642,7920191,2549
"19718",23,1,45,136,7926309,7928557,2248
"19919",23,5,115,137,7932905,7935610,2705
"20014",23,5,7,138,7937879,7940088,2209
"10102",24,4,47,1,11738498,11741831,3333
"1280",24,5,90,2,11746519,11750839,4320
"1390",24,3,100,3,11753238,11757316,4078
"14102",24,4,53,4,11759886,11764199,4313
"1670",24,6,97,5,11769050,11773102,4052
"1780",24,6,55,6,11775867,11779318,3451
"1890",24,1,44,7,11782083,11786717,4634
"2023",24,6,73,8,11791469,11795476,4007
"2121",24,1,68,9,11797842,11802326,4484
"2217",24,6,37,10,11804791,11811111,6320
"2420",24,2,105,11,11816282,11820163,3881
"2518",24,5,78,12,11822720,11825491,2771
"2618",24,6,31,13,11827988,11833452,5464
"2815",24,4,11,14,11839263,11843498,4235
"3020",24,6,61,15,11849767,11855140,5373
"3116",24,2,93,16,11857801,11861977,4176
"3213",24,1,2,17,11864232,11868029,3797
"3418",24,1,122,18,11873619,11876592,2973
"3516",24,4,131,19,11880083,11885292,5209
"3619",24,4,113,20,11887829,11894874,7045
"3710",24,1,8,21,11897679,11906339,8660
"3918",24,2,75,22,11911595,11916000,4405
"4017",24,6,7,23,11918302,11922817,4515
"4215",24,3,106,24,11928093,11932145,4052
"4317",24,4,89,25,11934446,11939204,4758
"4418",24,1,92,26,11941846,11946316,4470
"4510",24,2,45,27,11948558,11952140,3582
"4716",24,3,94,28,11956977,11965768,8791
"4814",24,3,124,29,11968239,11973827,5588
"4915",24,1,104,30,11976456,11981867,5411
"5021",24,6,91,31,11984404,11988685,4281
"5110",24,5,96,32,11991509,11995365,3856
"5220",24,1,98,33,11998320,12004320,6000
"5318",24,1,134,34,12006556,12010836,4280
"5420",24,6,115,35,12013445,12017013,3568
"5519",24,3,112,36,12019315,12022935,3620
"5617",24,4,95,37,12026668,12030903,4235
"5719",24,4,17,38,12033995,12038368,4373
"5918",24,3,16,39,12045552,12049957,4405
"6114",24,3,58,40,12055160,12059859,4699
"6222",24,2,15,41,12062331,12065794,3463
"6417",24,1,128,42,12071684,12077030,5346
"6517",24,4,83,43,12079443,12083364,3921
"6615",24,3,88,44,12085522,12089619,4097
"6718",24,2,51,45,12092686,12096162,3476
"6917",24,2,99,46,12100719,12104542,3823
"7019",24,6,103,47,12106942,12111209,4267
"7118",24,5,30,48,12114484,12117497,3013
"7318",24,5,108,49,12122531,12126276,3745
"7416",24,5,54,50,12129309,12133348,4039
"7620",24,6,85,51,12141081,12145486,4405
"7717",24,5,36,52,12148016,12151434,3418
"7916",24,1,56,53,12157553,12161324,3771
"8018",24,3,136,54,12163887,12169984,6097
"8113",24,1,80,55,12172181,12176808,4627
"8221",24,2,135,56,12180711,12185103,4392
"8318",24,6,13,57,12187332,12190430,3098
"8516",24,5,138,58,12196261,12199542,3281
"8621",24,3,40,59,12201981,12209150,7169
"8820",24,5,72,60,12214230,12218497,4267
"8913",24,4,137,61,12220668,12224197,3529
"9015",24,5,102,62,12226564,12230439,3875
"9118",24,2,123,63,12233342,12237891,4549
"9217",24,2,129,64,12241519,12245453,3934
"9320",24,2,21,65,12248284,12252153,3869
"9512",24,2,3,66,12523074,12527374,4300
"9710",24,3,28,67,12532637,12536251,3614
"9917",24,5,114,68,12542010,12545755,3745
"10020",24,4,125,69,12548180,12550559,2379
"10119",24,3,130,70,12552965,12557638,4673
"10220",24,5,84,71,12560665,12564442,3777
"10318",24,2,39,72,12566842,12570253,3411
"10516",24,5,6,73,12574810,12579175,4365
"10718",24,4,59,74,12584261,12587359,3098
"10815",24,1,110,75,12589804,12593836,4032
"10919",24,5,12,76,12596125,12599837,3712
"11121",24,5,132,77,12605086,12608517,3431
"11221",24,1,14,78,12611008,12615975,4967
"11418",24,2,111,79,12621591,12625283,3692
"11511",24,3,10,80,12627689,12631911,4222
"11718",24,2,63,81,12637788,12640709,2921
"11817",24,4,29,82,12643298,12647206,3908
"12015",24,1,116,83,12653083,12657396,4313
"12119",24,4,35,84,12660391,12663044,2653
"12317",24,6,1,85,12669110,12672319,3209
"12519",24,4,41,86,12677052,12680019,2967
"12717",24,4,77,87,12685007,12687862,2855
"12814",24,4,107,88,12690131,12694085,3954
"12919",24,5,42,89,12696654,12699523,2869
"13117",24,4,23,90,12704661,12707334,2673
"13317",24,4,101,91,12712289,12715191,2902
"13414",24,2,33,92,12717636,12721557,3921
"13613",24,1,74,93,12726584,12729931,3347
"13717",24,2,117,94,12732147,12734702,2555
"13816",24,6,19,95,12737853,12740755,2902
"14017",24,5,18,96,12747227,12751586,4359
"14217",24,6,109,97,12756423,12759893,3470
"14318",24,5,24,98,12762548,12765724,3176
"14513",24,5,120,99,12770875,12773482,2607
"14617",24,2,57,100,12775869,12778914,3045
"14714",24,3,64,101,12781510,12787117,5607
"14815",24,6,43,102,12790249,12793654,3405
"15018",24,1,62,103,12798472,12801537,3065
"15120",24,3,52,104,12804093,12806890,2797
"15318",24,4,65,105,12811453,12813779,2326
"15417",24,5,126,106,12817532,12821100,3568
"15513",24,1,20,107,12823310,12826113,2803
"15720",24,4,5,108,12831742,12834402,2660
"15917",24,5,60,109,12839716,12842945,3229
"16020",24,3,34,110,12845318,12848644,3326
"16214",24,6,49,111,12854430,12857750,3320
"16414",24,6,67,112,12862633,12865365,2732
"16517",24,1,50,113,12867620,12872130,4510
"16718",24,4,71,114,12876758,12880555,3797
"16818",24,3,4,115,12883007,12886608,3601
"17018",24,6,133,116,12891609,12895301,3692
"17120",24,3,82,117,12897688,12900471,2783
"17218",24,6,79,118,12902904,12905929,3025
"17318",24,6,25,119,12911734,12914825,3091
"17519",24,1,26,120,12922108,12926140,4032
"17716",24,2,87,121,12931265,12935291,4026
"17816",24,2,81,122,12937913,12941357,3444
"17918",24,4,119,123,12943848,12947684,3836
"18015",24,3,46,124,12950175,12954018,3843
"18218",24,1,32,125,12958718,12961881,3163
"18415",24,3,118,126,12966483,12970051,3568
"18516",24,2,9,127,12972222,12976418,4196
"18715",24,3,22,128,12981491,12986007,4516
"18914",24,1,38,129,12991812,12995073,3261
"19116",24,6,121,130,12999590,13002335,2745
"19221",24,3,76,131,13004688,13007531,2843
"19317",24,5,48,132,13009708,13011610,1902
"19516",24,3,70,133,13016552,13020251,3699
"19617",24,2,27,134,13022369,13025872,3503
"19813",24,1,86,135,13030723,13033121,2398
"19920",24,6,127,136,13035553,13038664,3111
"20015",24,5,66,137,13042168,13046743,4575
"20119",24,2,69,138,13049051,13051299,2248
"10103",25,5,23,1,14069028,14072185,3157
"1290",25,4,34,2,14077891,14081715,3824
"14103",25,2,62,3,14086958,14090611,3653
"1580",25,2,32,4,14093187,14095735,2548
"1790",25,5,113,5,14101684,14103984,2300
"18100",25,3,63,6,14106632,14109514,2882
"1980",25,4,4,7,14111822,14114246,2424
"2122",25,2,98,8,14119764,14122587,2823
"2218",25,2,20,9,14125300,14127489,2189
"2421",25,5,35,10,14133444,14135463,2019
"2619",25,3,129,11,14140935,14145000,4065
"2715",25,1,37,12,14147700,14152419,4719
"2919",25,1,97,13,14157420,14160158,2738
"3021",25,4,106,14,14162401,14165720,3319
"3117",25,4,136,15,14168590,14171525,2935
"3214",25,5,95,16,14174624,14177453,2829
"3317",25,2,74,17,14179735,14182369,2634
"3419",25,1,91,18,14185082,14187722,2640
"3517",25,3,21,19,14190834,14194663,3829
"3711",25,4,88,20,14200821,14203605,2784
"3816",25,2,116,21,14206534,14209991,3457
"3919",25,5,131,22,14212482,14214436,1954
"4018",25,2,2,23,14217149,14220208,3059
"4216",25,6,18,24,14225653,14227666,2013
"4419",25,1,7,25,14232699,14235137,2438
"4618",25,6,120,26,14240824,14243327,2503
"4717",25,4,130,27,14245746,14249197,3451
"4815",25,6,48,28,14251661,14253380,1719
"5022",25,5,137,29,14258335,14260400,2065
"5111",25,6,138,30,14262982,14265394,2412
"5221",25,1,85,31,14268107,14270656,2549
"5319",25,2,104,32,14273539,14275408,1869
"5421",25,5,5,33,14278140,14280447,2307
"5618",25,6,72,34,14286239,14289239,3000
"5720",25,1,49,35,14291945,14294873,2928
"5919",25,5,41,36,14299893,14301743,1850
"6115",25,4,28,37,14306299,14309174,2875
"6314",25,2,26,38,14314653,14317038,2385
"6518",25,1,79,39,14322183,14324319,2136
"6616",25,5,89,40,14327340,14331640,4300
"6719",25,3,75,41,14334451,14338307,3856
"6814",25,1,25,42,14340929,14343164,2235
"7020",25,5,53,43,14348354,14350864,2510
"7214",25,3,117,44,14355851,14357766,1915
"7319",25,5,125,45,14360277,14364139,3862
"7417",25,4,112,46,14367048,14369009,1961
"7519",25,6,60,47,14371565,14374989,3424
"7621",25,5,83,48,14377402,14379957,2555
"7718",25,3,135,49,14382383,14386644,4261
"7817",25,2,128,50,14389337,14393147,3810
"7917",25,6,42,51,14395841,14398363,2522
"8114",25,4,52,52,14403789,14406456,2667
"8319",25,3,3,53,14411692,14415286,3594
"8517",25,5,11,54,14420359,14422221,1862
"8710",25,5,29,55,14428556,14431085,2529
"8914",25,6,132,56,14435857,14439543,3686
"9016",25,5,71,57,14442387,14444988,2601
"9119",25,4,100,58,14447903,14450655,2752
"9218",25,3,57,59,14453374,14456099,2725
"9321",25,3,33,60,14458460,14461479,3019
"9513",25,4,22,61,14466983,14470336,3353
"9711",25,3,93,62,14476258,14479846,3588
"9818",25,4,10,63,14482376,14484598,2222
"10021",25,4,70,64,14489972,14492670,2698
"10120",25,2,86,65,14495429,14498632,3203
"10221",25,3,87,66,14523497,14526196,2699
"10319",25,2,38,67,14529308,14531935,2627
"10517",25,1,61,68,14537713,14540759,3046
"10618",25,1,67,69,14544237,14546655,2418
"10719",25,3,45,70,14549551,14552067,2516
"10920",25,1,13,71,14557538,14560021,2483
"11122",25,3,111,72,14564931,14569270,4339
"11222",25,6,90,73,14572003,14574611,2608
"11316",25,6,114,74,14577291,14580186,2895
"11419",25,1,103,75,14582814,14586919,4105
"11512",25,3,99,76,14589671,14593363,3692
"11620",25,4,118,77,14596083,14598763,2680
"11719",25,4,94,78,14601580,14603998,2418
"11818",25,4,40,79,14606914,14610110,3196
"12016",25,2,134,80,14615876,14619123,3247
"12120",25,3,27,81,14621771,14625026,3255
"12318",25,3,69,82,14630634,14632987,2353
"12414",25,5,119,83,14636308,14639635,3327
"12520",25,5,65,84,14642407,14644975,2568
"12611",25,6,66,85,14647897,14650877,2980
"12718",25,4,76,86,14653185,14656538,3353
"12815",25,6,78,87,14659591,14661473,1882
"12920",25,2,44,88,14663735,14665715,1980
"13118",25,1,115,89,14670572,14672264,1692
"13217",25,2,14,90,14675514,14678219,2705
"13415",25,6,12,91,14683455,14685553,2098
"13614",25,4,82,92,14691377,14693625,2248
"13718",25,6,30,93,14696763,14698835,2072
"13918",25,4,124,94,14703947,14705685,1738
"14018",25,4,46,95,14708483,14710881,2398
"14218",25,3,81,96,14716366,14718548,2182
"14319",25,5,17,97,14720883,14722954,2071
"14514",25,6,84,98,14727811,14732209,4398
"14618",25,6,108,99,14735047,14739308,4261
"14715",25,1,55,100,14741694,14743772,2078
"14816",25,3,15,101,14746303,14748001,1698
"15019",25,3,51,102,14753113,14755727,2614
"15216",25,6,36,103,14760624,14762852,2228
"15418",25,1,43,104,14768075,14772506,4431
"15618",25,5,59,105,14777298,14779611,2313
"15721",25,4,58,106,14782390,14784579,2189
"15815",25,1,73,107,14787024,14789141,2117
"15918",25,2,56,108,14792541,14796090,3549
"16021",25,4,16,109,14798607,14801410,2803
"16215",25,6,24,110,14806294,14809711,3417
"16415",25,2,8,111,14814967,14819241,4274
"16616",25,6,126,112,14824543,14827307,2764
"16719",25,6,102,113,14829628,14831288,1660
"16819",25,2,80,114,14834446,14836707,2261
"16916",25,1,1,115,14839361,14841164,1803
"17121",25,5,77,116,14846447,14850649,4202
"17219",25,1,133,117,14853218,14854924,1706
"17319",25,5,101,118,14857428,14859721,2293
"17413",25,2,50,119,14863049,14865839,2790
"17617",25,3,105,120,14871187,14873402,2215
"17717",25,1,31,121,14875958,14878631,2673
"17919",25,1,19,122,14884769,14888867,4098
"18123",25,3,39,123,14896940,14900352,3412
"18315",25,1,109,124,14905771,14907986,2215
"18416",25,1,127,125,14910490,14912594,2104
"18517",25,2,68,126,14915458,14917666,2208
"18616",25,5,47,127,14920367,14922673,2306
"18820",25,4,64,128,14928413,14932040,3627
"18915",25,5,107,129,14934786,14936936,2150
"19018",25,3,9,130,14939283,14942511,3228
"19222",25,1,121,131,14948238,14950394,2156
"19318",25,6,96,132,14952950,14955179,2229
"19415",25,2,110,133,14958062,14960643,2581
"19517",25,3,123,134,14963376,14966193,2817
"19618",25,6,54,135,14969318,14971435,2117
"19814",25,2,122,136,14981063,14983122,2059
"19921",25,2,92,137,14986221,14989083,2862
"20016",25,6,6,138,14991574,14993946,2372
"10104",26,5,28,1,16485053,16489066,4013
"12100",26,5,88,2,16495440,16499720,4280
"13100",26,4,39,3,16502264,16506675,4411
"1590",26,1,84,4,16512461,16517329,4868
"1680",26,3,2,5,16520101,16522938,2837
"18101",26,5,118,6,16529004,16532834,3830
"1990",26,1,72,7,16535286,16539370,4084
"2024",26,5,46,8,16541933,16546462,4529
"2219",26,6,41,9,16552509,16556332,3823
"2422",26,1,6,10,16561111,16567973,6862
"2620",26,6,125,11,16572778,16577869,5091
"2716",26,2,19,12,16580485,16583942,3457
"2920",26,6,23,13,16588877,16592609,3732
"3118",26,2,7,14,16597636,16602335,4699
"3318",26,2,61,15,16607532,16611499,3967
"3420",26,6,5,16,16614029,16616970,2941
"3620",26,2,79,17,16622945,16625892,2947
"3712",26,1,66,18,16628318,16634096,5778
"3817",26,3,122,19,16636587,16640540,3953
"3920",26,2,55,20,16643241,16646992,3751
"4019",26,1,96,21,16649424,16652482,3058
"4118",26,5,40,22,16654915,16659247,4332
"4318",26,4,105,23,16665713,16668595,2882
"4420",26,2,91,24,16671157,16674255,3098
"4511",26,3,68,25,16676864,16680327,3463
"4619",26,6,137,26,16682648,16685504,2856
"4718",26,1,54,27,16687773,16691361,3588
"4916",26,6,59,28,16696662,16699577,2915
"5023",26,2,109,29,16702310,16705819,3509
"5112",26,5,58,30,16708291,16711414,3123
"5222",26,4,3,31,16713664,16716970,3306
"5422",26,3,98,32,16721586,16724977,3391
"5520",26,4,57,33,16727495,16730690,3195
"5619",26,6,83,34,16733201,16737174,3973
"5721",26,5,124,35,16739561,16741959,2398
"5816",26,3,14,36,16744241,16748195,3954
"6017",26,1,42,37,16753601,16756489,2888
"6223",26,2,85,38,16762438,16767895,5457
"6315",26,5,16,39,16770537,16773700,3163
"6519",26,4,123,40,16779132,16782648,3516
"6617",26,3,104,41,16785047,16790348,5301
"6720",26,4,75,42,16792741,16795518,2777
"6815",26,2,49,43,16798114,16801518,3404
"7021",26,2,31,44,16806722,16811624,4902
"7215",26,1,120,45,16815880,16818690,2810
"7320",26,1,114,46,16842862,16848221,5359
"7418",26,4,111,47,16851032,16854097,3065
"7520",26,5,130,48,16856444,16861379,4935
"7622",26,5,136,49,16863994,16867601,3607
"7719",26,2,103,50,16870073,16873144,3071
"7818",26,3,8,51,16876498,16879256,2758
"8019",26,6,71,52,16884865,16887361,2496
"8115",26,5,64,53,16889787,16893871,4084
"8222",26,6,101,54,16896499,16899845,3346
"8320",26,2,25,55,16902265,16906885,4620
"8518",26,4,63,56,16912723,16915056,2333
"8622",26,3,56,57,16917671,16922304,4633
"8711",26,4,15,58,16926148,16927847,1699
"8915",26,5,10,59,16933044,16937841,4797
"9120",26,1,60,60,16942855,16946293,3438
"9219",26,4,87,61,16948961,16953954,4993
"9322",26,4,93,62,16957138,16960248,3110
"9419",26,3,44,63,16962850,16965745,2895
"9617",26,5,34,64,16970870,16974569,3699
"9819",26,6,65,65,16980257,16985649,5392
"9918",26,6,119,66,17142052,17146548,4496
"10022",26,6,95,67,17148948,17153287,4339
"10121",26,5,4,68,17155661,17158268,2607
"10320",26,6,29,69,17163321,17168112,4791
"10518",26,6,107,70,17173021,17176328,3307
"10619",26,1,78,71,17178858,17181871,3013
"10720",26,5,82,72,17184297,17188028,3731
"10816",26,1,102,73,17190447,17194525,4078
"10921",26,6,47,74,17196853,17201879,5026
"11123",26,6,89,75,17207069,17210356,3287
"11223",26,3,32,76,17212717,17216108,3391
"11420",26,2,133,77,17221528,17224285,2757
"11513",26,2,13,78,17226607,17230266,3659
"11720",26,1,138,79,17235110,17238901,3791
"11819",26,5,106,80,17241398,17244692,3294
"11918",26,1,36,81,17247503,17250516,3013
"12121",26,3,116,82,17255393,17259719,4326
"12219",26,4,135,83,17262825,17267112,4287
"12319",26,5,76,84,17270440,17273178,2738
"12415",26,3,74,85,17275597,17279172,3575
"12521",26,1,48,86,17281676,17284218,2542
"12719",26,4,27,87,17290578,17294094,3516
"12921",26,5,94,88,17299134,17304199,5065
"13017",26,4,21,89,17306769,17309514,2745
"13218",26,4,9,90,17317279,17320651,3372
"13416",26,3,38,91,17326378,17329626,3248
"13615",26,3,92,92,17334548,17338979,4431
"13719",26,4,69,93,17341392,17343843,2451
"13817",26,1,108,94,17346589,17351157,4568
"13919",26,5,52,95,17353426,17356157,2731
"14126",26,4,51,96,17361047,17363491,2444
"14320",26,2,67,97,17371558,17373361,1803
"14418",26,5,112,98,17375989,17379747,3758
"14515",26,4,45,99,17382578,17385970,3392
"14716",26,4,99,100,17391435,17397859,6424
"14817",26,3,86,101,17400304,17403552,3248
"14920",26,2,73,102,17405919,17409958,4039
"15020",26,1,90,103,17412482,17416749,4267
"15121",26,6,17,104,17419293,17424240,4947
"15319",26,4,129,105,17429385,17430763,1378
"15419",26,1,18,106,17433888,17436574,2686
"15619",26,4,33,107,17442262,17445836,3574
"15816",26,1,30,108,17451851,17455334,3483
"16022",26,4,117,109,17461171,17466164,4993
"16119",26,6,11,110,17468799,17472315,3516
"16322",26,1,12,111,17478787,17485002,6215
"16518",26,5,22,112,17494971,17501964,6993
"16720",26,2,37,113,17507802,17514011,6209
"16917",26,3,26,114,17519816,17524528,4712
"17122",26,3,62,115,17529170,17531659,2489
"17220",26,5,100,116,17534065,17537692,3627
"17320",26,6,53,117,17540085,17544536,4451
"17520",26,1,24,118,17550269,17553236,2967
"17718",26,6,77,119,17558649,17561452,2803
"17817",26,6,131,120,17564074,17566949,2875
"17920",26,6,113,121,17569407,17572995,3588
"18016",26,3,110,122,17577761,17581466,3705
"18124",26,3,50,123,17584663,17589500,4837
"18316",26,4,81,124,17595364,17599337,3973
"18417",26,3,134,125,17601606,17604082,2476
"18518",26,2,97,126,17606351,17610939,4588
"18617",26,2,115,127,17613463,17618462,4999
"18716",26,3,20,128,17620836,17623175,2339
"18916",26,2,127,129,17628706,17631261,2555
"19019",26,1,126,130,17633706,17637196,3490
"19117",26,6,35,131,17639517,17644275,4758
"19319",26,3,128,132,17649661,17655798,6137
"19416",26,2,1,133,17658328,17661426,3098
"19619",26,5,70,134,17666349,17669793,3444
"19719",26,1,132,135,17672277,17676937,4660
"19815",26,2,121,136,17679310,17684545,5235
"19922",26,2,43,137,17688716,17691474,2758
"20120",26,3,80,138,17696076,17699912,3836
"10105",27,4,56,1,21403126,21409995,6869
"1180",27,3,133,2,21412427,21417309,4882
"12101",27,3,49,3,21419780,21424930,5150
"14104",27,1,47,4,21429892,21433957,4065
"1690",27,6,58,5,21440729,21449932,9203
"17100",27,6,64,6,21452423,21459220,6797
"18102",27,6,28,7,21461940,21468371,6431
"2025",27,3,7,8,21474804,21479463,4659
"2220",27,6,40,9,21485373,21491778,6405
"2423",27,4,110,10,21498583,21503125,4542
"2519",27,2,48,11,21505583,21508001,2418
"2717",27,4,8,12,21512832,21518348,5516
"2921",27,2,132,13,21527199,21530846,3647
"3022",27,1,107,14,21533089,21538480,5391
"3119",27,4,128,15,21540788,21546553,5765
"3215",27,3,13,16,21548920,21555475,6555
"3421",27,6,10,17,21560476,21567149,6673
"3621",27,3,37,18,21573542,21578601,5059
"3818",27,6,130,19,21583373,21587098,3725
"3921",27,5,45,20,21589720,21594445,4725
"4119",27,6,88,21,21599544,21604354,4810
"4217",27,4,44,22,21606623,21610171,3548
"4421",27,3,67,23,21615166,21621401,6235
"4512",27,1,29,24,21623735,21627146,3411
"4719",27,1,119,25,21632402,21638964,6562
"4816",27,1,59,26,21641593,21645324,3731
"4917",27,6,46,27,21647730,21653129,5399
"5113",27,4,2,28,21659535,21663972,4437
"5320",27,6,118,29,21670137,21675738,5601
"5423",27,4,104,30,21678242,21681608,3366
"5521",27,2,42,31,21684007,21688876,4869
"5722",27,2,72,32,21694942,21697929,2987
"5817",27,4,98,33,21700172,21704498,4326
"5920",27,1,65,34,21706963,21712067,5104
"6018",27,2,126,35,21714545,21717937,3392
"6116",27,2,108,36,21720343,21725395,5052
"6224",27,2,6,37,21728226,21735141,6915
"6418",27,5,9,38,21740684,21744645,3961
"6618",27,2,54,39,21749619,21752076,2457
"6816",27,4,74,40,21765980,21770699,4719
"6918",27,5,129,41,21773307,21778340,5033
"7022",27,5,63,42,21780602,21786464,5862
"7119",27,3,31,43,21788929,21794831,5902
"7321",27,5,27,44,21801891,21805139,3248
"7521",27,3,121,45,21810970,21815002,4032
"7623",27,2,60,46,21817356,21821258,3902
"7720",27,2,90,47,21823990,21827265,3275
"7819",27,3,85,48,21829736,21834003,4267
"7918",27,3,25,49,21836638,21839867,3229
"8116",27,2,114,50,21844430,21848083,3653
"8223",27,6,136,51,21850672,21853867,3195
"8321",27,4,116,52,21856659,21860861,4202
"8411",27,6,124,53,21863320,21866136,2816
"8519",27,4,122,54,21868725,21871065,2340
"8623",27,6,94,55,21873510,21879033,5523
"8712",27,5,135,56,21881334,21889393,8059
"8821",27,1,77,57,21891877,21894923,3046
"8916",27,1,41,58,21897172,21899661,2489
"9121",27,5,111,59,21904930,21908152,3222
"9220",27,1,101,60,21910630,21915225,4595
"9323",27,5,21,61,21917886,21920127,2241
"9514",27,2,66,62,21925200,21928846,3646
"9618",27,2,84,63,21931187,21936507,5320
"9712",27,3,91,64,21939011,21941906,2895
"9820",27,5,3,65,21944796,21948789,3993
"10023",27,6,34,66,21988171,21991315,3144
"10222",27,3,43,67,21996296,21999897,3601
"10417",27,4,86,68,22004401,22008009,3608
"10519",27,3,127,69,22010663,22014453,3790
"10620",27,4,32,70,22016722,22019951,3229
"10817",27,5,81,71,22024840,22030285,5445
"10922",27,1,95,72,22032782,22036847,4065
"11014",27,4,134,73,22039247,22044410,5163
"11124",27,2,36,74,22046639,22049253,2614
"11317",27,3,109,75,22054771,22059470,4699
"11421",27,6,4,76,22061843,22065222,3379
"11621",27,1,113,77,22070144,22076033,5889
"11721",27,4,68,78,22078543,22082040,3497
"11820",27,2,102,79,22085001,22087517,2516
"11919",27,6,106,80,22090021,22092197,2176
"12017",27,5,123,81,22094754,22099263,4509
"12122",27,4,26,82,22101937,22105754,3817
"12320",27,1,5,83,22111094,22114800,3706
"12522",27,3,73,84,22121259,22123768,2509
"12612",27,5,93,85,22126194,22130775,4581
"12720",27,4,14,86,22133377,22136847,3470
"12922",27,6,70,87,22141561,22147044,5483
"13018",27,6,16,88,22149437,22152221,2784
"13219",27,1,17,89,22157385,22162320,4935
"13417",27,5,39,90,22167582,22172902,5320
"13616",27,5,33,91,22178092,22182896,4804
"13818",27,1,53,92,22188629,22191040,2411
"14019",27,1,35,93,22195322,22197668,2346
"14219",27,6,22,94,22204852,22208061,3209
"14419",27,2,78,95,22215932,22218781,2849
"14516",27,5,75,96,22221213,22231102,9889
"14619",27,2,120,97,22233567,22237475,3908
"14717",27,1,11,98,22239796,22242253,2457
"14921",27,5,57,99,22247104,22249469,2365
"15021",27,6,52,100,22251699,22255208,3509
"15217",27,6,76,101,22260196,22263895,3699
"15320",27,6,100,102,22267105,22270327,3222
"15420",27,3,19,103,22272641,22275922,3281
"15620",27,2,12,104,22284871,22286988,2117
"15817",27,5,69,105,22292061,22293812,1751
"15919",27,1,131,106,22296113,22300015,3902
"16023",27,4,38,107,22302669,22305087,2418
"16216",27,1,71,108,22309997,22312173,2176
"16323",27,2,24,109,22314775,22317467,2692
"16519",27,3,103,110,22322658,22326540,3882
"16617",27,3,1,111,22329854,22332788,2934
"16820",27,4,92,112,22337646,22341841,4195
"16918",27,5,87,113,22344254,22348306,4052
"17019",27,6,112,114,22350588,22354783,4195
"17123",27,3,55,115,22357902,22360692,2790
"17221",27,3,97,116,22363066,22367059,3993
"17321",27,1,89,117,22370419,22374844,4425
"17414",27,2,30,118,22377622,22379942,2320
"17618",27,1,137,119,22384642,22387746,3104
"17719",27,2,138,120,22390251,22393479,3228
"17818",27,2,18,121,22395917,22399734,3817
"18017",27,4,20,122,22404872,22407499,2627
"18219",27,5,117,123,22413049,22415245,2196
"18317",27,2,96,124,22417605,22420278,2673
"18418",27,3,61,125,22422952,22429181,6229
"18519",27,3,115,126,22432959,22435763,2804
"18618",27,5,51,127,22438201,22442646,4445
"18821",27,4,50,128,22447601,22450672,3071
"19020",27,4,80,129,22455804,22459202,3398
"19118",27,3,79,130,22461523,22464732,3209
"19223",27,6,82,131,22467301,22470275,2974
"19320",27,1,125,132,22472772,22475589,2817
"19417",27,4,62,133,22478230,22481740,3510
"19518",27,5,15,134,22484760,22487060,2300
"19720",27,1,23,135,22492493,22494289,1796
"19923",27,5,105,136,22499800,22503859,4059
"20017",27,1,83,137,22506513,22511121,4608
"20121",27,5,99,138,22513814,22517644,3830
"10106",28,2,5,1,26208120,26213179,5059
"12102",28,6,87,2,26219788,26225382,5594
"13101",28,4,73,3,26228671,26234952,6281
"14105",28,3,96,4,26237769,26241939,4170
"15100",28,5,32,5,26244142,26248606,4464
"17101",28,4,43,6,26254339,26259241,4902
"19100",28,3,66,7,26265340,26272588,7248
"2026",28,6,21,8,26275007,26279700,4693
"2221",28,4,79,9,26286655,26292249,5594
"2318",28,3,42,10,26294669,26301877,7208
"2520",28,4,127,11,26308604,26314310,5706
"2621",28,2,47,12,26316663,26320062,3399
"2816",28,6,69,13,26325337,26328768,3431
"2922",28,4,85,14,26331187,26336409,5222
"3023",28,3,12,15,26339580,26344815,5235
"3216",28,1,76,16,26350803,26354469,3666
"3319",28,5,104,17,26357581,26361731,4150
"3422",28,4,49,18,26366085,26371248,5163
"3622",28,5,62,19,26376360,26380536,4176
"3713",28,1,112,20,26405061,26409760,4699
"3819",28,2,89,21,26412761,26417630,4869
"3922",28,2,11,22,26420677,26425833,5156
"4120",28,6,57,23,26430900,26436390,5490
"4218",28,3,108,24,26439685,26443900,4215
"4319",28,6,75,25,26446600,26452031,5431
"4422",28,4,7,26,26455862,26462882,7020
"4620",28,5,74,27,26469347,26477758,8411
"4720",28,3,120,28,26479844,26483962,4118
"4817",28,6,15,29,26486923,26489544,2621
"5024",28,5,56,30,26496388,26500995,4607
"5114",28,5,38,31,26503983,26509094,5111
"5321",28,1,106,32,26514180,26517781,3601
"5424",28,5,92,33,26520160,26529769,9609
"5522",28,2,83,34,26532325,26537612,5287
"5620",28,1,58,35,26541044,26546868,5824
"5723",28,2,23,36,26550561,26554032,3471
"5921",28,3,6,37,26559490,26563359,3869
"6117",28,6,129,38,26568125,26575432,7307
"6225",28,6,3,39,26577877,26581988,4111
"6419",28,5,80,40,26588773,26594949,6176
"6520",28,4,13,41,26597329,26600708,3379
"6721",28,2,59,42,26605676,26610088,4412
"6817",28,1,88,43,26613330,26619088,5758
"6919",28,5,44,44,26622056,26627063,5007
"7120",28,4,19,45,26632796,26638188,5392
"7322",28,4,115,46,26648378,26652123,3745
"7419",28,1,40,47,26654660,26659614,4954
"7624",28,2,77,48,26666948,26670523,3575
"7721",28,4,91,49,26672949,26678046,5097
"7820",28,3,138,50,26680727,26686380,5653
"7919",28,1,130,51,26688891,26695806,6915
"8020",28,2,95,52,26698421,26704878,6457
"8117",28,1,124,53,26707605,26711134,3529
"8224",28,3,54,54,26713860,26717082,3222
"8412",28,3,18,55,26723416,26728867,5451
"8624",28,2,17,56,26734378,26738475,4097
"8822",28,6,45,57,26744149,26748626,4477
"9017",28,2,101,58,26754346,26761294,6948
"9122",28,2,65,59,26763706,26767621,3915
"9221",28,1,46,60,26770158,26774366,4208
"9420",28,5,134,61,26779439,26785119,5680
"9515",28,1,34,62,26787858,26793315,5457
"9713",28,3,60,63,26801755,26807526,5771
"9821",28,2,131,64,26810258,26814356,4098
"9919",28,3,24,65,26820762,26828233,7471
"10122",28,6,51,66,26904938,26909042,4104
"10321",28,1,118,67,26914200,26917709,3509
"10418",28,2,29,68,26920566,26924095,3529
"10621",28,3,72,69,26929874,26934344,4470
"10721",28,1,16,70,26936620,26940796,4176
"10923",28,6,105,71,26947150,26950908,3758
"11015",28,6,33,72,26953170,26961431,8261
"11224",28,6,111,73,26966740,26971661,4921
"11318",28,6,81,74,26974152,26977328,3176
"11422",28,6,117,75,26979976,26982975,2999
"11514",28,1,70,76,26985590,26990283,4693
"11622",28,4,121,77,26993271,26997159,3888
"11722",28,4,55,78,26999761,27004512,4751
"11821",28,2,71,79,27007879,27011729,3850
"11920",28,3,114,80,27014573,27020043,5470
"12018",28,4,1,81,27022455,27026651,4196
"12220",28,1,94,82,27036666,27041240,4574
"12321",28,2,113,83,27044176,27048489,4313
"12416",28,6,27,84,27050706,27056019,5313
"12613",28,6,39,85,27063380,27068935,5555
"12816",28,3,48,86,27074819,27077759,2940
"13019",28,2,35,87,27084597,27088400,3803
"13220",28,2,53,88,27095356,27100003,4647
"13418",28,2,107,89,27105422,27109624,4202
"13518",28,1,4,90,27112037,27115337,3300
"13720",28,5,122,91,27121619,27125678,4059
"13819",28,4,67,92,27128201,27132645,4444
"13920",28,4,109,93,27134914,27142443,7529
"14020",28,5,110,94,27145431,27148784,3353
"14127",28,3,36,95,27154040,27158294,4254
"14321",28,5,8,96,27164145,27170497,6352
"14517",28,4,25,97,27175577,27178661,3084
"14718",28,6,135,98,27183309,27186845,3536
"14818",28,5,14,99,27189440,27195538,6098
"15022",28,6,93,100,27201363,27207245,5882
"15122",28,4,61,101,27209860,27215121,5261
"15218",28,1,22,102,27217730,27223063,5333
"15421",28,1,64,103,27228685,27232502,3817
"15514",28,3,30,104,27234973,27240809,5836
"15722",28,3,78,105,27247366,27251294,3928
"15818",28,5,50,106,27253942,27257510,3568
"16024",28,5,20,107,27262171,27266608,4437
"16217",28,5,128,108,27272165,27278217,6052
"16324",28,3,102,109,27280885,27285342,4457
"16416",28,6,123,110,27291434,27297081,5647
"16520",28,3,126,111,27300396,27305742,5346
"16618",28,5,98,112,27308435,27312461,4026
"16721",28,2,41,113,27315691,27320266,4575
"16919",28,1,52,114,27325071,27328671,3600
"17124",28,6,9,115,27335986,27341927,5941
"17322",28,3,90,116,27346614,27352961,6347
"17415",28,2,125,117,27355321,27360111,4790
"17521",28,1,136,118,27362694,27367752,5058
"17619",28,4,133,119,27370165,27374583,4418
"17720",28,5,86,120,27376937,27380329,3392
"17819",28,5,26,121,27382735,27387662,4927
"18018",28,2,137,122,27396474,27401428,4954
"18125",28,1,10,123,27403893,27410180,6287
"18318",28,1,100,124,27416122,27419592,3470
"18419",28,6,99,125,27421776,27427469,5693
"18520",28,1,28,126,27430182,27434018,3836
"18717",28,3,132,127,27440771,27444895,4124
"18822",28,3,84,128,27447196,27453359,6163
"18917",28,4,97,129,27455491,27459902,4411
"19021",28,4,31,130,27462498,27466877,4379
"19224",28,5,68,131,27472152,27476420,4268
"19321",28,4,37,132,27479114,27484028,4914
"19519",28,5,116,133,27489336,27494735,5399
"19620",28,5,2,134,27500703,27506062,5359
"19816",28,2,119,135,27512090,27519978,7888
"19924",28,6,63,136,27527895,27534947,7052
"20018",28,4,103,137,27537359,27542019,4660
"20122",28,1,82,138,27544771,27549882,5111
"10107",29,5,121,1,31280538,31282852,2314
"1190",29,4,30,2,31285271,31287643,2372
"13102",29,5,73,3,31293801,31296094,2293
"14106",29,3,107,4,31298879,31300853,1974
"15101",29,3,113,5,31305697,31307670,1973
"16100",29,5,7,6,31312155,31314860,2705
"18103",29,5,31,7,31320600,31322586,1986
"2027",29,6,86,8,31327175,31329430,2255
"2123",29,1,81,9,31333287,31335528,2241
"2222",29,3,101,10,31338425,31340842,2417
"2319",29,6,104,11,31343869,31347601,3732
"2424",29,1,21,12,31350000,31353059,3059
"2622",29,5,13,13,31358066,31360465,2399
"2817",29,2,82,14,31366087,31367982,1895
"2923",29,5,109,15,31370525,31373387,2862
"3024",29,1,33,16,31375930,31378453,2523
"3217",29,2,10,17,31384277,31386499,2222
"3423",29,5,55,18,31391539,31392800,1261
"3518",29,3,137,19,31399494,31401016,1522
"3623",29,4,72,20,31403298,31405448,2150
"3714",29,5,67,21,31407900,31409762,1862
"3820",29,6,44,22,31412730,31414311,1581
"4020",29,5,97,23,31419064,31420939,1875
"4121",29,2,34,24,31423489,31426221,2732
"4320",29,6,20,25,31433470,31434927,1457
"4513",29,2,94,26,31440157,31442627,2470
"4621",29,1,87,27,31446112,31447778,1666
"4721",29,5,61,28,31450504,31452059,1555
"4818",29,5,43,29,31476695,31478276,1581
"5025",29,4,60,30,31486166,31487872,1706
"5115",29,3,59,31,31490971,31492513,1542
"5223",29,6,62,32,31494683,31497140,2457
"5322",29,3,29,33,31499474,31501487,2013
"5523",29,3,17,34,31506691,31508259,1568
"5724",29,4,132,35,31515070,31516743,1673
"5818",29,1,93,36,31519280,31520776,1496
"5922",29,6,14,37,31523136,31524770,1634
"6118",29,6,110,38,31530241,31531986,1745
"6226",29,4,42,39,31534418,31536699,2281
"6420",29,6,116,40,31543144,31544849,1705
"6521",29,2,106,41,31547255,31548562,1307
"6619",29,2,118,42,31550994,31552543,1549
"6722",29,1,51,43,31554681,31556465,1784
"6920",29,1,3,44,31560629,31562119,1490
"7121",29,6,80,45,31571813,31573858,2045
"7216",29,1,27,46,31576107,31577701,1594
"7420",29,4,18,47,31583983,31585199,1216
"7625",29,6,74,48,31589409,31590813,1404
"7722",29,5,79,49,31597664,31599291,1627
"7821",29,1,135,50,31602959,31604631,1672
"7920",29,5,19,51,31607586,31609096,1510
"8118",29,2,124,52,31614933,31617554,2621
"8225",29,4,102,53,31621568,31623240,1672
"8322",29,5,127,54,31627542,31628770,1228
"8413",29,1,57,55,31631431,31633078,1647
"8520",29,3,89,56,31636837,31638725,1888
"8625",29,2,16,57,31646785,31648222,1437
"8823",29,4,36,58,31652746,31654197,1451
"9018",29,3,83,59,31659322,31661334,2012
"9123",29,2,76,60,31663937,31665929,1992
"9222",29,2,88,61,31668943,31670662,1719
"9324",29,6,128,62,31672950,31674590,1640
"9421",29,6,98,63,31677244,31678669,1425
"9516",29,4,24,64,31682474,31684042,1568
"9714",29,1,75,65,31693880,31695873,1993
"9822",29,4,6,66,31821921,31823633,1712
"10024",29,3,41,67,31829457,31832581,3124
"10223",29,3,47,68,31837543,31839287,1744
"10419",29,1,123,69,31844811,31846713,1902
"10520",29,6,26,70,31849014,31850661,1647
"10722",29,5,1,71,31855701,31857060,1359
"10924",29,6,8,72,31861897,31863367,1470
"11125",29,2,28,73,31869316,31871317,2001
"11319",29,3,11,74,31875990,31877394,1404
"11515",29,6,2,75,31883062,31884310,1248
"11723",29,6,50,76,31890468,31891768,1300
"11921",29,3,77,77,31897370,31899076,1706
"12019",29,4,90,78,31901501,31902814,1313
"12123",29,6,134,79,31905214,31906651,1437
"12221",29,1,15,80,31908907,31910273,1366
"12417",29,2,64,81,31915025,31916580,1555
"12523",29,3,131,82,31919248,31920548,1300
"12614",29,2,52,83,31922764,31924254,1490
"12817",29,6,92,84,31929006,31930222,1216
"12923",29,1,9,85,31932523,31934248,1725
"13119",29,2,136,86,31938981,31941000,2019
"13221",29,1,63,87,31944282,31946582,2300
"13318",29,3,71,88,31949276,31950988,1712
"13419",29,5,25,89,31953832,31956053,2221
"13617",29,3,5,90,31962754,31963975,1221
"13820",29,3,65,91,31969022,31970976,1954
"13921",29,1,111,92,31976206,31977820,1614
"14021",29,2,100,93,31980003,31981526,1523
"14128",29,5,37,94,31983716,31985134,1418
"14322",29,5,115,95,31990468,31992258,1790
"14420",29,2,4,96,31994782,31996788,2006
"14620",29,1,39,97,32000978,32002252,1274
"14819",29,2,130,98,32006822,32008822,2000
"14922",29,5,103,99,32012110,32014136,2026
"15023",29,4,126,100,32016300,32017371,1071
"15123",29,1,99,101,32019705,32021345,1640
"15219",29,4,48,102,32026392,32027718,1326
"15422",29,4,108,103,32034124,32035895,1771
"15515",29,2,112,104,32038805,32040255,1450
"15621",29,6,38,105,32043086,32044177,1091
"15819",29,6,32,106,32050439,32052125,1686
"16025",29,5,133,107,32057250,32058675,1425
"16120",29,1,105,108,32061368,32062694,1326
"16218",29,1,45,109,32084527,32085709,1182
"16417",29,3,23,110,32092364,32094049,1685
"16619",29,3,119,111,32098867,32101527,2660
"16722",29,5,85,112,32104247,32106057,1810
"16821",29,2,22,113,32108332,32110175,1843
"17020",29,4,54,114,32115476,32117325,1849
"17222",29,2,46,115,32123431,32125130,1699
"17416",29,4,84,116,32131347,32133229,1882
"17522",29,4,120,117,32135536,32137974,2438
"17620",29,4,12,118,32140256,32142928,2672
"17820",29,4,66,119,32151544,32153524,1980
"17921",29,3,125,120,32155597,32157485,1888
"18019",29,4,96,121,32159878,32162243,2365
"18126",29,3,95,122,32164447,32167636,3189
"18220",29,5,49,123,32170624,32172715,2091
"18420",29,5,91,124,32178552,32180277,1725
"18521",29,4,78,125,32186664,32188337,1673
"18619",29,1,117,126,32193821,32195318,1497
"18718",29,4,138,127,32198456,32200070,1614
"18823",29,2,70,128,32205286,32206978,1692
"18918",29,3,53,129,32209751,32211129,1378
"19119",29,6,122,130,32218071,32219803,1732
"19225",29,1,69,131,32222353,32223869,1516
"19322",29,3,35,132,32227137,32228921,1784
"19520",29,6,56,133,32233902,32236569,2667
"19621",29,4,114,134,32239504,32241961,2457
"19721",29,2,58,135,32244119,32246746,2627
"19817",29,6,68,136,32249897,32251832,1935
"19925",29,2,40,137,32254734,32256648,1914
"20123",29,1,129,138,32265277,32267316,2039
"10108",30,3,16,1,33479528,33486077,6549
"12103",30,5,84,2,33491862,33498581,6719
"13103",30,4,107,3,33501745,33506222,4477
"14107",30,5,72,4,33510210,33514967,4757
"15102",30,6,73,5,33517792,33521870,4078
"16101",30,4,29,6,33525943,33533112,7169
"18104",30,6,43,7,33541833,33549068,7235
"2028",30,5,126,8,33559102,33563167,4065
"2124",30,2,93,9,33566004,33570095,4091
"2223",30,2,135,10,33572900,33580743,7843
"2320",30,5,48,11,33583110,33585704,2594
"2521",30,4,47,12,33594098,33600104,6006
"2718",30,3,82,13,33605412,33608157,2745
"2818",30,2,129,14,33611556,33618831,7275
"2924",30,6,7,15,33621439,33625779,4340
"3120",30,1,2,16,33632780,33638387,5607
"3320",30,4,137,17,33645480,33650205,4725
"3424",30,4,11,18,33652598,33656598,4000
"3624",30,2,69,19,33669861,33673383,3522
"3715",30,3,76,20,33675835,33685515,9680
"3821",30,2,81,21,33687816,33691188,3372
"3923",30,1,116,22,33693843,33698326,4483
"4021",30,3,130,23,33700719,33707575,6856
"4122",30,3,46,24,33710125,33715340,5215
"4321",30,2,63,25,33722962,33726099,3137
"4423",30,5,36,26,33729499,33734897,5398
"4622",30,2,99,27,33741421,33744519,3098
"4722",30,6,79,28,33747800,33753918,6118
"4819",30,6,25,29,33759056,33763357,4301
"5026",30,6,133,30,33786548,33790476,3928
"5116",30,1,80,31,33793013,33796594,3581
"5224",30,1,98,32,33799562,33803778,4216
"5323",30,1,92,33,33806654,33810405,3751
"5425",30,3,22,34,33813498,33818765,5267
"5621",30,6,37,35,33825649,33832472,6823
"5819",30,6,67,36,33844729,33847480,2751
"5923",30,2,123,37,33850317,33854539,4222
"6019",30,4,35,38,33857664,33861298,3634
"6227",30,6,85,39,33867462,33871841,4379
"6316",30,6,1,40,33874685,33877403,2718
"6522",30,1,20,41,33883045,33886018,2973
"6723",30,5,96,42,33896294,33899444,3150
"6818",30,6,109,43,33902059,33906418,4359
"6921",30,2,27,44,33908948,33912850,3902
"7122",30,2,57,45,33918158,33922400,4242
"7217",30,5,42,46,33927447,33932283,4836
"7421",30,6,55,47,33942983,33946068,3085
"7522",30,4,65,48,33949925,33953637,3712
"7626",30,4,77,49,33957344,33962128,4784
"7723",30,3,70,50,33966162,33969226,3064
"7822",30,2,111,51,33972456,33974586,2130
"7921",30,2,15,52,33977561,33980391,2830
"8119",30,3,106,53,33986013,33990032,4019
"8226",30,1,104,54,33994621,33999215,4594
"8323",30,1,128,55,34001772,34006784,5012
"8414",30,6,19,56,34010060,34012438,2378
"8626",30,2,87,57,34027486,34032048,4562
"8713",30,1,134,58,34037879,34041355,3476
"8824",30,5,114,59,34044212,34050088,5876
"8917",30,5,12,60,34052520,34058089,5569
"9124",30,3,34,61,34065593,34068612,3019
"9325",30,1,50,62,34075927,34077940,2013
"9517",30,4,5,63,34082921,34086921,4000
"9715",30,1,110,64,34093451,34095418,1967
"9823",30,5,54,65,34099131,34101608,2477
"10025",30,5,30,66,34179123,34181358,2235
"10224",30,4,53,67,34187019,34189235,2216
"10420",30,2,21,68,34193896,34197281,3385
"10622",30,3,112,69,34204236,34207471,3235
"10723",30,6,103,70,34210099,34212641,2542
"10818",30,5,90,71,34216224,34220178,3954
"10925",30,6,97,72,34223303,34227538,4235
"11016",30,5,66,73,34230891,34234708,3817
"11126",30,2,105,74,34237160,34240597,3437
"11225",30,3,118,75,34243357,34246206,2849
"11320",30,5,6,76,34249481,34255553,6072
"11516",30,1,74,77,34261979,34266397,4418
"11623",30,3,88,78,34269221,34274920,5699
"11724",30,6,121,79,34277306,34282365,5059
"11822",30,3,94,80,34287660,34292705,5045
"11922",30,6,31,81,34295125,34298928,3803
"12124",30,4,59,82,34304210,34307412,3202
"12222",30,5,18,83,34310407,34314733,4326
"12418",30,3,100,84,34319904,34325780,5876
"12524",30,6,49,85,34328375,34333238,4863
"12721",30,4,113,86,34339343,34342127,2784
"12818",30,1,68,87,34346082,34350853,4771
"12924",30,2,51,88,34355906,34358749,2843
"13120",30,1,44,89,34365345,34368057,2712
"13319",30,4,23,90,34373581,34377299,3718
"13519",30,5,132,91,34384085,34389614,5529
"13618",30,1,122,92,34392595,34395647,3052
"13721",30,1,38,93,34398537,34402510,3973
"13922",30,2,33,94,34407661,34412942,5281
"14129",30,2,39,95,34419420,34423923,4503
"14323",30,1,8,96,34429624,34433989,4365
"14518",30,1,26,97,34440860,34446173,5313
"14719",30,1,14,98,34452311,34455605,3294
"14923",30,3,124,99,34463410,34466573,3163
"15024",30,4,89,100,34468875,34474155,5280
"15124",30,3,64,101,34476731,34482038,5307
"15220",30,6,127,102,34485046,34490758,5712
"15321",30,5,138,103,34493896,34496726,2830
"15423",30,4,83,104,34499785,34503563,3778
"15516",30,2,45,105,34506446,34510530,4084
"15723",30,6,61,106,34516185,34519603,3418
"15820",30,2,9,107,34522395,34528068,5673
"16026",30,4,71,108,34624107,34627140,3033
"16121",30,2,75,109,34630173,34633990,3817
"16219",30,3,52,110,34636258,34640617,4359
"16418",30,1,32,111,34647795,34650651,2856
"16620",30,5,120,112,34655966,34658861,2895
"16723",30,2,3,113,34661959,34665194,3235
"16920",30,1,56,114,34670352,34676489,6137
"17021",30,5,108,115,34678980,34682326,3346
"17125",30,4,95,116,34684673,34690137,5464
"17223",30,6,13,117,34692471,34696641,4170
"17417",30,4,119,118,34701576,34704570,2994
"17523",30,5,102,119,34706825,34710021,3196
"17621",30,6,91,120,34713819,34716963,3144
"17721",30,6,115,121,34719584,34722780,3196
"17821",30,4,131,122,34725055,34729003,3948
"17922",30,3,28,123,34732330,34736245,3915
"18127",30,3,136,124,34742239,34744605,2366
"18221",30,4,17,125,34748122,34752533,4411
"18421",30,4,41,126,34757567,34759848,2281
"18620",30,5,78,127,34764463,34767260,2797
"18719",30,4,125,128,34769509,34774202,4693
"18824",30,3,4,129,34777320,34782620,5300
"19022",30,1,62,130,34787563,34790837,3274
"19120",30,3,40,131,34794380,34798733,4353
"19323",30,5,24,132,34804479,34811361,6882
"19521",30,5,60,133,34817806,34821989,4183
"19622",30,3,10,134,34824081,34829872,5791
"19818",30,3,58,135,34835442,34839775,4333
"19926",30,1,86,136,34843050,34846095,3045
"20019",30,4,101,137,34848423,34852723,4300
"20124",30,2,117,138,34855809,34859162,3353
"10109",31,2,116,1,35882381,35886197,3816
"11100",31,1,61,2,35888590,35891269,2679
"12104",31,6,48,3,35893741,35896159,2418
"14108",31,6,78,4,35901205,35903048,1843
"15103",31,6,6,5,35905330,35913336,8006
"17102",31,1,115,6,35917991,35920245,2254
"18105",31,6,126,7,35922632,35928403,5771
"19101",31,4,52,8,35930828,35933691,2863
"2125",31,3,33,9,35938757,35942044,3287
"2321",31,6,42,10,35947869,35952221,4352
"2522",31,6,138,11,35957686,35960817,3131
"2623",31,1,31,12,35963255,35967013,3758
"2819",31,4,28,13,35971798,35976733,4935
"3025",31,4,76,14,35982230,35987034,4804
"3121",31,1,85,15,35989649,35992845,3196
"3218",31,1,133,16,35995349,35997048,1699
"3321",31,2,32,17,35999297,36005029,5732
"3519",31,3,27,18,36010154,36012807,2653
"3716",31,2,92,19,36017560,36023775,6215
"3822",31,6,114,20,36026684,36030501,3817
"3924",31,5,59,21,36032868,36035031,2163
"4022",31,2,134,22,36037469,36041606,4137
"4123",31,4,118,23,36043934,36046005,2071
"4219",31,2,44,24,36048509,36049973,1464
"4424",31,5,107,25,36054575,36056588,2013
"4514",31,6,108,26,36059013,36062085,3072
"4623",31,6,90,27,36064576,36070360,5784
"4723",31,1,55,28,36073766,36075341,1575
"4820",31,5,23,29,36077805,36079975,2170
"5027",31,6,24,30,36084839,36086975,2136
"5225",31,1,7,31,36092656,36094564,1908
"5426",31,2,80,32,36099728,36102061,2333
"5524",31,6,66,33,36104912,36108977,4065
"5622",31,4,4,34,36111402,36113206,1804
"5820",31,5,101,35,36117651,36120030,2379
"5924",31,1,91,36,36123109,36124827,1718
"6020",31,5,137,37,36128168,36129998,1830
"6119",31,2,56,38,36132338,36134776,2438
"6228",31,2,98,39,36137757,36139724,1967
"6317",31,2,122,40,36142784,36144175,1391
"6421",31,2,128,41,36146549,36151960,5411
"6523",31,1,1,42,36154817,36157052,2235
"6724",31,4,58,43,36163615,36166438,2823
"6819",31,3,45,44,36168812,36171059,2247
"7023",31,5,5,45,36176086,36178485,2399
"7218",31,5,77,46,36184551,36187668,3117
"7323",31,5,125,47,36190029,36192773,2744
"7422",31,4,64,48,36195578,36198695,3117
"7523",31,1,73,49,36201565,36203624,2059
"7627",31,2,14,50,36206213,36208709,2496
"7823",31,2,104,51,36214573,36218762,4189
"7922",31,1,103,52,36221246,36223821,2575
"8021",31,3,51,53,36226338,36228455,2117
"8227",31,5,83,54,36233914,36235998,2084
"8324",31,4,16,55,36238332,36240280,1948
"8521",31,5,65,56,36245202,36247365,2163
"8627",31,5,113,57,36249993,36251842,1849
"8714",31,3,3,58,36254490,36256418,1928
"8918",31,5,41,59,36261177,36263314,2137
"9125",31,3,75,60,36267668,36270870,3202
"9223",31,2,74,61,36274041,36276079,2038
"9326",31,3,9,62,36278557,36285479,6922
"9518",31,4,40,63,36291833,36294636,2803
"9716",31,4,136,64,36300382,36302565,2183
"9824",31,2,62,65,36305383,36308382,2999
"9920",31,6,96,66,36349876,36352490,2614
"10026",31,2,2,67,36355360,36357778,2418
"10225",31,3,57,68,36363373,36364987,1614
"10322",31,6,102,69,36367289,36369144,1855
"10421",31,1,109,70,36371635,36374197,2562
"10521",31,6,60,71,36377093,36381452,4359
"10623",31,4,22,72,36383878,36386433,2555
"10819",31,5,95,73,36391277,36393316,2039
"10926",31,5,17,74,36395814,36399212,3398
"11127",31,5,131,75,36403958,36406565,2607
"11226",31,1,127,76,36409193,36411324,2131
"11321",31,1,25,77,36413658,36415468,1810
"11517",31,4,112,78,36420881,36423226,2345
"11624",31,3,129,79,36425659,36428116,2457
"11725",31,3,81,80,36430822,36432874,2052
"11823",31,3,69,81,36435378,36437646,2268
"11923",31,3,39,82,36440333,36443711,3378
"12125",31,2,20,83,36448209,36450124,1915
"12322",31,1,79,84,36456700,36459889,3189
"12419",31,6,72,85,36462406,36463791,1385
"12525",31,5,29,86,36466727,36468792,2065
"12722",31,3,99,87,36473714,36475387,1673
"12819",31,4,34,88,36477721,36481570,3849
"13020",31,3,21,89,36491009,36492623,1614
"13222",31,4,130,90,36498291,36500388,2097
"13320",31,3,111,91,36502879,36504853,1974
"13420",31,2,26,92,36507154,36508677,1523
"13619",31,3,105,93,36513919,36515311,1392
"13722",31,2,110,94,36517724,36520991,3267
"13821",31,3,135,95,36523868,36529769,5901
"13923",31,5,47,96,36532653,36534162,1509
"14130",31,4,100,97,36539294,36541025,1731
"14220",31,6,132,98,36543869,36546476,2607
"14324",31,4,70,99,36548863,36550732,1869
"14421",31,3,87,100,36553131,36556608,3477
"14519",31,6,36,101,36558981,36561523,2542
"14720",31,1,19,102,36566420,36568602,2182
"14924",31,2,68,103,36576610,36578309,1699
"15025",31,3,63,104,36580793,36583479,2686
"15125",31,3,123,105,36586238,36588754,2516
"15221",31,2,86,106,36591219,36592970,1751
"15322",31,6,12,107,36595363,36597447,2084
"15517",31,2,38,108,36609318,36611618,2300
"15724",31,4,94,109,36617037,36619704,2667
"15821",31,2,50,110,36622384,36623972,1588
"16027",31,5,119,111,36628456,36630881,2425
"16122",31,6,54,112,36633489,36634966,1477
"16325",31,6,120,113,36640261,36641908,1647
"16419",31,6,84,114,36644333,36645718,1385
"16521",31,1,121,115,36648366,36650594,2228
"16621",31,4,10,116,36652909,36655314,2405
"16822",31,4,82,117,36661478,36662791,1313
"16921",31,5,89,118,36665629,36668602,2973
"17022",31,1,13,119,36671158,36673158,2000
"17224",31,3,15,120,36677852,36679257,1405
"17418",31,4,124,121,36684538,36685878,1340
"17524",31,4,88,122,36688297,36690055,1758
"17622",31,6,30,123,36692434,36694833,2399
"17822",31,2,8,124,36699455,36701271,1816
"18020",31,3,117,125,36707579,36708827,1248
"18128",31,5,35,126,36711959,36714095,2136
"18319",31,5,11,127,36719208,36720495,1287
"18522",31,1,37,128,36726228,36728861,2633
"18720",31,1,49,129,36735280,36737345,2065
"18919",31,4,46,130,36741921,36743921,2000
"19121",31,4,106,131,36749798,36751327,1529
"19226",31,5,71,132,36753896,36755405,1509
"19324",31,5,53,133,36758289,36760419,2130
"19522",31,1,43,134,36765315,36766301,986
"19722",31,1,67,135,36772178,36774073,1895
"19819",31,3,93,136,36776564,36778793,2229
"19927",31,6,18,137,36781499,36785799,4300
"20125",31,1,97,138,36792258,36793885,1627
"10123",32,3,116,1,1316366,1325451,9085
"11101",32,5,112,2,1328498,1331203,2705
"12105",32,2,73,3,1334269,1339334,5065
"13104",32,3,68,4,1342427,1347028,4601
"14109",32,6,107,5,1349983,1354616,4633
"15104",32,2,7,6,1358114,1362087,3973
"17103",32,4,123,7,1371324,1379226,7902
"18106",32,4,93,8,1381664,1385207,3543
"19102",32,1,24,9,1388652,1392135,3483
"2126",32,5,130,10,1401274,1406482,5208
"2224",32,2,79,11,1408973,1412091,3118
"2322",32,1,30,12,1414738,1420457,5719
"2523",32,3,80,13,1425491,1428575,3084
"2624",32,3,44,14,1432256,1435746,3490
"2820",32,3,134,15,1440923,1443720,2797
"2925",32,3,86,16,1446643,1450525,3882
"3026",32,2,97,17,1453846,1457257,3411
"3122",32,6,89,18,1459983,1471232,11249
"3219",32,4,63,19,1474108,1476657,2549
"3322",32,1,72,20,1479030,1481056,2026
"3425",32,4,105,21,1483455,1486135,2680
"3520",32,2,85,22,1489593,1493214,3621
"3625",32,2,115,23,1496803,1501482,4679
"3717",32,6,47,24,1504182,1507103,2921
"3925",32,2,31,25,1513399,1521111,7712
"4124",32,4,69,26,1527229,1531144,3915
"4220",32,2,103,27,1533792,1536118,2326
"4322",32,5,76,28,1539211,1544263,5052
"4425",32,1,138,29,1547264,1551047,3783
"4515",32,6,131,30,1554061,1557028,2967
"4624",32,2,121,31,1560526,1564852,4326
"4724",32,3,32,32,1567481,1571813,4332
"4918",32,2,133,33,1577912,1583801,5889
"5028",32,6,59,34,1586194,1590704,4510
"5117",32,4,51,35,1593312,1596037,2725
"5324",32,4,135,36,1601725,1610149,8424
"5427",32,3,26,37,1612673,1618483,5810
"5623",32,2,49,38,1624360,1629157,4797
"5821",32,4,27,39,1634335,1637360,3025
"6021",32,3,2,40,1643224,1646629,3405
"6229",32,4,75,41,1653408,1659107,5699
"6318",32,3,56,42,1666683,1670552,3869
"6422",32,1,132,43,1673331,1677526,4195
"6524",32,2,67,44,1679926,1682500,2574
"6620",32,4,3,45,1684965,1689684,4719
"6820",32,5,70,46,1696999,1700894,3895
"6922",32,1,18,47,1703215,1708391,5176
"7123",32,3,20,48,1713255,1715875,2620
"7324",32,4,45,49,1722667,1725288,2621
"7524",32,1,126,50,1730609,1734648,4039
"7628",32,5,46,51,1736949,1740171,3222
"7824",32,5,58,52,1747394,1752002,4608
"7923",32,5,52,53,1754493,1756486,1993
"8120",32,5,34,54,1761585,1764355,2770
"8325",32,1,120,55,1769827,1772990,3163
"8415",32,5,16,56,1776011,1779102,3091
"8628",32,1,90,57,1785514,1788540,3026
"8715",32,6,119,58,1795169,1798122,2953
"8825",32,6,5,59,1801215,1805090,3875
"9019",32,3,62,60,1811516,1815254,3738
"9126",32,3,74,61,1818039,1820157,2118
"9224",32,4,33,62,1822824,1824954,2130
"9422",32,5,82,63,1831883,1834439,2556
"9519",32,1,96,64,1840087,1843276,3189
"9619",32,1,84,65,1846139,1851217,5078
"9717",32,3,14,66,1877383,1883337,5954
"9921",32,4,117,67,1891489,1893547,2058
"10027",32,1,48,68,1896260,1897809,1549
"10226",32,2,43,69,1904378,1906398,2020
"10422",32,2,13,70,1911725,1914660,2935
"10624",32,4,81,71,1920039,1922268,2229
"10724",32,5,100,72,1924837,1927713,2876
"10820",32,1,60,73,1930204,1933327,3123
"10927",32,2,37,74,1940093,1943204,3111
"11128",32,5,64,75,1948943,1952047,3104
"11227",32,3,8,76,1955022,1957845,2823
"11423",32,6,41,77,1963781,1966218,2437
"11625",32,3,110,78,1972141,1975677,3536
"11726",32,1,6,79,1978802,1981148,2346
"11924",32,2,19,80,1987423,1989723,2300
"12126",32,1,36,81,1996450,1998672,2222
"12323",32,6,101,82,2005169,2007391,2222
"12420",32,4,21,83,2010804,2014228,3424
"12615",32,2,61,84,2019569,2023137,3568
"12723",32,4,111,85,2025949,2029177,3228
"12820",32,5,106,86,2034583,2036485,1902
"12925",32,1,108,87,2038910,2041609,2699
"13021",32,3,92,88,2044551,2050041,5490
"13121",32,4,99,89,2057088,2060460,3372
"13223",32,2,1,90,2063180,2065362,2182
"13421",32,4,87,91,2070631,2073127,2496
"13520",32,6,113,92,2076076,2081416,5340
"13620",32,4,129,93,2084567,2087403,2836
"13723",32,4,9,94,2091410,2094495,3085
"13924",32,1,114,95,2101208,2105718,4510
"14022",32,2,127,96,2108307,2110862,2555
"14131",32,2,91,97,2117562,2120111,2549
"14221",32,6,71,98,2122791,2125216,2425
"14325",32,5,124,99,2128112,2131131,3019
"14422",32,6,83,100,2134341,2137994,3653
"14520",32,5,94,101,2141165,2144335,3170
"14621",32,5,118,102,2149414,2152283,2869
"14721",32,5,28,103,2155147,2157937,2790
"14925",32,3,122,104,2164167,2165957,1790
"15026",32,5,4,105,2169860,2172239,2379
"15222",32,3,38,106,2177468,2180141,2673
"15424",32,6,95,107,2185789,2189050,3261
"15518",32,6,65,108,2192142,2194351,2209
"15622",32,6,77,109,2197744,2200397,2653
"15725",32,4,15,110,2203378,2205182,1804
"15920",32,6,11,111,2210222,2212640,2418
"16123",32,3,128,112,2218000,2220673,2673
"16220",32,6,17,113,2223667,2227373,3706
"16420",32,6,137,114,2233916,2235569,1653
"16522",32,4,39,115,2241100,2244028,2928
"16724",32,5,88,116,2298424,2301848,3424
"16823",32,6,29,117,2304372,2307293,2921
"17023",32,1,102,118,2312366,2315692,3326
"17126",32,6,125,119,2318262,2321529,3267
"17225",32,1,42,120,2324112,2327013,2901
"17419",32,1,12,121,2334040,2336040,2000
"17623",32,1,78,122,2341146,2343452,2306
"17722",32,1,66,123,2345963,2348753,2790
"17823",32,2,109,124,2351290,2354460,3170
"17923",32,4,57,125,2356944,2359388,2444
"18021",32,3,50,126,2361873,2364401,2528
"18222",32,3,104,127,2371037,2374644,3607
"18320",32,3,98,128,2378076,2381108,3032
"18422",32,5,136,129,2383796,2389952,6156
"18523",32,2,55,130,2392646,2394436,1790
"18621",32,5,22,131,2397097,2399606,2509
"18825",32,2,25,132,2404228,2406515,2287
"19023",32,5,40,133,2413098,2416261,3163
"19227",32,6,35,134,2423275,2425229,1954
"19418",32,1,54,135,2431609,2433583,1974
"19623",32,5,10,136,2439930,2444028,4098
"19820",32,6,23,137,2450421,2455872,5451
"20020",32,6,53,138,2460781,2463245,2464
"10124",33,4,74,1,3663933,3667671,3738
"11102",33,2,30,2,3670083,3673959,3876
"13105",33,3,43,3,3679345,3685299,5954
"15105",33,6,22,4,3691320,3696862,5542
"17104",33,3,67,5,3702380,3707040,4660
"18107",33,3,115,6,3709341,3714007,4666
"19103",33,6,76,7,3716387,3720707,4320
"2029",33,6,130,8,3723368,3728538,5170
"2127",33,5,105,9,3730878,3735126,4248
"2225",33,1,77,10,3737611,3743297,5686
"2323",33,4,38,11,3745932,3751225,5293
"2524",33,2,126,12,3756547,3762233,5686
"2625",33,2,36,13,3764671,3770344,5673
"2821",33,5,15,14,3776528,3780495,3967
"3027",33,4,2,15,3786222,3790306,4084
"3220",33,1,53,16,3795490,3799974,4484
"3426",33,2,72,17,3804857,3808674,3817
"3521",33,6,34,18,3811642,3817361,5719
"3718",33,4,68,19,3822963,3828936,5973
"3823",33,6,52,20,3831048,3839022,7974
"4023",33,4,128,21,3845337,3851056,5719
"4125",33,3,7,22,3853658,3859736,6078
"4323",33,1,119,23,3866672,3872201,5529
"4426",33,4,26,24,3874796,3881018,6222
"4625",33,5,3,25,3887065,3892692,5627
"4821",33,5,135,26,3899831,3904392,4561
"4919",33,3,109,27,3906792,3915609,8817
"5029",33,5,129,28,3918930,3926682,7752
"5118",33,1,131,29,3928963,3932296,3333
"5226",33,1,11,30,3934676,3938990,4314
"5428",33,3,19,31,3944082,3947618,3536
"5624",33,1,101,32,3953390,3959226,5836
"5725",33,6,112,33,3961449,3965285,3836
"5822",33,1,41,34,3967652,3972142,4490
"6022",33,1,83,35,3977202,3982476,5274
"6120",33,5,93,36,3985621,3992457,6836
"6230",33,4,44,37,3994772,3998804,4032
"6423",33,3,85,38,4004256,4009151,4895
"6525",33,2,138,39,4011649,4017380,5731
"6621",33,5,21,40,4020218,4025211,4993
"6821",33,6,124,41,4030408,4033636,3228
"6923",33,5,81,42,4035905,4040395,4490
"7024",33,2,96,43,4042781,4045742,2961
"7124",33,6,46,44,4048677,4053579,4902
"7325",33,4,104,45,4059691,4066129,6438
"7423",33,4,8,46,4068731,4073168,4437
"7629",33,3,25,47,4078300,4082143,3843
"7825",33,4,116,48,4087771,4094987,7216
"7924",33,5,99,49,4097955,4106968,9013
"8022",33,1,23,50,4110551,4115492,4941
"8228",33,1,47,51,4121107,4126172,5065
"8416",33,4,86,52,4132434,4136336,3902
"8522",33,6,136,53,4138579,4146650,8071
"8629",33,6,64,54,4149749,4155559,5810
"8716",33,1,89,55,4159475,4167188,7713
"8826",33,4,98,56,4169528,4174176,4648
"8919",33,3,31,57,4177562,4183235,5673
"9127",33,2,54,58,4189223,4194660,5437
"9327",33,6,28,59,4200982,4207007,6025
"9520",33,2,84,60,4213492,4221963,8471
"9620",33,5,39,61,4224584,4229636,5052
"9825",33,6,106,62,4234892,4238369,3477
"9922",33,1,65,63,4240755,4245611,4856
"10028",33,4,110,64,4248011,4251821,3810
"10125",33,5,33,65,4254240,4258429,4189
"10323",33,6,82,66,4291399,4297791,6392
"10423",33,2,90,67,4300184,4305752,5568
"10522",33,5,117,68,4308087,4313034,4947
"10625",33,3,13,69,4315506,4323244,7738
"10821",33,2,42,70,4328160,4334284,6124
"11017",33,6,70,71,4341690,4347585,5895
"11129",33,1,17,72,4350037,4356677,6640
"11322",33,3,97,73,4361495,4366129,4634
"11424",33,2,24,74,4369940,4375875,5935
"11626",33,5,75,75,4382647,4387555,4908
"11727",33,4,50,76,4389942,4393909,3967
"11925",33,3,79,77,4400106,4404386,4280
"12020",33,5,63,78,4408485,4414341,5856
"12127",33,4,62,79,4417434,4423401,5967
"12223",33,2,66,80,4426140,4431480,5340
"12324",33,1,29,81,4434853,4438892,4039
"12526",33,3,91,82,4444664,4450612,5948
"12616",33,3,61,83,4454234,4461233,6999
"12724",33,6,94,84,4463352,4469509,6157
"12821",33,1,107,85,4472117,4476071,3954
"12926",33,6,10,86,4478490,4483372,4882
"13122",33,6,58,87,4490563,4497282,6719
"13224",33,2,102,88,4500805,4504746,3941
"13321",33,5,9,89,4510662,4514315,3653
"13521",33,3,37,90,4519159,4527617,8458
"13724",33,4,92,91,4533533,4537376,3843
"13822",33,6,16,92,4540873,4545076,4203
"14023",33,6,4,93,4552044,4556795,4751
"14222",33,2,78,94,4563117,4568143,5026
"14326",33,6,88,95,4570516,4575130,4614
"14423",33,5,123,96,4577569,4585209,7640
"14521",33,5,27,97,4588007,4593569,5562
"14722",33,3,1,98,4600681,4606387,5706
"14926",33,2,114,99,4612996,4619048,6052
"15027",33,2,12,100,4621996,4625486,3490
"15223",33,1,95,101,4630670,4636049,5379
"15323",33,4,14,102,4638141,4646331,8190
"15519",33,2,6,103,4656188,4661175,4987
"15726",33,1,71,104,4668209,4676326,8117
"15822",33,2,108,105,4679157,4687320,8163
"15921",33,5,51,106,4689485,4693661,4176
"16124",33,2,60,107,4699191,4705603,6412
"16221",33,3,49,108,4708237,4714976,6739
"16421",33,5,57,109,4722049,4727859,5810
"16523",33,3,73,110,4730376,4735526,5150
"16622",33,5,69,111,4737880,4741880,4000
"16725",33,3,103,112,4745756,4751652,5896
"16824",33,2,120,113,4755038,4758776,3738
"16922",33,3,55,114,4761908,4766358,4450
"17024",33,2,48,115,4768875,4773097,4222
"17226",33,1,59,116,4780321,4785327,5006
"17323",33,5,87,117,4788936,4794746,5810
"17420",33,2,18,118,4797106,4801753,4647
"17624",33,5,111,119,4806891,4811191,4300
"17723",33,4,20,120,4814676,4819512,4836
"17924",33,4,122,121,4826775,4830689,3914
"18022",33,4,80,122,4833860,4839703,5843
"18129",33,4,32,123,4842436,4848508,6072
"18321",33,6,40,124,4854639,4859639,5000
"18524",33,4,134,125,4867313,4872601,5288
"18622",33,1,35,126,4874856,4879902,5046
"18826",33,6,118,127,4885563,4889321,3758
"18920",33,4,56,128,4891505,4896053,4548
"19024",33,2,132,129,4899440,4904100,4660
"19122",33,6,100,130,4907022,4910891,3869
"19228",33,1,113,131,4913807,4918316,4509
"19325",33,3,121,132,4920722,4925173,4451
"19419",33,1,5,133,4928082,4931363,3281
"19624",33,3,127,134,4938044,4941396,3352
"19723",33,5,45,135,4943789,4947566,3777
"19928",33,3,133,136,4952966,4956574,3608
"20021",33,1,137,137,4958836,4965287,6451
"20126",33,1,125,138,4967666,4971196,3530
"10126",34,6,81,1,6396330,6401951,5621
"11103",34,6,63,2,6404455,6408186,3731
"12106",34,5,68,3,6410632,6414069,3437
"13106",34,5,8,4,6416514,6420573,4059
"15106",34,1,88,5,6426509,6429815,3306
"16102",34,5,32,6,6432620,6436456,3836
"18108",34,5,20,7,6442307,6446222,3915
"2030",34,4,121,8,6451929,6455909,3980
"2128",34,2,107,9,6458570,6462517,3947
"2226",34,2,137,10,6464936,6469452,4516
"2324",34,6,21,11,6472185,6476524,4339
"2525",34,5,110,12,6482323,6486237,3914
"2626",34,4,79,13,6488637,6492532,3895
"2719",34,2,35,14,6494958,6498428,3470
"2926",34,5,80,15,6504043,6509134,5091
"3028",34,3,108,16,6524332,6527508,3176
"3123",34,1,124,17,6529973,6532986,3013
"3221",34,5,62,18,6535476,6538646,3170
"3323",34,6,123,19,6541451,6545856,4405
"3427",34,6,111,20,6548255,6552013,3758
"3522",34,6,9,21,6554648,6559020,4372
"3719",34,1,40,22,6565472,6570165,4693
"3926",34,6,87,23,6575872,6580348,4476
"4024",34,2,125,24,6583957,6589244,5287
"4126",34,3,96,25,6591925,6595611,3686
"4221",34,3,24,26,6597971,6602984,5013
"4427",34,5,86,27,6608168,6613181,5013
"4516",34,4,7,28,6615619,6618815,3196
"4725",34,1,82,29,6624554,6626979,2425
"4822",34,2,59,30,6629267,6631979,2712
"4920",34,5,50,31,6634516,6637548,3032
"5119",34,5,104,32,6642673,6646346,3673
"5227",34,4,91,33,6672100,6675413,3313
"5325",34,5,44,34,6677806,6680067,2261
"5525",34,4,55,35,6685225,6688493,3268
"5625",34,1,28,36,6691369,6694676,3307
"5823",34,1,106,37,6700965,6703742,2777
"5925",34,2,71,38,6710246,6712619,2373
"6023",34,4,97,39,6715103,6719116,4013
"6121",34,1,34,40,6721999,6724887,2888
"6319",34,1,58,41,6731307,6735548,4241
"6424",34,2,131,42,6739085,6742647,3562
"6526",34,1,118,43,6745615,6749118,3503
"6622",34,3,54,44,6751550,6754615,3065
"6822",34,4,37,45,6804181,6807827,3646
"7025",34,2,101,46,6812985,6816874,3889
"7125",34,1,22,47,6819365,6823044,3679
"7326",34,4,109,48,6828182,6832051,3869
"7424",34,2,77,49,6834510,6838254,3744
"7525",34,6,99,50,6840915,6844549,3634
"7630",34,4,67,51,6847151,6850425,3274
"7724",34,2,113,52,6852949,6856203,3254
"7826",34,1,4,53,6859217,6863746,4529
"8023",34,2,119,54,6868937,6875793,6856
"8121",34,2,41,55,6878166,6882251,4085
"8326",34,4,49,56,6887167,6890428,3261
"8523",34,5,14,57,6895474,6899794,4320
"8717",34,5,134,58,6906671,6911945,5274
"8827",34,6,45,59,6914299,6917939,3640
"9020",34,6,117,60,6923221,6925816,2595
"9128",34,6,57,61,6928280,6931992,3712
"9225",34,3,72,62,6934549,6938411,3862
"9328",34,3,114,63,6941242,6946189,4947
"9423",34,2,29,64,6948654,6954197,5543
"9621",34,3,66,65,6959557,6966818,7261
"9718",34,2,95,66,7051230,7057452,6222
"9826",34,3,84,67,7060119,7064570,4451
"9923",34,1,94,68,7067159,7072152,4993
"10029",34,2,47,69,7074532,7078460,3928
"10227",34,2,23,70,7083467,7086898,3431
"10424",34,3,90,71,7092331,7097186,4855
"10523",34,5,98,72,7099501,7105703,6202
"10626",34,3,138,73,7108122,7114181,6059
"10725",34,1,16,74,7121117,7124515,3398
"10928",34,3,120,75,7129608,7133575,3967
"11018",34,4,61,76,7135902,7139843,3941
"11130",34,6,39,77,7142255,7147209,4954
"11323",34,6,69,78,7153178,7155870,2692
"11425",34,2,83,79,7158296,7162642,4346
"11518",34,2,89,80,7165061,7169766,4705
"11627",34,3,30,81,7172114,7175250,3136
"11824",34,5,92,82,7179879,7183369,3490
"11926",34,4,127,83,7185703,7189101,3398
"12021",34,1,70,84,7191370,7196409,5039
"12128",34,4,103,85,7198651,7202958,4307
"12224",34,6,51,86,7205358,7209815,4457
"12421",34,1,52,87,7215901,7219574,3673
"12617",34,4,25,88,7225555,7229097,3542
"12822",34,2,53,89,7234261,7237934,3673
"13022",34,6,27,90,7248831,7252073,3242
"13225",34,4,13,91,7257544,7261661,4117
"13422",34,3,132,92,7268225,7272022,3797
"13522",34,6,75,93,7274767,7279460,4693
"13621",34,3,48,94,7282154,7284238,2084
"13823",34,2,17,95,7293246,7298690,5444
"14024",34,3,12,96,7304358,7307030,2672
"14223",34,1,46,97,7313450,7316900,3450
"14424",34,4,43,98,7322045,7326215,4170
"14622",34,1,112,99,7330922,7333810,2888
"14723",34,3,36,100,7336562,7338869,2307
"14927",34,3,6,101,7344609,7351249,6640
"15126",34,2,65,102,7359093,7362838,3745
"15224",34,4,1,103,7365133,7368936,3803
"15425",34,4,115,104,7375029,7378983,3954
"15520",34,2,11,105,7381585,7385193,3608
"15727",34,6,93,106,7430614,7433503,2889
"15823",34,3,42,107,7436471,7439739,3268
"16028",34,1,130,108,7445321,7450386,5065
"16125",34,3,126,109,7453407,7458184,4777
"16222",34,3,102,110,7460427,7465015,4588
"16326",34,5,56,111,7467636,7470597,2961
"16422",34,4,85,112,7473251,7477676,4425
"16524",34,6,129,113,7480513,7484480,3967
"16623",34,4,133,114,7487134,7490454,3320
"16726",34,5,128,115,7494370,7499422,5052
"16825",34,3,60,116,7502319,7506926,4607
"16923",34,6,135,117,7509724,7514979,5255
"17025",34,1,64,118,7517450,7521456,4006
"17127",34,1,76,119,7523961,7528986,5025
"17227",34,6,3,120,7531392,7535706,4314
"17421",34,5,2,121,7541131,7544125,2994
"17625",34,4,73,122,7550243,7553249,3006
"17724",34,5,74,123,7555727,7558773,3046
"17824",34,2,5,124,7561917,7566028,4111
"18023",34,6,15,125,7572036,7574401,2365
"18223",34,5,38,126,7578990,7582284,3294
"18423",34,1,100,127,7587932,7592075,4143
"18525",34,5,116,128,7594299,7598939,4640
"18623",34,4,31,129,7601770,7605874,4104
"18827",34,6,105,130,7610986,7613430,2444
"18921",34,6,33,131,7615712,7618875,3163
"19123",34,3,78,132,7623359,7626686,3327
"19229",34,5,26,133,7629314,7632647,3333
"19420",34,3,18,134,7638223,7641275,3052
"19625",34,4,19,135,7646459,7649805,3346
"19821",34,5,122,136,7661793,7664146,2353
"19929",34,1,10,137,7666486,7669081,2595
"20127",34,1,136,138,7674729,7678245,3516
"10127",35,4,108,1,10849300,10853816,4516
"11104",35,5,79,2,10859764,10864496,4732
"12107",35,5,67,3,10867196,10870157,2961
"13107",35,5,43,4,10873125,10876798,3673
"15107",35,1,27,5,10883132,10886583,3451
"17105",35,2,130,6,10894074,10899198,5124
"18109",35,2,28,7,10901826,10905571,3745
"2031",35,3,83,8,10912180,10916075,3895
"2129",35,3,23,9,10923180,10926134,2954
"2325",35,3,17,10,10932442,10937109,4667
"2526",35,1,33,11,10943626,10947404,3778
"2720",35,4,96,12,10952902,10956555,3653
"2822",35,5,55,13,10961137,10964300,3163
"2927",35,2,46,14,10966517,10970444,3927
"3124",35,4,42,15,10979393,10983118,3725
"3324",35,4,48,16,10990113,10992910,2797
"3523",35,6,44,17,10998362,11001191,2829
"3720",35,1,51,18,11006330,11010074,3744
"3927",35,2,40,19,11015278,11019140,3862
"4127",35,2,82,20,11025632,11029324,3692
"4222",35,5,37,21,11034319,11039266,4947
"4428",35,1,15,22,11045548,11048450,2902
"4626",35,1,99,23,11053039,11055653,2614
"4726",35,2,52,24,11059065,11062019,2954
"4921",35,2,4,25,11067759,11071909,4150
"5120",35,6,134,26,11078125,11081850,3725
"5228",35,1,129,27,11087943,11091178,3235
"5326",35,3,131,28,11094146,11096538,2392
"5429",35,4,90,29,11099212,11102499,3287
"5526",35,3,101,30,11104807,11108009,3202
"5626",35,3,119,31,11110520,11114598,4078
"5726",35,6,2,32,11116984,11119958,2974
"5926",35,3,47,33,11126802,11129638,2836
"6122",35,2,16,34,11134554,11136821,2267
"6320",35,2,136,35,11143875,11147626,3751
"6425",35,1,135,36,11150849,11154712,3863
"6527",35,6,80,37,11157693,11163189,5496
"6623",35,1,87,38,11166027,11169516,3489
"6725",35,6,32,39,11172779,11176458,3679
"6924",35,3,71,40,11185387,11188557,3170
"7026",35,1,39,41,11191636,11195172,3536
"7219",35,1,21,42,11200035,11202970,2935
"7425",35,6,74,43,11208304,11211519,3215
"7526",35,3,41,44,11216788,11220468,3680
"7725",35,3,107,45,11226090,11231952,5862
"7827",35,2,112,46,11235371,11238580,3209
"7925",35,6,122,47,11241097,11243972,2875
"8024",35,3,11,48,11246679,11250123,3444
"8229",35,2,64,49,11255222,11259241,4019
"8327",35,5,7,50,11265661,11270464,4803
"8524",35,4,72,51,11282067,11284236,2169
"8630",35,6,104,52,11287865,11292100,4235
"8718",35,6,38,53,11295604,11299041,3437
"8920",35,4,30,54,11304807,11307617,2810
"9129",35,1,75,55,11312991,11316552,3561
"9226",35,2,124,56,11319161,11321396,2235
"9329",35,2,34,57,11324116,11327122,3006
"9521",35,1,45,58,11335711,11338233,2522
"9719",35,4,36,59,11343594,11347234,3640
"9924",35,2,88,60,11353843,11358039,4196
"10030",35,2,10,61,11360785,11363555,2770
"10228",35,5,73,62,11368726,11371654,2928
"10324",35,6,26,63,11373916,11377256,3340
"10524",35,6,92,64,11382642,11385733,3091
"10627",35,3,113,65,11388414,11391368,2954
"10726",35,1,93,66,11420161,11422873,2712
"10822",35,4,78,67,11426103,11428599,2496
"10929",35,6,14,68,11431227,11434789,3562
"11131",35,6,62,69,11444176,11446711,2535
"11228",35,5,31,70,11449379,11452627,3248
"11426",35,4,84,71,11457340,11464778,7438
"11519",35,2,22,72,11467922,11471981,4059
"11728",35,3,65,73,11477413,11480576,3163
"11825",35,4,6,74,11483204,11486093,2889
"12022",35,3,53,75,11492303,11495989,3686
"12225",35,5,19,76,11501853,11504480,2627
"12422",35,1,105,77,11514952,11517187,2235
"12527",35,3,137,78,11520861,11523239,2378
"12618",35,3,35,79,11526580,11529246,2666
"12823",35,5,121,80,11536136,11540829,4693
"12927",35,1,111,81,11543653,11546470,2817
"13023",35,2,118,82,11549202,11552823,3621
"13123",35,3,125,83,11555615,11558137,2522
"13226",35,2,106,84,11560621,11562549,1928
"13322",35,6,50,85,11566099,11569007,2908
"13523",35,1,3,86,11576001,11579295,3294
"13725",35,4,54,87,11584211,11586721,2510
"13925",35,6,128,88,11592467,11599663,7196
"14025",35,6,20,89,11602984,11606160,3176
"14224",35,2,70,90,11612592,11616520,3928
"14327",35,5,103,91,11619285,11623599,4314
"14425",35,6,86,92,11627495,11630279,2784
"14522",35,5,61,93,11632790,11636286,3496
"14623",35,5,13,94,11638895,11643116,4221
"14820",35,4,24,95,11647751,11651208,3457
"15028",35,3,95,96,11658824,11662876,4052
"15127",35,1,117,97,11665726,11669380,3654
"15225",35,6,56,98,11672250,11676995,4745
"15324",35,3,29,99,11679682,11683668,3986
"15521",35,5,133,100,11689192,11692152,2960
"15623",35,3,59,101,11696532,11699780,3248
"15728",35,3,77,102,11703670,11707787,4117
"15824",35,4,132,103,11711723,11714357,2634
"15922",35,4,60,104,11717965,11721808,3843
"16029",35,2,94,105,11725534,11729207,3673
"16126",35,6,68,106,11734202,11737436,3234
"16223",35,4,18,107,11740104,11743319,3215
"16423",35,1,9,108,11749457,11751934,2477
"16624",35,5,85,109,11759079,11762144,3065
"16727",35,3,89,110,11765753,11770275,4522
"16826",35,5,127,111,11775185,11777700,2515
"16924",35,6,116,112,11783368,11788237,4869
"17026",35,6,110,113,11791316,11795231,3915
"17128",35,1,69,114,11798121,11800133,2012
"17228",35,5,91,115,11805441,11808206,2765
"17324",35,2,100,116,11815985,11820409,4424
"17422",35,1,57,117,11824221,11826913,2692
"17525",35,4,138,118,11830469,11834031,3562
"17626",35,4,102,119,11841379,11843862,2483
"17725",35,5,115,120,11852052,11855725,3673
"17825",35,1,123,121,11858478,11861281,2803
"17925",35,6,8,122,11869675,11872380,2705
"18130",35,5,25,123,11879786,11882668,2882
"18322",35,4,126,124,11887643,11890453,2810
"18424",35,2,58,125,11897637,11900454,2817
"18526",35,5,97,126,11907605,11910480,2875
"18624",35,6,98,127,11914050,11917697,3647
"18721",35,1,63,128,11921345,11923690,2345
"18828",35,2,76,129,11930437,11934025,3588
"18922",35,5,1,130,11937542,11939456,1914
"19124",35,5,109,131,11945464,11949150,3686
"19230",35,1,81,132,11954373,11957157,2784
"19326",35,4,66,133,11965138,11967458,2320
"19421",35,4,114,134,11973975,11978805,4830
"19523",35,4,12,135,11981695,11984132,2437
"19724",35,4,120,136,11990702,11993754,3052
"19822",35,3,5,137,12000213,12004068,3855
"20022",35,5,49,138,12012259,12015265,3006
"10128",36,5,12,1,13131196,13135673,4477
"12108",36,6,79,2,13141275,13145209,3934
"13108",36,3,52,3,13147929,13153216,5287
"15108",36,3,88,4,13158485,13162073,3588
"16103",36,4,23,5,13164852,13168479,3627
"18131",36,1,50,6,13173245,13177042,3797
"2032",36,3,118,7,13181918,13186441,4523
"2130",36,5,42,8,13188899,13192918,4019
"2326",36,2,99,9,13198272,13203527,5255
"2425",36,5,6,10,13206260,13211625,5365
"2627",36,1,80,11,13216986,13221783,4797
"2721",36,6,67,12,13224457,13227620,3163
"2823",36,1,110,13,13230418,13234457,4039
"2928",36,1,26,14,13237536,13241569,4033
"3125",36,6,133,15,13247629,13252798,5169
"3222",36,4,95,16,13255649,13261792,6143
"3325",36,6,7,17,13264270,13269479,5209
"3524",36,6,25,18,13275755,13279166,3411
"3721",36,2,123,19,13284043,13289526,5483
"3824",36,6,55,20,13292135,13295095,2960
"3928",36,3,10,21,13297658,13302037,4379
"4128",36,4,107,22,13308142,13313083,4941
"4223",36,4,53,23,13315666,13320469,4803
"4429",36,5,54,24,13325261,13329300,4039
"4627",36,2,69,25,13337177,13341203,4026
"4727",36,6,43,26,13343733,13349086,5353
"4922",36,4,137,27,13354276,13359132,4856
"5030",36,4,11,28,13361839,13366322,4483
"5229",36,3,28,29,13372545,13377349,4804
"5430",36,1,86,30,13382788,13387114,4326
"5527",36,2,15,31,13389697,13393710,4013
"5727",36,2,63,32,13398835,13403978,5143
"5824",36,4,71,33,13406221,13410325,4104
"5927",36,1,68,34,13412613,13416600,3987
"6024",36,1,92,35,13419405,13424607,5202
"6123",36,1,32,36,13427353,13431313,3960
"6321",36,3,34,37,13437112,13440896,3784
"6528",36,3,130,38,13448184,13452021,3837
"6624",36,4,17,39,13454714,13458596,3882
"6823",36,6,103,40,13463395,13470342,6947
"6925",36,4,89,41,13472892,13478931,6039
"7027",36,6,13,42,13481455,13487905,6450
"7220",36,6,37,43,13492900,13496618,3718
"7426",36,2,57,44,13501861,13504867,3006
"7527",36,5,126,45,13507757,13511561,3804
"7631",36,1,14,46,13514215,13518620,4405
"7828",36,4,77,47,13523797,13529300,5503
"7926",36,4,47,48,13531883,13536105,4222
"8122",36,1,2,49,13541053,13546060,5007
"8328",36,3,16,50,13551773,13559577,7804
"8525",36,4,59,51,13564937,13569506,4569
"8631",36,6,115,52,13572506,13576473,3967
"8719",36,2,27,53,13579108,13582382,3274
"8921",36,3,112,54,13587730,13592193,4463
"9021",36,3,46,55,13594678,13598396,3718
"9227",36,4,101,56,13604574,13608201,3627
"9330",36,2,51,57,13610587,13615437,4850
"9522",36,5,78,58,13620542,13624627,4085
"9622",36,6,61,59,13627471,13630830,3359
"9720",36,6,85,60,13633354,13638621,5267
"9827",36,3,76,61,13641498,13646890,5392
"9925",36,2,75,62,13649224,13654864,5640
"10031",36,3,124,63,13657545,13661316,3771
"10129",36,2,21,64,13663702,13670833,7131
"10325",36,4,29,65,13676435,13681441,5006
"10525",36,5,96,66,13759486,13763617,4131
"10628",36,2,117,67,13766186,13770068,3882
"10727",36,6,73,68,13772644,13777905,5261
"10823",36,1,20,69,13781095,13783991,2896
"11019",36,3,64,70,13789161,13793691,4530
"11132",36,1,128,71,13796247,13800508,4261
"11229",36,1,62,72,13803162,13808384,5222
"11324",36,1,56,73,13810829,13815345,4516
"11427",36,3,136,74,13817673,13822392,4719
"11520",36,2,81,75,13824915,13830771,5856
"11628",36,1,98,76,13833674,13839406,5732
"11729",36,4,41,77,13842642,13848511,5869
"11927",36,6,19,78,13853793,13858355,4562
"12129",36,4,113,79,13864500,13870016,5516
"12226",36,1,116,80,13872696,13877363,4667
"12325",36,6,31,81,13880030,13883762,3732
"12528",36,3,70,82,13888907,13894913,6006
"12619",36,3,58,83,13897476,13903639,6163
"12725",36,5,72,84,13906287,13909522,3235
"12824",36,6,97,85,13911967,13914529,2562
"12928",36,6,49,86,13917471,13921627,4156
"13124",36,1,8,87,13927066,13931118,4052
"13323",36,1,134,88,13936544,13942138,5594
"13423",36,5,48,89,13944610,13948054,3444
"13622",36,5,102,90,13953852,13957296,3444
"13726",36,5,18,91,13959774,13963251,3477
"13926",36,5,108,92,13969102,13972905,3803
"14026",36,3,22,93,13976082,13980017,3935
"14225",36,2,111,94,13984867,13991743,6876
"14328",36,5,84,95,13994142,13999240,5098
"14426",36,5,36,96,14001908,14005175,3267
"14624",36,4,5,97,14011431,14016535,5104
"14821",36,5,30,98,14022347,14025216,2869
"15029",36,6,91,99,14030994,14036694,5700
"15128",36,6,127,100,14039165,14043661,4496
"15226",36,1,104,101,14046362,14050544,4182
"15325",36,3,106,102,14052826,14057734,4908
"15426",36,2,39,103,14060539,14064872,4333
"15624",36,5,114,104,14070043,14073951,3908
"15729",36,6,121,105,14076435,14079906,3471
"15825",36,2,3,106,14082482,14087168,4686
"16030",36,4,35,107,14092391,14095933,3542
"16224",36,5,66,108,14101725,14107528,5803
"16327",36,2,93,109,14110274,14113084,2810
"16424",36,6,109,110,14115575,14119751,4176
"16525",36,1,38,111,14122726,14126948,4222
"16728",36,1,44,112,14132073,14135223,3150
"16925",36,5,132,113,14140747,14145263,4516
"17027",36,2,33,114,14147859,14151093,3234
"17229",36,4,65,115,14156892,14160525,3633
"17325",36,3,94,116,14163114,14171101,7987
"17423",36,5,138,117,14173612,14178677,5065
"17526",36,2,87,118,14181292,14186207,4915
"17627",36,5,24,119,14188855,14194652,5797
"17826",36,3,40,120,14200516,14205195,4679
"18024",36,1,74,121,14210294,14214516,4222
"18132",36,5,90,122,14216870,14221843,4973
"18224",36,4,131,123,14224380,14227955,3575
"18323",36,4,125,124,14230406,14234125,3719
"18425",36,2,105,125,14237074,14241570,4496
"18527",36,2,9,126,14244270,14247799,3529
"18722",36,2,45,127,14254741,14258872,4131
"18923",36,4,119,128,14263814,14269245,5431
"19025",36,2,129,129,14271710,14276997,5287
"19125",36,5,60,130,14279390,14282978,3588
"19231",36,2,135,131,14285417,14290717,5300
"19327",36,3,82,132,14293241,14297175,3934
"19422",36,4,83,133,14300039,14306587,6548
"19524",36,5,120,134,14308856,14312758,3902
"19626",36,1,122,135,14315902,14320242,4340
"19725",36,3,4,136,14322922,14327589,4667
"19930",36,3,100,137,14332727,14338903,6176
"20023",36,6,1,138,14341532,14345812,4280
"10130",37,1,43,1,1681499,1688984,7485
"12109",37,6,126,2,1695671,1698003,2332
"13109",37,5,17,3,1701703,1704357,2654
"15109",37,5,41,4,1710050,1711945,1895
"17106",37,6,96,5,1717397,1721397,4000
"18133",37,3,63,6,1724339,1728385,4046
"19104",37,2,92,7,1731418,1733483,2065
"2033",37,4,76,8,1737366,1742627,5261
"2131",37,2,62,9,1745641,1747843,2202
"2227",37,4,106,10,1751347,1752889,1542
"2327",37,4,10,11,1755785,1759400,3615
"2527",37,1,115,12,1765492,1767642,2150
"2628",37,2,50,13,1770858,1784127,13269
"2824",37,1,79,14,1789539,1795310,5771
"2929",37,6,84,15,1798605,1804350,5745
"3029",37,6,72,16,1807096,1813011,5915
"3126",37,3,93,17,1815953,1818828,2875
"3223",37,4,46,18,1825471,1827164,1693
"3428",37,2,14,19,1832072,1835457,3385
"3626",37,2,80,20,1842236,1844046,1810
"3722",37,4,40,21,1847582,1849699,2117
"3929",37,4,58,22,1855295,1857334,2039
"4025",37,5,83,23,1859662,1864786,5124
"4129",37,6,60,24,1867616,1871734,4118
"4224",37,3,39,25,1879408,1881433,2025
"4430",37,5,125,26,1886938,1892199,5261
"4517",37,6,24,27,1895095,1899461,4366
"4728",37,2,8,28,1904547,1908030,3483
"4923",37,4,124,29,1913083,1915168,2085
"5031",37,1,55,30,1918077,1920423,2346
"5121",37,2,98,31,1923045,1926908,3863
"5230",37,4,16,32,1929640,1931313,1673
"5431",37,3,75,33,1936758,1940000,3242
"5528",37,2,134,34,1946929,1948712,1783
"5627",37,1,49,35,1951537,1953641,2104
"5825",37,1,25,36,1958590,1961615,3025
"6025",37,1,133,37,1966675,1971858,5183
"6124",37,5,11,38,1974381,1975421,1040
"6322",37,5,137,39,1980382,1981976,1594
"6426",37,4,82,40,1984578,1986414,1836
"6529",37,4,4,41,1989801,1991513,1712
"6726",37,1,7,42,1996782,1999134,2352
"6926",37,4,64,43,2004867,2006553,1686
"7028",37,4,112,44,2009469,2016410,6941
"7126",37,6,66,45,2019607,2021894,2287
"7221",37,1,85,46,2024594,2038124,13530
"7327",37,6,114,47,2040915,2046759,5844
"7427",37,2,26,48,2049563,2052910,3347
"7632",37,6,12,49,2060786,2062445,1659
"7829",37,5,107,50,2068205,2074682,6477
"7927",37,5,53,51,2077166,2079048,1882
"8123",37,3,27,52,2083872,2092696,8824
"8329",37,3,9,53,2097926,2100089,2163
"8526",37,2,68,54,2115417,2116691,1274
"8632",37,6,6,55,2118986,2122299,3313
"8828",37,1,91,56,2129530,2131084,1554
"8922",37,3,45,57,2133582,2135496,1914
"9130",37,4,34,58,2140942,2142797,1855
"9331",37,2,110,59,2147720,2149955,2235
"9424",37,6,132,60,2152629,2156727,4098
"9523",37,3,33,61,2159433,2160988,1555
"9721",37,6,30,62,2166754,2168635,1881
"9926",37,1,1,63,2173460,2174924,1464
"10131",37,1,67,64,2180271,2184245,3974
"10229",37,3,69,65,2187402,2188676,1274
"10326",37,4,136,66,2223104,2224607,1503
"10425",37,3,21,67,2227549,2229012,1463
"10629",37,1,19,68,2234490,2235862,1372
"10824",37,3,99,69,2242994,2248131,5137
"10930",37,3,87,70,2250857,2253818,2961
"11020",37,6,108,71,2256361,2258674,2313
"11133",37,2,38,72,2261270,2263158,1888
"11325",37,6,90,73,2268290,2270087,1797
"11428",37,3,117,74,2273369,2274845,1476
"11521",37,2,116,75,2277526,2279100,1574
"11629",37,5,113,76,2281866,2283362,1496
"11730",37,3,3,77,2286579,2288558,1979
"11928",37,1,127,78,2293337,2298043,4706
"12023",37,4,70,79,2301024,2307671,6647
"12130",37,6,120,80,2310325,2312586,2261
"12227",37,4,130,81,2315280,2317580,2300
"12326",37,5,77,82,2321104,2333366,12262
"12423",37,2,20,83,2335810,2340059,4249
"12620",37,2,74,84,2345243,2349425,4182
"12726",37,2,56,85,2352145,2354367,2222
"12825",37,4,100,86,2356688,2358537,1849
"12929",37,5,59,87,2360819,2362550,1731
"13024",37,4,88,88,2364917,2366982,2065
"13125",37,2,2,89,2369499,2371649,2150
"13324",37,1,109,90,2377604,2380513,2909
"13424",37,6,36,91,2382873,2384506,1633
"13623",37,6,138,92,2389455,2395245,5790
"13727",37,3,111,93,2398076,2399585,1509
"13824",37,5,5,94,2402253,2405318,3065
"14027",37,4,28,95,2412679,2415024,2345
"14226",37,6,54,96,2420267,2421921,1654
"14427",37,1,31,97,2428589,2430346,1757
"14625",37,1,37,98,2437164,2440203,3039
"14822",37,3,81,99,2446805,2451426,4621
"14928",37,5,35,100,2454237,2459041,4804
"15129",37,4,22,101,2463963,2480179,16216
"15326",37,2,128,102,2485134,2490114,4980
"15427",37,2,104,103,2492834,2496194,3360
"15522",37,3,123,104,2499933,2503933,4000
"15625",37,3,105,105,2506574,2509344,2770
"15730",37,5,71,106,2512796,2514266,1470
"15826",37,2,32,107,2516816,2517757,941
"16031",37,3,15,108,2523993,2525672,1679
"16225",37,1,97,109,2532223,2537215,4992
"16328",37,5,101,110,2540046,2542967,2921
"16425",37,6,18,111,2545831,2550164,4333
"16625",37,2,122,112,2559728,2561459,1731
"16729",37,4,94,113,2564773,2566832,2059
"16827",37,5,23,114,2569728,2573637,3909
"17028",37,3,51,115,2578546,2581290,2744
"17230",37,6,42,116,2586697,2589428,2731
"17424",37,2,44,117,2596907,2598978,2071
"17628",37,3,129,118,2604666,2606880,2214
"17726",37,2,86,119,2609685,2611704,2019
"17827",37,5,95,120,2614496,2615188,692
"17926",37,1,73,121,2618797,2621713,2916
"18025",37,4,52,122,2625758,2627601,1843
"18225",37,1,61,123,2633824,2635568,1744
"18324",37,6,102,124,2641445,2643249,1804
"18426",37,5,47,125,2646171,2647550,1379
"18625",37,1,103,126,2653041,2654864,1823
"18723",37,1,13,127,2658198,2660983,2785
"18924",37,3,57,128,2666630,2668211,1581
"19026",37,5,131,129,2671290,2673074,1784
"19126",37,5,119,130,2680526,2682192,1666
"19232",37,6,48,131,2685383,2691233,5850
"19423",37,4,118,132,2701254,2702913,1659
"19525",37,3,135,133,2705606,2709744,4138
"19627",37,5,89,134,2712600,2715018,2418
"19726",37,1,121,135,2718097,2719456,1359
"19823",37,5,65,136,2722104,2724104,2000
"19931",37,5,29,137,2726516,2728862,2346
"20128",37,6,78,138,2734236,2737137,2901
"10132",38,3,26,1,3553662,3556603,2941
"12131",38,2,37,2,3563166,3565643,2477
"14132",38,4,3,3,3570748,3573382,2634
"16104",38,1,30,4,3579605,3582062,2457
"18134",38,6,47,5,3587383,3590115,2732
"2034",38,3,104,6,3597011,3599887,2876
"2132",38,5,94,7,3602358,3605286,2928
"2228",38,6,59,8,3607822,3611927,4105
"2328",38,2,73,9,3614843,3618169,3326
"2426",38,2,49,10,3621320,3623862,2542
"2629",38,3,80,11,3629216,3631967,2751
"2722",38,2,13,12,3634876,3637824,2948
"2930",38,2,25,13,3642779,3644922,2143
"3127",38,1,60,14,3651727,3654296,2569
"3224",38,5,100,15,3656597,3659564,2967
"3326",38,5,130,16,3662146,3666270,4124
"3429",38,3,110,17,3674154,3676447,2293
"3525",38,3,68,18,3678932,3681624,2692
"3627",38,2,43,19,3685011,3688056,3045
"3825",38,5,106,20,3694867,3698305,3438
"3930",38,4,93,21,3701306,3703528,2222
"4026",38,1,114,22,3706718,3709620,2902
"4130",38,3,86,23,3715588,3718783,3195
"4225",38,2,67,24,3721059,3723725,2666
"4324",38,5,118,25,3726399,3730288,3889
"4431",38,2,103,26,3732766,3735569,2803
"4518",38,2,121,27,3737955,3741870,3915
"4628",38,2,97,28,3744596,3746910,2314
"4729",38,5,46,29,3749420,3753093,3673
"4924",38,3,92,30,3758813,3762381,3568
"5032",38,3,62,31,3764637,3767172,2535
"5122",38,2,55,32,3769781,3772460,2679
"5231",38,3,50,33,3774873,3778467,3594
"5432",38,6,107,34,3783422,3787063,3641
"5529",38,4,87,35,3789423,3792743,3320
"5628",38,5,124,36,3795096,3797743,2647
"5728",38,5,52,37,3800005,3802541,2536
"5928",38,1,132,38,3807999,3810326,2327
"6026",38,5,70,39,3812790,3816045,3255
"6125",38,1,138,40,3818327,3821084,2757
"6231",38,6,53,41,3823700,3826320,2620
"6427",38,2,115,42,3831654,3834654,3000
"6530",38,2,79,43,3837145,3839190,2045
"6625",38,6,95,44,3841452,3844223,2771
"6727",38,6,83,45,3846832,3850603,3771
"6824",38,6,41,46,3852950,3855518,2568
"7029",38,4,75,47,3860735,3864231,3496
"7127",38,3,32,48,3866742,3869336,2594
"7328",38,4,129,49,3874344,3876127,1783
"7428",38,3,116,50,3878494,3881605,3111
"7528",38,4,21,51,3883834,3886291,2457
"7726",38,4,15,52,3891162,3892906,1744
"7928",38,5,58,53,3897986,3900116,2130
"8025",38,3,14,54,3902626,3905763,3137
"8230",38,4,123,55,3910699,3913470,2771
"8330",38,1,78,56,3916137,3918202,2065
"8417",38,5,22,57,3920490,3923130,2640
"8633",38,4,105,58,3928053,3930111,2058
"8720",38,1,36,59,3932465,3934935,2470
"8923",38,1,72,60,3939884,3941726,1842
"9022",38,4,45,61,3944531,3946910,2379
"9228",38,4,57,62,3951715,3954093,2378
"9332",38,1,24,63,3956532,3958538,2006
"9524",38,2,61,64,3964408,3966460,2052
"9623",38,3,20,65,3968873,3971323,2450
"9828",38,1,96,66,4008026,4010372,2346
"9927",38,2,109,67,4013176,4016124,2948
"10032",38,4,63,68,4019327,4021130,1803
"10133",38,4,135,69,4023948,4026948,3000
"10230",38,5,88,70,4029877,4032085,2208
"10327",38,1,84,71,4035125,4038125,3000
"10426",38,1,12,72,4041329,4043145,1816
"10630",38,6,17,73,4050584,4054361,3777
"10825",38,5,4,74,4059454,4062323,2869
"11021",38,6,35,75,4068396,4071108,2712
"11230",38,6,131,76,4077318,4079978,2660
"11326",38,3,134,77,4082560,4084939,2379
"11429",38,6,101,78,4087521,4089723,2202
"11522",38,3,98,79,4094639,4097391,2752
"11630",38,2,1,80,4102686,4104594,1908
"11826",38,6,5,81,4109843,4112189,2346
"12024",38,5,40,82,4117902,4120555,2653
"12228",38,3,38,83,4125936,4128340,2404
"12424",38,3,128,84,4133374,4135916,2542
"12529",38,1,108,85,4139668,4142270,2602
"12621",38,6,23,86,4145826,4147936,2110
"12826",38,4,51,87,4152290,4155322,3032
"13025",38,1,54,88,4161376,4163473,2097
"13227",38,4,69,89,4170474,4172807,2333
"13325",38,1,126,90,4176292,4178605,2313
"13425",38,6,119,91,4181501,4184821,3320
"13524",38,3,8,92,4187574,4190240,2666
"13728",38,1,42,93,4195515,4198489,2974
"13927",38,3,122,94,4204248,4205907,1659
"14028",38,6,89,95,4208725,4211679,2954
"14133",38,3,56,96,4214523,4217274,2751
"14227",38,4,117,97,4221458,4223275,1817
"14329",38,1,18,98,4228674,4231445,2771
"14523",38,4,99,99,4236610,4238857,2247
"14626",38,6,11,100,4241446,4243864,2418
"14823",38,2,133,101,4249022,4251597,2575
"14929",38,5,76,102,4254689,4258284,3595
"15030",38,5,82,103,4261114,4263303,2189
"15130",38,2,85,104,4266206,4268755,2549
"15227",38,6,113,105,4272828,4274912,2084
"15327",38,1,120,106,4278945,4281416,2471
"15428",38,1,66,107,4285992,4288939,2947
"15523",38,5,112,108,4292476,4294953,2477
"15626",38,1,102,109,4299156,4301554,2398
"15731",38,5,136,110,4304150,4306516,2366
"15827",38,6,125,111,4309758,4312274,2516
"15923",38,5,34,112,4314778,4317111,2333
"16127",38,6,65,113,4323256,4325628,2372
"16226",38,2,31,114,4328054,4330426,2372
"16426",38,4,111,115,4337061,4339707,2646
"16526",38,5,64,116,4343617,4346531,2914
"16626",38,1,90,117,4349336,4351865,2529
"16730",38,4,33,118,4354827,4357075,2248
"16926",38,1,48,119,4362383,4364088,1705
"17129",38,4,39,120,4375384,4377984,2600
"17326",38,4,27,121,4383201,4385599,2398
"17527",38,5,28,122,4390117,4393253,3136
"17727",38,5,10,123,4400111,4402862,2751
"17927",38,5,16,124,4408732,4411255,2523
"18135",38,2,19,125,4416589,4418954,2365
"18325",38,6,137,126,4430119,4433354,3235
"18427",38,2,7,127,4436250,4438930,2680
"18626",38,4,9,128,4445519,4448891,3372
"18829",38,3,2,129,4454225,4456591,2366
"19027",38,2,127,130,4462795,4464938,2143
"19127",38,6,71,131,4470142,4472102,1960
"19233",38,1,6,132,4474809,4478416,3607
"19424",38,6,29,133,4484221,4486887,2666
"19628",38,2,91,134,4491921,4494182,2261
"19727",38,3,44,135,4496836,4498679,1843
"19932",38,6,77,136,4503935,4505869,1934
"20024",38,4,81,137,4508608,4510706,2098
"20129",38,3,74,138,4513478,4515503,2025
"10134",39,2,66,1,6008447,6012296,3849
"11105",39,6,34,2,6015245,6019722,4477
"13126",39,4,2,3,6026775,6033598,6823
"15131",39,1,23,4,6041541,6045298,3757
"17107",39,4,86,5,6050417,6054600,4183
"18136",39,1,53,6,6057352,6063136,5784
"2035",39,6,118,7,6069248,6074536,5288
"2133",39,3,127,8,6077445,6085785,8340
"2229",39,1,83,9,6088616,6095818,7202
"2329",39,5,27,10,6098799,6101982,3183
"2528",39,6,136,11,6109500,6114114,4614
"2630",39,6,112,12,6116618,6121454,4836
"2723",39,2,108,13,6124703,6128160,3457
"2825",39,3,97,14,6131070,6134487,3417
"2931",39,4,110,15,6137933,6141344,3411
"3030",39,3,49,16,6144103,6148456,4353
"3225",39,2,36,17,6154862,6157966,3104
"3430",39,3,55,18,6164052,6166738,2686
"3526",39,2,54,19,6169477,6172529,3052
"3723",39,5,99,20,6177687,6182216,4529
"3826",39,3,43,21,6185184,6189805,4621
"4027",39,4,56,22,6197564,6204329,6765
"4131",39,5,111,23,6206800,6210806,4006
"4226",39,6,4,24,6213709,6218833,5124
"4432",39,4,50,25,6226860,6232690,5830
"4629",39,6,10,26,6239070,6244246,5176
"4823",39,1,17,27,6249849,6256496,6647
"5033",39,2,90,28,6262163,6264777,2614
"5123",39,2,24,29,6267843,6271739,3896
"5327",39,1,11,30,6279707,6284210,4503
"5530",39,5,75,31,6290106,6294910,4804
"5629",39,6,70,32,6297741,6301937,4196
"5729",39,3,19,33,6304728,6307506,2778
"5929",39,5,135,34,6314945,6326951,12006
"6027",39,4,128,35,6329586,6340808,11222
"6126",39,4,116,36,6343522,6348672,5150
"6232",39,2,102,37,6351751,6354718,2967
"6323",39,3,37,38,6357412,6364607,7195
"6531",39,2,78,39,6371295,6375765,4470
"6626",39,1,47,40,6378420,6384798,6378
"6825",39,2,84,41,6390355,6396342,5987
"6927",39,4,92,42,6398748,6407473,8725
"7030",39,2,126,43,6409801,6416036,6235
"7128",39,1,29,44,6418834,6423873,5039
"7329",39,1,71,45,6430122,6434475,4353
"7429",39,4,98,46,6436972,6447495,10523
"7529",39,4,134,47,6450084,6452992,2908
"7633",39,6,124,48,6455869,6459496,3627
"7727",39,2,96,49,6461987,6465510,3523
"7830",39,2,120,50,6468105,6472229,4124
"7929",39,1,59,51,6475014,6480386,5372
"8026",39,1,107,52,6482904,6487295,4391
"8124",39,3,79,53,6490067,6492688,2621
"8231",39,3,61,54,6495094,6499394,4300
"8331",39,2,12,55,6502774,6506637,3863
"8527",39,6,82,56,6512259,6514990,2731
"8634",39,5,9,57,6517605,6521389,3784
"8829",39,4,68,58,6532665,6536717,4052
"8924",39,1,119,59,6539581,6546437,6856
"9023",39,5,15,60,6549385,6551470,2085
"9229",39,3,103,61,6556732,6565091,8359
"9333",39,6,40,62,6567694,6573066,5372
"9525",39,3,133,63,6580564,6584746,4182
"9624",39,3,115,64,6587126,6592943,5817
"9722",39,4,14,65,6595512,6600610,5098
"9928",39,5,117,66,6671557,6674439,2882
"10033",39,3,121,67,6677348,6681661,4313
"10135",39,4,8,68,6684813,6688204,3391
"10328",39,6,76,69,6693454,6699538,6084
"10427",39,5,63,70,6702173,6705225,3052
"10526",39,1,5,71,6709167,6712134,2967
"10728",39,3,13,72,6717939,6722533,4594
"10931",39,2,6,73,6728665,6734024,5359
"11134",39,5,3,74,6739770,6744208,4438
"11327",39,5,129,75,6750967,6755745,4778
"11430",39,6,46,76,6758125,6765281,7156
"11631",39,1,77,77,6774073,6779772,5699
"11731",39,5,93,78,6784957,6789316,4359
"11827",39,6,22,79,6793356,6800166,6810
"12025",39,5,39,80,6807056,6810657,3601
"12229",39,5,21,81,6815776,6820311,4535
"12425",39,1,95,82,6827221,6832064,4843
"12530",39,3,109,83,6836803,6843332,6529
"12622",39,2,72,84,6847248,6854346,7098
"12727",39,3,73,85,6858001,6861425,3424
"12827",39,5,33,86,6864563,6870367,5804
"13026",39,6,100,87,6876061,6885819,9758
"13127",39,5,123,88,6889441,6894649,5208
"13228",39,5,87,89,6897402,6901604,4202
"13326",39,2,114,90,6904736,6912062,7326
"13426",39,3,67,91,6914495,6921364,6869
"13525",39,1,101,92,6924410,6928952,4542
"13624",39,2,60,93,6932522,6936763,4241
"13729",39,2,42,94,6941059,6945601,4542
"13928",39,6,88,95,6951641,6956915,5274
"14029",39,5,51,96,6960844,6966733,5889
"14228",39,2,30,97,6973296,6977250,3954
"14428",39,4,104,98,6981937,6989048,7111
"14524",39,3,1,99,6992650,6997656,5006
"14724",39,4,32,100,7003487,7006899,3412
"14930",39,3,91,101,7012017,7015664,3647
"15031",39,6,106,102,7017926,7021338,3412
"15132",39,1,125,103,7024763,7029109,4346
"15228",39,2,48,104,7033548,7035966,2418
"15429",39,4,20,105,7041653,7045326,3673
"15627",39,1,113,106,7050785,7054608,3823
"15732",39,4,44,107,7057151,7060798,3647
"15924",39,4,122,108,7065773,7068609,2836
"16032",39,4,38,109,7072989,7078361,5372
"16227",39,6,58,110,7083251,7089375,6124
"16329",39,6,64,111,7093056,7098206,5150
"16427",39,5,81,112,7102252,7107487,5235
"16527",39,1,41,113,7110495,7116906,6411
"16731",39,5,69,114,7122522,7126162,3640
"16828",39,4,62,115,7129424,7133110,3686
"16927",39,2,138,116,7135790,7140320,4530
"17029",39,5,57,117,7145242,7153072,7830
"17130",39,3,85,118,7157099,7164589,7490
"17231",39,6,52,119,7167695,7174433,6738
"17425",39,1,65,120,7180689,7183577,2888
"17528",39,1,131,121,7186389,7190120,3731
"17629",39,6,130,122,7192833,7199944,7111
"17728",39,4,74,123,7203252,7211586,8334
"17828",39,5,45,124,7214103,7222312,8209
"18026",39,6,94,125,7227640,7233620,5980
"18137",39,2,132,126,7236503,7241568,5065
"18226",39,6,16,127,7244641,7248020,3379
"18428",39,1,137,128,7253400,7256308,2908
"18528",39,3,25,129,7259263,7265537,6274
"18724",39,4,26,130,7270956,7275767,4811
"18925",39,1,35,131,7281205,7284545,3340
"19128",39,3,31,132,7290566,7298167,7601
"19328",39,1,89,133,7303998,7310573,6575
"19425",39,3,7,134,7314142,7320436,6294
"19629",39,5,105,135,7330980,7336437,5457
"19728",39,2,18,136,7339575,7344582,5007
"19933",39,6,28,137,7349772,7359432,9660
"20130",39,4,80,138,7365669,7369263,3594
"10136",40,1,52,1,11059922,11063385,3463
"12132",40,3,120,2,11068876,11072732,3856
"13128",40,4,121,3,11075537,11079145,3608
"14134",40,6,3,4,11081498,11084818,3320
"16105",40,1,94,5,11090891,11095113,4222
"17108",40,5,74,6,11097604,11101558,3954
"18138",40,6,129,7,11103970,11107924,3954
"19105",40,6,63,8,11110337,11113859,3522
"2036",40,2,89,9,11116422,11120186,3764
"2134",40,5,38,10,11123024,11126318,3294
"2330",40,3,108,11,11132770,11137057,4287
"2427",40,1,46,12,11139443,11142476,3033
"2631",40,1,112,13,11148058,11151234,3176
"2724",40,2,65,14,11153608,11156816,3208
"2826",40,5,104,15,11159353,11162653,3300
"2932",40,6,69,16,11165510,11168863,3353
"3031",40,5,80,17,11171406,11174713,3307
"3128",40,4,61,18,11177786,11181929,4143
"3226",40,6,123,19,11184446,11188531,4085
"3327",40,3,24,20,11191179,11194335,3156
"3527",40,6,51,21,11200545,11204042,3497
"3724",40,3,126,22,11210004,11213683,3679
"3827",40,5,26,23,11216233,11220376,4143
"4028",40,1,118,24,11227554,11230887,3333
"4132",40,4,7,25,11233646,11236547,2901
"4325",40,2,101,26,11242967,11246456,3489
"4433",40,5,122,27,11248712,11250908,2196
"4519",40,3,96,28,11253542,11256915,3373
"4630",40,5,2,29,11259504,11262078,2574
"4824",40,4,19,30,11269733,11272510,2777
"5034",40,6,105,31,11279021,11281851,2830
"5124",40,4,109,32,11284969,11288851,3882
"5232",40,6,135,33,11291133,11295140,4007
"5328",40,6,9,34,11297742,11301310,3568
"5531",40,5,86,35,11307036,11310271,3235
"5630",40,1,100,36,11312703,11316160,3457
"5730",40,4,37,37,11318488,11321925,3437
"5930",40,1,82,38,11328560,11331822,3262
"6028",40,6,87,39,11334450,11339384,4934
"6127",40,6,93,40,11342182,11344914,2732
"6233",40,1,28,41,11347261,11350757,3496
"6428",40,6,81,42,11357889,11361431,3542
"6532",40,2,17,43,11363648,11367857,4209
"6728",40,5,98,44,11373354,11376171,2817
"6826",40,3,114,45,11378721,11382688,3967
"6928",40,6,45,46,11385107,11388002,2895
"7129",40,2,41,47,11393630,11398127,4497
"7330",40,6,99,48,11403794,11406977,3183
"7430",40,4,67,49,11409886,11413670,3784
"7530",40,3,36,50,11415965,11418154,2189
"7728",40,1,124,51,11424508,11427135,2627
"7831",40,3,138,52,11430097,11432985,2888
"7930",40,6,27,53,11435411,11438783,3372
"8125",40,4,55,54,11444653,11446914,2261
"8232",40,3,72,55,11449824,11452392,2568
"8332",40,3,102,56,11455164,11457595,2431
"8418",40,2,23,57,11459942,11462373,2431
"8635",40,2,131,58,11468668,11471752,3084
"8721",40,1,106,59,11474165,11476949,2784
"8830",40,5,68,60,11479231,11482858,3627
"8925",40,2,71,61,11485382,11488479,3097
"9024",40,2,47,62,11490807,11493329,2522
"9230",40,4,25,63,11499448,11502957,3509
"9425",40,1,88,64,11508239,11511200,2961
"9526",40,2,95,65,11513959,11516952,2993
"9625",40,1,4,66,11548261,11551601,3340
"9829",40,4,91,67,11556863,11561857,4994
"9929",40,2,113,68,11564243,11566556,2313
"10034",40,2,107,69,11568890,11572236,3346
"10137",40,2,119,70,11574584,11577564,2980
"10231",40,4,127,71,11579950,11582845,2895
"10329",40,5,134,72,11585336,11588904,3568
"10428",40,3,18,73,11591454,11593532,2078
"10631",40,3,132,74,11599356,11602912,3556
"10729",40,1,34,75,11605220,11608552,3332
"10932",40,4,115,76,11614939,11618017,3078
"11022",40,6,111,77,11620619,11623475,2856
"11135",40,4,73,78,11626045,11629508,3463
"11231",40,1,40,79,11631875,11634613,2738
"11431",40,5,56,80,11640483,11643836,3353
"11523",40,2,5,81,11646216,11650908,4692
"11732",40,3,84,82,11656752,11659759,3007
"11828",40,5,62,83,11662335,11665406,3071
"11929",40,3,90,84,11667845,11671701,3856
"12026",40,3,54,85,11674159,11677492,3333
"12230",40,1,64,86,11684160,11688466,4306
"12327",40,2,83,87,11691029,11694950,3921
"12426",40,4,1,88,11697265,11699800,2535
"12623",40,4,13,89,11705200,11708605,3405
"12828",40,5,8,90,11714077,11717390,3313
"13027",40,6,21,91,11724247,11727443,3196
"13229",40,1,22,92,11733032,11736117,3085
"13427",40,4,97,93,11742000,11745176,3176
"13526",40,4,85,94,11747582,11752013,4431
"13625",40,2,137,95,11754707,11757347,2640
"13730",40,6,15,96,11759890,11762210,2320
"13929",40,3,60,97,11768361,11772322,3961
"14030",40,2,35,98,11774649,11777734,3085
"14229",40,5,14,99,11784212,11787133,2921
"14429",40,5,92,100,11792480,11796644,4164
"14525",40,6,33,101,11799095,11802749,3654
"14725",40,6,75,102,11808410,11811337,2927
"14824",40,6,39,103,11813953,11818018,4065
"15032",40,5,44,104,11823907,11826449,2542
"15229",40,1,130,105,11831849,11835731,3882
"15328",40,4,31,106,11838124,11841699,3575
"15524",40,3,30,107,11846700,11849954,3254
"15733",40,3,78,108,11855236,11857981,2745
"15828",40,5,20,109,11860158,11863524,3366
"16033",40,1,70,110,11869362,11873322,3960
"16128",40,4,43,111,11875800,11879721,3921
"16330",40,1,58,112,11885343,11889323,3980
"16428",40,4,103,113,11893043,11896225,3182
"16528",40,4,79,114,11898984,11902062,3078
"16627",40,3,6,115,11904344,11908069,3725
"16829",40,2,59,116,11913887,11917357,3470
"16928",40,3,48,117,11920352,11922332,1980
"17131",40,5,50,118,11928980,11932757,3777
"17327",40,6,117,119,11937699,11940065,2366
"17426",40,4,49,120,11943092,11946353,3261
"17630",40,5,116,121,11951374,11955203,3829
"17729",40,6,57,122,11957557,11960825,3268
"17829",40,2,53,123,11963335,11967099,3764
"18027",40,1,76,124,11972643,11976081,3438
"18139",40,1,16,125,11978898,11982251,3353
"18326",40,1,10,126,11989095,11992755,3660
"18529",40,2,29,127,11998553,12001246,2693
"18725",40,5,128,128,12006593,12010612,4019
"18830",40,2,11,129,12013254,12016515,3261
"19028",40,5,32,130,12022378,12026032,3654
"19234",40,3,42,131,12031529,12035333,3804
"19426",40,1,136,132,12041478,12044941,3463
"19526",40,3,66,133,12047112,12050425,3313
"19630",40,4,133,134,12052720,12055471,2751
"19729",40,5,110,135,12057773,12061321,3548
"19824",40,2,77,136,12065701,12069596,3895
"19934",40,2,125,137,12071996,12075087,3091
"20025",40,3,12,138,12077454,12080695,3241
"10138",41,6,110,1,322321,328209,5888
"11106",41,4,24,2,332210,339034,6824
"13129",41,2,58,3,346329,353054,6725
"14135",41,2,22,4,356009,361872,5863
"16106",41,5,31,5,368559,377213,8654
"18140",41,1,93,6,383292,390521,7229
"19106",41,6,68,7,393227,400338,7111
"2037",41,2,70,8,403607,410528,6921
"2135",41,2,64,9,413242,418640,5398
"2230",41,5,103,10,421641,427569,5928
"2331",41,3,113,11,430524,438125,7601
"2428",41,5,91,12,441152,447204,6052
"2529",41,2,106,13,450303,454721,4418
"2632",41,2,100,14,457362,462806,5444
"2725",41,3,77,15,465434,474068,8634
"2827",41,4,96,16,479696,486579,6883
"2933",41,4,48,17,489070,492507,3437
"3129",41,4,36,18,499358,503861,4503
"3328",41,1,9,19,510097,516836,6739
"3528",41,3,101,20,522039,527366,5327
"3628",41,2,16,21,530752,538582,7830
"3828",41,6,50,22,549714,556171,6457
"4029",41,3,125,23,562545,569682,7137
"4133",41,6,56,24,573055,580356,7301
"4227",41,6,134,25,583592,589494,5902
"4326",41,6,38,26,592410,597932,5522
"4520",41,2,28,27,604907,610979,6072
"4730",41,4,66,28,617326,622947,5621
"4825",41,1,3,29,627164,635641,8477
"5035",41,2,94,30,642001,648530,6529
"5125",41,3,89,31,650943,656204,5261
"5233",41,2,40,32,658656,664250,5594
"5433",41,6,26,33,670179,676454,6275
"5631",41,5,49,34,682330,689213,6883
"5826",41,6,92,35,694710,700109,5399
"5931",41,4,30,36,703410,710946,7536
"6128",41,2,4,37,718294,725163,6869
"6324",41,3,119,38,731778,738961,7183
"6429",41,1,81,39,741308,746556,5248
"6533",41,5,127,40,748871,754112,5241
"6627",41,1,33,41,756825,764466,7641
"6827",41,5,115,42,772735,777539,4804
"6929",41,5,133,43,780500,786716,6216
"7031",41,6,98,44,789769,796363,6594
"7130",41,3,137,45,798991,804795,5804
"7222",41,3,53,46,808495,813207,4712
"7431",41,3,65,47,818489,823528,5039
"7531",41,5,73,48,827457,832947,5490
"7634",41,4,78,49,835824,842647,6823
"7729",41,6,74,50,845027,853112,8085
"7832",41,1,63,51,856512,863707,7195
"7931",41,3,59,52,867140,875662,8522
"8027",41,6,104,53,878598,886330,7732
"8126",41,2,124,54,889265,894807,5542
"8233",41,6,8,55,897560,903207,5647
"8419",41,4,90,56,909352,913038,3686
"8528",41,5,97,57,915345,920881,5536
"8636",41,1,39,58,923777,929065,5288
"8831",41,1,123,59,935229,942301,7072
"8926",41,2,88,60,944700,948791,4091
"9025",41,4,84,61,951884,957570,5686
"9131",41,2,130,62,961100,967230,6130
"9231",41,1,51,63,970349,975571,5222
"9426",41,6,122,64,982147,985833,3686
"9527",41,3,5,65,988468,991441,2973
"9723",41,3,41,66,1075160,1080486,5326
"9930",41,5,43,67,1086206,1091467,5261
"10139",41,1,105,68,1098932,1103376,4444
"10232",41,4,108,69,1106037,1110181,4144
"10330",41,2,10,70,1116836,1122188,5352
"10527",41,2,136,71,1128889,1135790,6901
"10632",41,4,120,72,1141706,1145288,3582
"10730",41,1,99,73,1148243,1151922,3679
"10826",41,4,138,74,1154322,1159243,4921
"10933",41,4,72,75,1162093,1165727,3634
"11023",41,2,112,76,1169486,1173388,3902
"11136",41,5,67,77,1176277,1182303,6026
"11232",41,3,29,78,1185696,1193324,7628
"11432",41,6,2,79,1199704,1204599,4895
"11632",41,2,46,80,1211567,1216371,4804
"11829",41,5,79,81,1223163,1229502,6339
"11930",41,1,27,82,1232392,1236699,4307
"12133",41,1,75,83,1243576,1248229,4653
"12231",41,6,20,84,1252877,1257811,4934
"12427",41,3,11,85,1264675,1270694,6019
"12624",41,4,12,86,1276866,1281427,4561
"12829",41,4,18,87,1288043,1291532,3489
"13028",41,2,82,88,1296756,1304429,7673
"13130",41,4,42,89,1307796,1312946,5150
"13327",41,1,117,90,1318921,1322338,3417
"13428",41,5,25,91,1325738,1330300,4562
"13626",41,6,116,92,1335549,1341261,5712
"13731",41,2,52,93,1344589,1350249,5660
"13930",41,5,1,94,1356779,1361674,4895
"14136",41,6,86,95,1367440,1373152,5712
"14230",41,4,114,96,1376101,1381865,5764
"14330",41,3,95,97,1384807,1389872,5065
"14430",41,4,54,98,1392768,1398977,6209
"14627",41,1,129,99,1405325,1409377,4052
"14726",41,2,34,100,1411776,1416436,4660
"14931",41,5,13,101,1423091,1427064,3973
"15133",41,1,21,102,1432510,1436660,4150
"15329",41,5,37,103,1442183,1446497,4314
"15525",41,6,80,104,1453557,1457916,4359
"15628",41,3,35,105,1460917,1465256,4339
"15829",41,3,47,106,1471976,1476688,4712
"16034",41,6,14,107,1481683,1487584,5901
"16228",41,4,132,108,1496553,1501716,5163
"16331",41,3,107,109,1504390,1507305,2915
"16429",41,5,109,110,1509724,1512913,3189
"16529",41,1,111,111,1515966,1519188,3222
"16628",41,5,7,112,1522012,1528175,6163
"16830",41,5,121,113,1535320,1539451,4131
"16929",41,4,126,114,1542510,1546464,3954
"17030",41,3,23,115,1548942,1551432,2490
"17232",41,1,15,116,1556550,1559060,2510
"17427",41,3,131,117,1564525,1570943,6418
"17529",41,5,61,118,1573159,1577434,4275
"17631",41,2,76,119,1581219,1585617,4398
"17730",41,6,62,120,1588343,1592434,4091
"17830",41,1,87,121,1595011,1601984,6973
"17928",41,5,19,122,1605089,1608494,3405
"18141",41,4,60,123,1614051,1619319,5268
"18227",41,4,102,124,1621973,1626960,4987
"18327",41,6,44,125,1629483,1632627,3144
"18530",41,3,71,126,1639576,1644039,4463
"18627",41,4,6,127,1646229,1651726,5497
"18831",41,6,128,128,1657446,1667714,10268
"18926",41,5,55,129,1670140,1674368,4228
"19029",41,1,69,130,1676741,1683342,6601
"19129",41,1,135,131,1686533,1691493,4960
"19235",41,5,85,132,1695605,1700853,5248
"19329",41,3,83,133,1703436,1707945,4509
"19427",41,3,17,134,1710567,1714325,3758
"19631",41,2,118,135,1720947,1724757,3810
"19730",41,1,45,136,1727352,1731097,3745
"19935",41,1,57,137,1735739,1741248,5509
"20026",41,6,32,138,1744419,1750961,6542
"10140",42,4,113,1,5454702,5458127,3425
"11107",42,3,118,2,5460421,5463990,3569
"12134",42,5,72,3,5466402,5469460,3058
"13131",42,3,100,4,5471919,5476991,5072
"14137",42,2,69,5,5479514,5482128,2614
"15134",42,2,135,6,5484547,5487886,3339
"16107",42,1,68,7,5490273,5493357,3084
"17109",42,3,58,8,5495881,5498724,2843
"18142",42,5,96,9,5502006,5504646,2640
"19107",42,4,53,10,5507470,5510744,3274
"2136",42,3,70,11,5517190,5520359,3169
"2231",42,5,30,12,5522785,5527079,4294
"2429",42,1,104,13,5532191,5535360,3169
"2530",42,5,132,14,5537845,5541276,3431
"2633",42,2,81,15,5544538,5548695,4157
"2726",42,3,112,16,5581861,5585299,3438
"2828",42,6,79,17,5587645,5590887,3242
"2934",42,2,75,18,5593319,5597149,3830
"3032",42,4,23,19,5600339,5602835,2496
"3227",42,4,65,20,5608039,5610862,2823
"3329",42,5,108,21,5613425,5617653,4228
"3431",42,3,94,22,5619961,5623432,3471
"3529",42,4,131,23,5625785,5628275,2490
"3629",42,3,130,24,5635421,5638735,3314
"3725",42,2,111,25,5641296,5644616,3320
"3829",42,2,51,26,5647447,5651427,3980
"4030",42,6,55,27,5656689,5659303,2614
"4134",42,4,101,28,5662088,5665246,3158
"4228",42,5,126,29,5668259,5671690,3431
"4327",42,5,90,30,5674167,5678540,4373
"4434",42,6,37,31,5680965,5684135,3170
"4631",42,6,97,32,5690325,5693181,2856
"4731",42,6,91,33,5695443,5698926,3483
"4826",42,2,99,34,5701130,5704430,3300
"4925",42,6,61,35,5707013,5709626,2613
"5036",42,1,128,36,5716564,5720989,4425
"5126",42,3,22,37,5723321,5726745,3424
"5329",42,5,138,38,5731825,5734243,2418
"5434",42,2,39,39,5736714,5739282,2568
"5632",42,5,120,40,5744505,5747694,3189
"5731",42,3,34,41,5750048,5753519,3471
"5932",42,5,66,42,5760193,5763009,2816
"6029",42,4,137,43,5765389,5768166,2777
"6129",42,3,40,44,5770592,5774017,3425
"6325",42,6,49,45,5779861,5783279,3418
"6534",42,4,17,46,5788678,5794338,5660
"6729",42,5,6,47,5800489,5803371,2882
"6930",42,6,1,48,5808817,5811882,3065
"7131",42,1,86,49,5819413,5822412,2999
"7223",42,1,38,50,5825158,5827582,2424
"7432",42,2,27,51,5832877,5835844,2967
"7635",42,4,35,52,5841172,5843636,2464
"7833",42,6,115,53,5849310,5851956,2646
"7932",42,4,29,54,5854558,5858873,4315
"8127",42,2,93,55,5864121,5867493,3372
"8234",42,4,95,56,5869873,5874729,4856
"8333",42,1,56,57,5877030,5881096,4066
"8420",42,2,15,58,5883593,5886128,2535
"8637",42,1,44,59,5891763,5896110,4347
"8832",42,1,134,60,5901829,5905875,4046
"8927",42,1,74,61,5908385,5911319,2934
"9026",42,4,59,62,5914046,5918262,4216
"9132",42,6,25,63,5920824,5923497,2673
"9334",42,3,46,64,5928655,5932321,3666
"9528",42,5,12,65,5937263,5940916,3653
"9724",42,5,78,66,6029269,6031785,2516
"9830",42,4,77,67,6034217,6037433,3216
"9931",42,3,16,68,6039976,6042459,2483
"10141",42,3,106,69,6047564,6049656,2092
"10233",42,6,43,70,6052101,6055846,3745
"10429",42,6,13,71,6060912,6067415,6503
"10633",42,2,33,72,6072762,6075932,3170
"10827",42,6,133,73,6081743,6084449,2706
"10934",42,3,4,74,6086933,6092201,5268
"11137",42,5,60,75,6097202,6100143,2941
"11233",42,1,2,76,6102463,6105319,2856
"11433",42,3,52,77,6111353,6113967,2614
"11633",42,6,31,78,6119190,6123654,4464
"11830",42,4,41,79,6128531,6132478,3947
"12027",42,2,117,80,6137453,6139590,2137
"12135",42,3,10,81,6141982,6144309,2327
"12328",42,4,5,82,6150349,6153885,3536
"12531",42,3,124,83,6159886,6162611,2725
"12625",42,3,88,84,6165226,6168533,3307
"12728",42,1,50,85,6170984,6173905,2921
"12930",42,5,36,86,6178691,6181279,2588
"13132",42,6,73,87,6186757,6189757,3000
"13230",42,1,20,88,6192156,6194129,1973
"13429",42,4,71,89,6199882,6203541,3659
"13527",42,6,109,90,6205849,6209921,4072
"13627",42,6,67,91,6212856,6216373,3517
"13732",42,6,85,92,6218883,6222680,3797
"13825",42,5,54,93,6225158,6229648,4490
"14031",42,4,89,94,6235165,6238929,3764
"14138",42,2,63,95,6241433,6243701,2268
"14231",42,5,84,96,6246048,6250532,4484
"14331",42,3,64,97,6252976,6256670,3694
"14431",42,3,136,98,6259324,6262055,2731
"14526",42,6,127,99,6264834,6267095,2261
"14628",42,1,98,100,6269847,6273390,3543
"14727",42,6,103,101,6275887,6281390,5503
"14825",42,3,28,102,6283717,6286756,3039
"15033",42,5,48,103,6292149,6294083,1934
"15230",42,1,122,104,6299365,6301398,2033
"15330",42,3,82,105,6304300,6306332,2032
"15430",42,2,57,106,6308660,6312360,3700
"15526",42,5,24,107,6316268,6319791,3523
"15734",42,4,107,108,6326021,6329661,3640
"15830",42,1,14,109,6332106,6335838,3732
"16035",42,1,8,110,6342257,6347035,4778
"16229",42,4,119,111,6352617,6360447,7830
"16332",42,2,123,112,6363108,6367109,4001
"16430",42,2,9,113,6369553,6373017,3464
"16629",42,4,83,114,6378416,6383011,4595
"16732",42,1,110,115,6385417,6389149,3732
"16831",42,6,7,116,6391986,6395443,3457
"17031",42,5,114,117,6401464,6406699,5235
"17132",42,2,45,118,6410484,6413470,2986
"17328",42,1,26,119,6418425,6421595,3170
"17530",42,1,80,120,6426844,6431615,4771
"17632",42,1,32,121,6434021,6436779,2758
"17831",42,2,21,122,6441950,6444891,2941
"18028",42,3,76,123,6449976,6454127,4151
"18143",42,2,87,124,6456506,6460199,3693
"18228",42,6,121,125,6462690,6466055,3365
"18328",42,5,42,126,6468383,6472043,3660
"18531",42,2,129,127,6477599,6480226,2627
"18628",42,1,116,128,6482475,6487979,5504
"18726",42,1,92,129,6490384,6494260,3876
"18832",42,4,125,130,6497555,6500411,2856
"18927",42,1,62,131,6502797,6505470,2673
"19030",42,4,11,132,6507823,6511045,3222
"19236",42,5,102,133,6515876,6519281,3405
"19330",42,5,18,134,6521602,6526661,5059
"19527",42,2,3,135,6532217,6534923,2706
"19731",42,6,19,136,6540165,6543884,3719
"19936",42,4,47,137,6551408,6553885,2477
"20131",42,2,105,138,6558846,6561434,2588
"10142",43,6,96,1,7653845,7662551,8706
"11108",43,4,4,2,7666794,7673696,6902
"13133",43,5,11,3,7680455,7685082,4627
"15135",43,5,29,4,7691600,7704802,13202
"17133",43,4,16,5,7711379,7724314,12935
"19108",43,3,99,6,7730001,7735942,5941
"2038",43,1,91,7,7740721,7747864,7143
"2137",43,4,52,8,7750421,7756525,6104
"2332",43,6,72,9,7762780,7768160,5380
"2430",43,4,22,10,7774252,7781056,6804
"2634",43,6,90,11,7795495,7804633,9138
"2727",43,3,135,12,7808274,7815757,7483
"2829",43,5,53,13,7818170,7829327,11157
"3033",43,2,92,14,7835080,7843400,8320
"3130",43,6,66,15,7845963,7851296,5333
"3228",43,6,48,16,7853911,7857035,3124
"3432",43,6,6,17,7862611,7870892,8281
"3630",43,3,3,18,7876174,7883167,6993
"3830",43,3,33,19,7888854,7895416,6562
"4031",43,6,78,20,7900907,7906920,6013
"4135",43,5,101,21,7909588,7914620,5032
"4229",43,5,35,22,7917170,7923444,6274
"4435",43,2,86,23,7930079,7934471,4392
"4521",43,4,130,24,7936936,7941936,5000
"4632",43,3,39,25,7944472,7949243,4771
"4827",43,2,44,26,7954506,7959839,5333
"5037",43,5,131,27,7965271,7970826,5555
"5127",43,2,38,28,7974010,7979343,5333
"5330",43,1,79,29,7985155,7991370,6215
"5435",43,3,129,30,7994365,7998188,3823
"5532",43,5,59,31,8000626,8005613,4987
"5633",43,4,76,32,8008241,8016156,7915
"5732",43,4,10,33,8018660,8026268,7608
"5933",43,6,84,34,8031975,8036818,4843
"6030",43,6,132,35,8039498,8045478,5980
"6130",43,6,12,36,8048218,8051753,3535
"6326",43,1,115,37,8057911,8063172,5261
"6430",43,3,105,38,8065820,8069656,3836
"6535",43,4,70,39,8072167,8079370,7203
"6628",43,1,1,40,8081821,8087422,5601
"6828",43,2,104,41,8094829,8099534,4705
"6931",43,1,133,42,8102594,8105234,2640
"7032",43,3,21,43,8107875,8112313,4438
"7224",43,5,125,44,8117850,8121222,3372
"7331",43,2,98,45,8123915,8136033,12118
"7433",43,4,88,46,8138662,8143707,5045
"7532",43,1,103,47,8146133,8149923,3790
"7636",43,4,64,48,8153473,8158636,5163
"7730",43,2,32,49,8161395,8164774,3379
"7933",43,1,37,50,8170350,8177010,6660
"8128",43,5,17,51,8182736,8188860,6124
"8334",43,5,77,52,8194234,8197364,3130
"8421",43,6,18,53,8199920,8206339,6419
"8638",43,1,31,54,8211274,8215568,4294
"8833",43,4,118,55,8221033,8224908,3875
"8928",43,3,69,56,8227576,8231196,3620
"9027",43,2,2,57,8233602,8237282,3680
"9232",43,4,46,58,8242695,8247021,4326
"9427",43,1,19,59,8252937,8256917,3980
"9626",43,1,85,60,8263343,8270107,6764
"9725",43,5,65,61,8272540,8275343,2803
"9831",43,2,74,62,8278063,8282585,4522
"9932",43,4,94,63,8286017,8293619,7602
"10035",43,5,107,64,8296051,8299828,3777
"10143",43,6,114,65,8302365,8307142,4777
"10234",43,2,122,66,8365278,8367774,2496
"10331",43,1,25,67,8370683,8374565,3882
"10528",43,2,68,68,8379756,8382899,3143
"10634",43,2,8,69,8385305,8389952,4647
"10828",43,1,97,70,8394770,8397462,2692
"10935",43,6,102,71,8400463,8404090,3627
"11024",43,4,82,72,8406450,8412032,5582
"11138",43,3,9,73,8414928,8420431,5503
"11328",43,1,67,74,8426340,8429059,2719
"11434",43,4,124,75,8431419,8438798,7379
"11524",43,1,109,76,8441655,8445674,4019
"11634",43,2,20,77,8448061,8452302,4241
"11831",43,4,58,78,8457977,8463859,5882
"11931",43,6,120,79,8467154,8473049,5895
"12028",43,1,7,80,8476037,8480193,4156
"12232",43,2,26,81,8486946,8490298,3352
"12428",43,5,5,82,8496240,8500253,4013
"12626",43,3,63,83,8505313,8508580,3267
"12729",43,3,75,84,8510777,8516856,6079
"12830",43,5,119,85,8518954,8524098,5144
"12931",43,3,15,86,8526445,8529641,3196
"13134",43,2,50,87,8536263,8539216,2953
"13328",43,5,83,88,8544100,8547622,3522
"13430",43,4,136,89,8549969,8555825,5856
"13528",43,2,128,90,8558950,8564440,5490
"13628",43,4,112,91,8566683,8570205,3522
"13733",43,6,108,92,8573023,8579089,6066
"13826",43,3,117,93,8581815,8584448,2633
"13931",43,5,71,94,8587403,8591357,3954
"14032",43,4,100,95,8595587,8599240,3653
"14139",43,5,95,96,8602914,8607607,4693
"14232",43,1,121,97,8610104,8613176,3072
"14332",43,5,113,98,8616464,8620196,3732
"14432",43,1,127,99,8623072,8626150,3078
"14527",43,2,110,100,8629269,8633948,4679
"14629",43,4,34,101,8636282,8640151,3869
"14826",43,3,87,102,8647446,8657028,9582
"14932",43,6,138,103,8659460,8662558,3098
"15034",43,2,116,104,8665082,8668349,3267
"15136",43,5,89,105,8671415,8675480,4065
"15231",43,2,80,106,8678226,8683056,4830
"15331",43,1,73,107,8686174,8689958,3784
"15431",43,6,30,108,8692488,8695900,3412
"15629",43,1,13,109,8701332,8706678,5346
"15831",43,6,36,110,8711535,8715875,4340
"16036",43,3,93,111,8721052,8726667,5615
"16129",43,6,60,112,8729693,8733386,3693
"16230",43,5,47,113,8735537,8741086,5549
"16431",43,6,126,114,8747924,8754198,6274
"16530",43,5,137,115,8756519,8761251,4732
"16630",43,2,56,116,8764408,8771016,6608
"16733",43,4,40,117,8773435,8778441,5006
"16930",43,6,24,118,8785815,8789455,3640
"17134",43,3,27,119,8795247,8799423,4176
"17329",43,5,23,120,8805600,8811339,5739
"17531",43,6,42,121,8817967,8821130,3163
"17731",43,3,111,122,8827308,8833556,6248
"17832",43,1,43,123,8835714,8839118,3404
"18029",43,3,123,124,8844093,8847361,3268
"18144",43,3,51,125,8849695,8853884,4189
"18329",43,4,28,126,8858486,8862205,3719
"18532",43,6,54,127,8868219,8871513,3294
"18727",43,1,61,128,8878612,8882226,3614
"18833",43,5,41,129,8886011,8889488,3477
"19031",43,1,55,130,8894306,8897018,2712
"19130",43,3,81,131,8899195,8901979,2784
"19237",43,2,134,132,8906169,8909312,3143
"19331",43,2,62,133,8911562,8914882,3320
"19428",43,1,49,134,8918314,8921549,3235
"19632",43,3,57,135,8926020,8931105,5085
"19732",43,2,14,136,8933949,8938602,4653
"19937",43,3,45,137,8945028,8948465,3437
"20132",43,4,106,138,8955486,8959956,4470
"10144",44,2,67,1,12704462,12709665,5203
"11109",44,2,19,2,12712227,12717534,5307
"13135",44,6,125,3,12725627,12732882,7255
"14140",44,2,127,4,12735458,12740124,4666
"15137",44,3,26,5,12743138,12747118,3980
"17135",44,5,124,6,12752479,12757321,4842
"18145",44,2,115,7,12760276,12763609,3333
"19109",44,6,35,8,12766205,12770786,4581
"2138",44,3,86,9,12776742,12779839,3097
"2232",44,4,99,10,12782768,12787742,4974
"2333",44,2,109,11,12790579,12794232,3653
"2431",44,1,12,12,12796926,12799690,2764
"2635",44,2,79,13,12805279,12808449,3170
"2728",44,6,23,14,12810992,12815547,4555
"2935",44,2,43,15,12820378,12824822,4444
"3131",44,5,16,16,12829993,12836307,6314
"3330",44,1,96,17,12842458,12847242,4784
"3433",44,1,18,18,12849622,12852942,3320
"3631",44,1,108,19,12860891,12866668,5777
"3726",44,4,15,20,12869270,12873407,4137
"3931",44,6,53,21,12878879,12884042,5163
"4136",44,5,130,22,12888880,12892657,3777
"4230",44,2,1,23,12895468,12898598,3130
"4436",44,3,68,24,12903096,12906128,3032
"4522",44,4,135,25,12908371,12914312,5941
"4633",44,2,7,26,12916659,12919613,2954
"4828",44,4,21,27,12924882,12928829,3947
"5038",44,3,20,28,12933798,12938438,4640
"5234",44,6,83,29,12943615,12949981,6366
"5331",44,5,22,30,12952681,12960237,7556
"5533",44,2,55,31,12966074,12969263,3189
"5634",44,5,136,32,12971859,12977192,5333
"5733",44,6,95,33,12979794,12984356,4562
"5827",44,4,105,34,12986762,12990624,3862
"5934",44,4,93,35,12993056,12997180,4124
"6031",44,4,51,36,12999658,13003671,4013
"6234",44,3,122,37,13009737,13012037,2300
"6327",44,2,31,38,13014842,13018469,3627
"6536",44,4,123,39,13024294,13029901,5607
"6629",44,1,102,40,13032392,13036549,4157
"6730",44,6,107,41,13039242,13042216,2974
"6829",44,5,118,42,13045053,13048935,3882
"6932",44,1,42,43,13051681,13055419,3738
"7132",44,4,75,44,13060381,13066949,6568
"7225",44,1,132,45,13069538,13072420,2882
"7332",44,1,114,46,13074931,13079277,4346
"7434",44,5,82,47,13082840,13086140,3300
"7533",44,3,80,48,13088879,13091683,2804
"7637",44,5,46,49,13094435,13099912,5477
"7834",44,5,10,50,13108783,13112070,3287
"8028",44,2,97,51,13117202,13121116,3914
"8129",44,6,119,52,13123777,13126999,3222
"8235",44,3,116,53,13129496,13134143,4647
"8335",44,5,40,54,13136771,13140849,4078
"8529",44,6,59,55,13147073,13151595,4522
"8639",44,5,58,56,13154152,13157550,3398
"8722",44,5,112,57,13160505,13165596,5091
"8834",44,1,30,58,13168159,13170492,2333
"9028",44,6,101,59,13175604,13179009,3405
"9133",44,3,14,60,13181363,13184460,3097
"9335",44,3,8,61,13189827,13192631,2804
"9529",44,6,41,62,13197991,13203363,5372
"9726",44,1,54,63,13208874,13211770,2896
"9933",44,5,34,64,13216999,13219659,2660
"10145",44,3,44,65,13225045,13230627,5582
"10332",44,5,28,66,13283258,13287826,4568
"10529",44,4,39,67,13293795,13297533,3738
"10731",44,5,4,68,13303338,13306468,3130
"10936",44,3,62,69,13311547,13315077,3530
"11025",44,4,63,70,13317868,13320907,3039
"11139",44,3,38,71,13323424,13326234,2810
"11329",44,1,90,72,13332085,13335477,3392
"11435",44,4,69,73,13338353,13340784,2431
"11525",44,3,32,74,13343504,13349576,6072
"11733",44,3,92,75,13355099,13364073,8974
"11832",44,5,64,76,13366702,13371028,4326
"11932",44,5,52,77,13404037,13407579,3542
"12136",44,2,91,78,13412286,13416802,4516
"12233",44,2,37,79,13419829,13423606,3777
"12429",44,5,88,80,13429385,13434927,5542
"12532",44,4,57,81,13437798,13440804,3006
"12627",44,5,94,82,13443484,13451438,7954
"12730",44,4,27,83,13453942,13457883,3941
"12932",44,2,49,84,13463531,13466407,2876
"13136",44,1,48,85,13471329,13474107,2778
"13329",44,6,47,86,13478957,13481545,2588
"13529",44,5,100,87,13486304,13490075,3771
"13629",44,4,111,88,13493069,13495579,2510
"13734",44,5,70,89,13498135,13502056,3921
"13827",44,1,84,90,13504730,13508338,3608
"13932",44,1,36,91,13510920,13514312,3392
"14141",44,2,103,92,13519646,13523698,4052
"14233",44,1,72,93,13526359,13528757,2398
"14333",44,5,76,94,13531431,13535463,4032
"14433",44,2,121,95,13537804,13541464,3660
"14528",44,6,71,96,13544288,13548824,4536
"14630",44,1,78,97,13551792,13553713,1921
"14728",44,6,131,98,13556354,13559615,3261
"14827",44,3,74,99,13562061,13569616,7555
"14933",44,6,17,100,13572636,13575754,3118
"15138",44,6,77,101,13580800,13584663,3863
"15232",44,6,137,102,13587624,13590696,3072
"15332",44,3,2,103,13594010,13598840,4830
"15527",44,3,50,104,13609456,13614632,5176
"15735",44,2,85,105,13619940,13624424,4484
"15832",44,3,134,106,13627071,13630646,3575
"15925",44,2,61,107,13633379,13636418,3039
"16037",44,5,106,108,13639072,13644157,5085
"16130",44,3,128,109,13647171,13655406,8235
"16231",44,3,104,110,13658237,13663053,4816
"16333",44,4,117,111,13665767,13668093,2326
"16432",44,6,65,112,13670721,13674401,3680
"16531",44,4,129,113,13681722,13686656,4934
"16631",44,6,29,114,13689520,13692474,2954
"16832",44,3,98,115,13697442,13703317,5875
"16931",44,3,56,116,13705632,13709815,4183
"17032",44,2,13,117,13712502,13718253,5751
"17233",44,1,126,118,13723365,13725744,2379
"17330",44,4,9,119,13728222,13731561,3339
"17532",44,2,73,120,13737131,13741647,4516
"17633",44,6,5,121,13744425,13747869,3444
"17833",44,4,81,122,13754165,13758798,4633
"17929",44,6,11,123,13761289,13763955,2666
"18146",44,4,87,124,13769081,13772407,3326
"18229",44,6,89,125,13775199,13778800,3601
"18330",44,1,138,126,13781487,13783728,2241
"18429",44,2,133,127,13786448,13789062,2614
"18533",44,1,120,128,13804887,13807259,2372
"18629",44,1,24,129,13810789,13814390,3601
"18834",44,6,113,130,13821064,13824031,2967
"18928",44,4,45,131,13826529,13829659,3130
"19131",44,1,6,132,13834386,13836869,2483
"19332",44,2,25,133,13843393,13846026,2633
"19528",44,4,33,134,13850426,13853850,3424
"19733",44,4,3,135,13858910,13861694,2784
"19938",44,1,66,136,13866969,13869642,2673
"20027",44,1,60,137,13872251,13875120,2869
"20133",44,3,110,138,13877617,13880139,2522
"10146",45,2,48,1,15016364,15020351,3987
"12137",45,5,135,2,15027130,15034110,6980
"13137",45,2,60,3,15036496,15043450,6954
"14142",45,3,73,4,15045902,15051026,5124
"15139",45,6,28,5,15054491,15060981,6490
"17136",45,4,44,6,15067596,15070753,3157
"19132",45,1,5,7,15078271,15083597,5326
"2139",45,1,29,8,15089879,15095094,5215
"2334",45,5,51,9,15101631,15106840,5209
"2531",45,3,43,10,15116358,15122965,6607
"2729",45,2,132,11,15130457,15138346,7889
"2830",45,5,9,12,15141431,15149640,8209
"3034",45,1,137,13,15158844,15163903,5059
"3132",45,4,20,14,15166237,15170942,4705
"3331",45,3,1,15,15178336,15181708,3372
"3530",45,4,122,16,15190350,15194153,3803
"3632",45,5,93,17,15197481,15201343,3862
"3727",45,3,127,18,15204037,15209213,5176
"3831",45,6,46,19,15212135,15219939,7804
"4032",45,3,85,20,15227522,15233764,6242
"4137",45,4,116,21,15237189,15242444,5255
"4231",45,5,15,22,15244922,15249948,5026
"4437",45,5,99,23,15258034,15264027,5993
"4523",45,1,119,24,15267087,15272374,5287
"4634",45,1,71,25,15275172,15279231,4059
"4732",45,5,105,26,15286278,15289538,3260
"4829",45,1,131,27,15292003,15296637,4634
"4926",45,3,109,28,15299304,15307951,8647
"5039",45,1,59,29,15310501,15316749,6248
"5128",45,3,49,30,15319338,15327704,8366
"5332",45,3,7,31,15332915,15338071,5156
"5534",45,1,95,32,15344255,15350575,6320
"5635",45,3,25,33,15353060,15359275,6215
"5828",45,5,39,34,15364570,15373845,9275
"6032",45,4,32,35,15378767,15383898,5131
"6235",45,6,34,36,15390082,15396186,6104
"6431",45,2,18,37,15403233,15411788,8555
"6630",45,4,8,38,15417809,15421495,3686
"6830",45,2,54,39,15430274,15433607,3333
"7033",45,2,42,40,15441072,15447385,6313
"7226",45,5,111,41,15453288,15459340,6052
"7333",45,4,134,42,15461792,15468001,6209
"7435",45,1,101,43,15470270,15475505,5235
"7534",45,2,72,44,15477754,15481237,3483
"7638",45,3,37,45,15483454,15495206,11752
"7835",45,2,12,46,15500638,15504840,4202
"8029",45,2,78,47,15510403,15514305,3902
"8130",45,3,61,48,15516606,15523573,6967
"8236",45,4,74,49,15526045,15536104,10059
"8336",45,5,57,50,15544745,15549784,5039
"8422",45,6,64,51,15552328,15557523,5195
"8530",45,3,31,52,15559982,15565374,5392
"8723",45,5,3,53,15570368,15576858,6490
"8929",45,6,94,54,15582245,15592637,10392
"9029",45,5,33,55,15594951,15599402,4451
"9233",45,6,16,56,15605161,15608801,3640
"9428",45,3,91,57,15615999,15625567,9568
"9530",45,3,97,58,15627921,15632188,4267
"9627",45,1,17,59,15634558,15643876,9318
"9832",45,6,76,60,15651641,15659001,7360
"9934",45,4,80,61,15661459,15667263,5804
"10036",45,4,104,62,15669584,15674610,5026
"10147",45,3,13,63,15676917,15688617,11700
"10333",45,1,23,64,15694566,15700840,6274
"10530",45,3,115,65,15706187,15713723,7536
"10635",45,5,117,66,15776918,15782009,5091
"10732",45,2,108,67,15784467,15790467,6000
"10829",45,6,112,68,15792768,15798735,5967
"10937",45,5,87,69,15800828,15809194,8366
"11026",45,1,107,70,15811685,15816057,4372
"11140",45,5,21,71,15818378,15825959,7581
"11330",45,6,130,72,15831738,15835725,3987
"11436",45,5,27,73,15838163,15843503,5340
"11635",45,1,65,74,15848818,15853464,4646
"11734",45,4,92,75,15855988,15864053,8065
"11833",45,1,47,76,15866682,15872073,5391
"12029",45,2,96,77,15881833,15886924,5091
"12138",45,6,58,78,15889376,15895905,6529
"12234",45,6,10,79,15898180,15903697,5517
"12430",45,6,70,80,15909952,15914455,4503
"12533",45,6,52,81,15917071,15921678,4607
"12731",45,4,26,82,15926941,15934927,7986
"12933",45,4,56,83,15942288,15950785,8497
"13029",45,6,22,84,15953517,15959805,6288
"13231",45,2,90,85,15966669,15972923,6254
"13330",45,3,79,86,15975061,15981434,6373
"13431",45,4,62,87,15983820,15990670,6850
"13530",45,3,121,88,15992801,15997252,4451
"13630",45,6,82,89,15999403,16004396,4993
"13735",45,1,41,90,16006782,16014737,7955
"13933",45,4,50,91,16020260,16027502,7242
"14143",45,3,133,92,16032784,16040568,7784
"14234",45,2,84,93,16043131,16050000,6869
"14334",45,2,102,94,16052302,16056739,4437
"14434",45,1,113,95,16059172,16067073,7901
"14529",45,4,2,96,16069688,16074048,4360
"14729",45,1,83,97,16082088,16093788,11700
"14828",45,1,53,98,16095939,16100703,4764
"15035",45,1,125,99,16105867,16111253,5386
"15140",45,5,69,100,16113613,16117678,4065
"15233",45,5,63,101,16119790,16125659,5869
"15333",45,4,68,102,16127954,16135542,7588
"15432",45,4,38,103,16137817,16144758,6941
"15630",45,5,129,104,16152060,16158811,6751
"15736",45,6,88,105,16161152,16165047,3895
"15833",45,2,126,106,16167636,16176394,8758
"15926",45,5,75,107,16178663,16185879,7216
"16038",45,2,30,108,16190788,16195919,5131
"16232",45,2,24,109,16200841,16206932,6091
"16433",45,5,123,110,16212319,16224541,12222
"16532",45,3,19,111,16226817,16232254,5437
"16734",45,4,128,112,16238883,16244405,5522
"16833",45,6,118,113,16246700,16251765,5065
"16932",45,6,136,114,16254374,16258609,4235
"17033",45,3,67,115,16260904,16265603,4699
"17137",45,1,35,116,16268885,16274806,5921
"17331",45,2,114,117,16281271,16285460,4189
"17428",45,2,120,118,16287592,16291860,4268
"17533",45,5,81,119,16294324,16299899,5575
"17634",45,1,89,120,16302351,16313907,11556
"17732",45,2,6,121,16316221,16322502,6281
"17930",45,4,110,122,16328314,16339654,11340
"18030",45,2,66,123,16342092,16346680,4588
"18147",45,4,14,124,16348812,16355681,6869
"18331",45,3,103,125,16361139,16367812,6673
"18430",45,6,40,126,16370172,16377905,7733
"18630",45,4,86,127,16384500,16389049,4549
"18728",45,6,4,128,16392958,16397925,4967
"18929",45,2,138,129,16403266,16407769,4503
"19032",45,1,77,130,16410208,16416345,6137
"19133",45,6,106,131,16418574,16423921,5347
"19238",45,3,55,132,16426163,16430307,4144
"19333",45,6,100,133,16433340,16438190,4850
"19429",45,5,45,134,16440811,16446765,5954
"19633",45,1,11,135,16452537,16461041,8504
"19825",45,2,36,136,16469395,16474904,5509
"20028",45,4,98,137,16481794,16488010,6216
"20134",45,6,124,138,16490534,16498089,7555
"10148",46,6,111,1,17542963,17546106,3143
"11141",46,6,117,2,17548395,17550728,2333
"12139",46,3,72,3,17553480,17557022,3542
"13138",46,2,89,4,17559461,17563402,3941
"14144",46,6,33,5,17566030,17569690,3660
"16108",46,3,126,6,17575508,17579122,3614
"17138",46,2,77,7,17581652,17585063,3411
"18148",46,1,106,8,17587378,17590220,2842
"19134",46,1,4,9,17592927,17595881,2954
"2140",46,2,11,10,17600699,17604215,3516
"2335",46,2,5,11,17609327,17613510,4183
"2532",46,6,39,12,17618158,17621615,3457
"2730",46,3,60,13,17626701,17630413,3712
"2831",46,6,87,14,17632962,17637060,4098
"2936",46,3,48,15,17639898,17642198,2300
"3133",46,5,44,16,17647087,17650185,3098
"3332",46,1,70,17,17655330,17659375,4045
"3434",46,4,13,18,17661762,17665886,4124
"3633",46,1,112,19,17671043,17674605,3562
"3728",46,2,119,20,17676959,17682789,5830
"3832",46,6,3,21,17685509,17690528,5019
"4033",46,5,38,22,17696032,17699175,3143
"4232",46,2,113,23,17704281,17707019,2738
"4328",46,5,2,24,17709405,17712183,2778
"4524",46,4,85,25,17717373,17720798,3425
"4635",46,1,28,26,17723406,17726073,2667
"4830",46,5,128,27,17730956,17735492,4536
"4927",46,4,67,28,17738002,17740740,2738
"5040",46,3,66,29,17743159,17747251,4092
"5129",46,1,130,30,17750316,17753918,3602
"5235",46,1,40,31,17758618,17762742,4124
"5436",46,5,20,32,17767978,17770814,2836
"5636",46,5,26,33,17776423,17780259,3836
"5829",46,5,32,34,17785378,17788240,2862
"6033",46,2,101,35,17794313,17797424,3111
"6131",46,4,19,36,17800072,17803431,3359
"6328",46,1,34,37,17809118,17812144,3026
"6537",46,3,96,38,17817230,17820190,2960
"6631",46,5,104,39,17822635,17825877,3242
"6731",46,5,134,40,17828368,17831243,2875
"6831",46,3,12,41,17833825,17836224,2399
"7034",46,1,46,42,17840878,17843322,2444
"7227",46,6,69,43,17849081,17851185,2104
"7334",46,1,10,44,17853735,17857094,3359
"7535",46,4,61,45,17863004,17865533,2529
"7639",46,2,29,46,17867815,17870278,2463
"7836",46,5,68,47,17875155,17878043,2888
"7934",46,1,94,48,17881057,17884070,3013
"8030",46,3,6,49,17886600,17889567,2967
"8237",46,3,114,50,17894130,17896803,2673
"8337",46,4,37,51,17899216,17902254,3038
"8531",46,1,16,52,17910157,17913333,3176
"8724",46,5,98,53,17918276,17922805,4529
"8835",46,3,108,54,17925381,17927596,2215
"8930",46,2,71,55,17929865,17932603,2738
"9030",46,2,95,56,17934747,17938244,3497
"9134",46,1,76,57,17941088,17945205,4117
"9234",46,6,129,58,17947735,17953120,5385
"9336",46,4,55,59,17955932,17959801,3869
"9429",46,6,9,60,17962631,17966350,3719
"9628",46,1,64,61,17973495,17976586,3091
"9727",46,3,132,62,17978855,17983377,4522
"9833",46,1,58,63,17986110,17990090,3980
"9935",46,4,115,64,17993437,17997195,3758
"10037",46,2,137,65,18001379,18004732,3353
"10149",46,1,52,66,18075632,18078697,3065
"10334",46,4,79,67,18083698,18086874,3176
"10430",46,6,57,68,18089228,18092633,3405
"10531",46,6,75,69,18094804,18098496,3692
"10636",46,5,74,70,18101026,18104372,3346
"10733",46,5,110,71,18108112,18111229,3117
"10830",46,5,56,72,18113877,18117713,3836
"10938",46,4,133,73,18120864,18124360,3496
"11027",46,3,84,74,18127061,18131387,4326
"11142",46,6,27,75,18134028,18138008,3980
"11331",46,6,123,76,18143251,18147970,4719
"11437",46,4,97,77,18150454,18153304,2850
"11526",46,3,102,78,18155847,18160624,4777
"11636",46,1,88,79,18163566,18166742,3176
"11735",46,6,81,80,18169246,18171717,2471
"11834",46,1,118,81,18174214,18176991,2777
"11933",46,2,125,82,18179332,18182881,3549
"12030",46,5,92,83,18185254,18190385,5131
"12140",46,4,103,84,18192725,18196849,4124
"12235",46,3,138,85,18199360,18202679,3319
"12329",46,4,31,86,18205295,18209850,4555
"12534",46,6,21,87,18214557,18218315,3758
"12732",46,3,24,88,18223714,18227171,3457
"12934",46,1,82,89,18231643,18234374,2731
"13030",46,4,25,90,18236584,18241120,4536
"13232",46,6,51,91,18246448,18250415,3967
"13432",46,5,8,92,18255638,18260278,4640
"13631",46,3,90,93,18265338,18268632,3294
"13736",46,6,63,94,18272423,18278488,6065
"13828",46,2,47,95,18281326,18285482,4156
"14033",46,6,135,96,18290059,18294150,4091
"14145",46,5,86,97,18296647,18299947,3300
"14235",46,3,36,98,18303223,18306902,3679
"14435",46,5,122,99,18314093,18317073,2980
"14530",46,1,136,100,18319636,18323302,3666
"14631",46,4,43,101,18361933,18367194,5261
"14829",46,2,35,102,18371783,18374665,2882
"15036",46,5,80,103,18381868,18384665,2797
"15141",46,2,59,104,18400170,18403085,2915
"15234",46,4,49,105,18405498,18408223,2725
"15433",46,5,50,106,18413923,18416034,2111
"15631",46,1,124,107,18420878,18423256,2378
"15737",46,4,1,108,18425930,18428544,2614
"15927",46,6,45,109,18433807,18435989,2182
"16131",46,2,107,110,18441016,18445232,4216
"16233",46,4,109,111,18447598,18451585,3987
"16334",46,5,116,112,18454226,18458232,4006
"16434",46,6,105,113,18461129,18464743,3614
"16533",46,6,93,114,18467332,18469998,2666
"16632",46,3,42,115,18472456,18474998,2542
"16834",46,3,54,116,18480561,18484188,3627
"17034",46,3,78,117,18490072,18493052,2980
"17139",46,1,100,118,18495739,18495745,6
"17234",46,3,120,119,18498543,18501039,2496
"17332",46,4,7,120,18504197,18507053,2856
"17534",46,2,83,121,18512675,18516772,4097
"17635",46,4,73,122,18520100,18522845,2745
"17733",46,6,99,123,18525198,18527910,2712
"17834",46,2,131,124,18530937,18534767,3830
"17931",46,3,18,125,18537513,18540624,3111
"18149",46,4,127,126,18546174,18550814,4640
"18230",46,3,30,127,18554213,18556964,2751
"18431",46,5,14,128,18561887,18565632,3745
"18631",46,5,62,129,18573515,18576613,3098
"18729",46,2,41,130,18579195,18582260,3065
"18930",46,2,23,131,18587359,18591294,3935
"19135",46,2,17,132,18596236,18600301,4065
"19334",46,4,91,133,18605583,18608046,2463
"19430",46,4,121,134,18610511,18613223,2712
"19529",46,2,53,135,18615878,18620773,4895
"19734",46,2,65,136,18626035,18629420,3385
"19826",46,1,22,137,18632009,18636074,4065
"20029",46,6,15,138,18641350,18643506,2156
"10150",47,4,96,1,19786577,19790700,4123
"11143",47,1,123,2,19795401,19799459,4058
"12141",47,5,55,3,19802251,19805833,3582
"13139",47,6,80,4,19808401,19812760,4359
"14146",47,1,15,5,19816827,19820356,3529
"16109",47,1,3,6,19825586,19828755,3169
"18150",47,6,56,7,19834050,19839828,5778
"19136",47,2,112,8,19842940,19846580,3640
"2039",47,2,34,9,19850032,19853855,3823
"2233",47,5,91,10,19861647,19865320,3673
"2336",47,3,5,11,19869569,19872908,3339
"2533",47,1,135,12,19879302,19882922,3620
"2636",47,4,18,13,19886341,19890700,4359
"2832",47,2,82,14,19896329,19901466,5137
"2937",47,2,46,15,19904486,19908427,3941
"3134",47,4,12,16,19916925,19920212,3287
"3333",47,6,134,17,19925736,19928768,3032
"3435",47,3,65,18,19931521,19935292,3771
"3531",47,5,61,19,19937737,19941508,3771
"3634",47,4,6,20,19943953,19947632,3679
"3833",47,3,137,21,19952914,19957025,4111
"3932",47,3,131,22,19959385,19962215,2830
"4034",47,3,89,23,19965314,19970673,5359
"4138",47,2,22,24,19973138,19976824,3686
"4329",47,4,138,25,19983537,19988138,4601
"4438",47,5,115,26,19990387,19993465,3078
"4525",47,6,32,27,19995884,19999361,3477
"4733",47,5,13,28,20005722,20010872,5150
"4928",47,4,132,29,20015912,20019088,3176
"5041",47,3,11,30,20021448,20024533,3085
"5236",47,2,52,31,20029410,20032736,3326
"5437",47,5,127,32,20038691,20041730,3039
"5535",47,3,83,33,20044201,20048280,4079
"5637",47,1,87,34,20050875,20054077,3202
"5734",47,5,37,35,20056516,20060875,4359
"5935",47,3,119,36,20066039,20069758,3719
"6034",47,4,84,37,20072935,20077602,4667
"6132",47,2,10,38,20080040,20083641,3601
"6329",47,2,40,39,20089276,20093890,4614
"6538",47,5,133,40,20099637,20102826,3189
"6632",47,5,85,41,20105539,20109166,3627
"6732",47,3,113,42,20111670,20114121,2451
"6832",47,1,57,43,20116716,20119186,2470
"6933",47,4,126,44,20121841,20124036,2195
"7035",47,3,47,45,20126808,20130206,3398
"7228",47,5,25,46,20135168,20138109,2941
"7436",47,2,76,47,20143287,20147770,4483
"7536",47,2,16,48,20150124,20154326,4202
"7731",47,3,77,49,20159497,20162457,2960
"7837",47,6,20,50,20164804,20166921,2117
"8031",47,2,136,51,20172739,20175608,2869
"8131",47,6,122,52,20178315,20180713,2398
"8238",47,3,101,53,20183583,20187086,3503
"8338",47,6,128,54,20190113,20193015,2902
"8423",47,4,30,55,20195623,20198224,2601
"8640",47,4,102,56,20203787,20206813,3026
"8725",47,5,103,57,20209690,20213846,4156
"8836",47,2,88,58,20216161,20220180,4019
"8931",47,3,41,59,20223828,20226729,2901
"9135",47,6,50,60,20232495,20234750,2255
"9337",47,1,33,61,20239280,20242613,3333
"9531",47,2,64,62,20249163,20252411,3248
"9629",47,1,93,63,20255098,20257758,2660
"9728",47,2,94,64,20260131,20263372,3241
"9834",47,6,116,65,20265824,20269843,4019
"9936",47,5,1,66,20315827,20318343,2516
"10151",47,1,45,67,20323187,20326292,3105
"10335",47,1,51,68,20331319,20334495,3176
"10532",47,4,120,69,20339659,20341972,2313
"10637",47,3,125,70,20344470,20347652,3182
"10734",47,4,108,71,20350209,20354058,3849
"10831",47,1,117,72,20356379,20359719,3340
"10939",47,6,14,73,20362347,20365484,3137
"11144",47,4,54,74,20370700,20373478,2778
"11332",47,5,79,75,20378734,20381766,3032
"11438",47,1,39,76,20384263,20386805,2542
"11637",47,4,72,77,20391565,20394878,3313
"11736",47,5,121,78,20397415,20399577,2162
"11835",47,5,7,79,20402029,20404578,2549
"12031",47,3,17,80,20410180,20413042,2862
"12236",47,1,9,81,20417978,20422573,4595
"12431",47,6,98,82,20428338,20431109,2771
"12535",47,2,28,83,20433600,20436149,2549
"12733",47,3,95,84,20442137,20447300,5163
"12831",47,1,111,85,20449653,20452921,3268
"12935",47,6,74,86,20455628,20458490,2862
"13031",47,3,59,87,20461301,20465791,4490
"13140",47,6,104,88,20468583,20472020,3437
"13233",47,1,99,89,20474472,20477498,3026
"13331",47,3,53,90,20480727,20483943,3216
"13531",47,4,42,91,20489427,20492917,3490
"13737",47,5,49,92,20498421,20501342,2921
"13934",47,4,60,93,20506043,20509382,3339
"14034",47,6,86,94,20511880,20514494,2614
"14147",47,1,105,95,20517769,20520657,2888
"14236",47,5,67,96,20523364,20526148,2784
"14335",47,2,124,97,20528927,20531148,2221
"14436",47,3,35,98,20533665,20535750,2085
"14632",47,1,129,99,20541359,20543633,2274
"14730",47,5,73,100,20546307,20548908,2601
"14830",47,2,118,101,20551471,20554366,2895
"14934",47,1,81,102,20556804,20560026,3222
"15037",47,5,19,103,20562556,20565360,2804
"15235",47,4,48,104,20571740,20573419,1679
"15434",47,2,100,105,20579204,20581354,2150
"15528",47,2,106,106,20583754,20585662,1908
"15632",47,6,26,107,20589408,20592100,2692
"15834",47,1,27,108,20598350,20600963,2613
"16039",47,3,29,109,20605729,20608114,2385
"16234",47,4,24,110,20613606,20616128,2522
"16435",47,1,63,111,20622613,20624776,2163
"16534",47,6,68,112,20627306,20630090,2784
"16633",47,5,97,113,20633006,20636345,3339
"16735",47,5,31,114,20639490,20642561,3071
"16933",47,5,43,115,20647843,20649679,1836
"17140",47,3,107,116,20654661,20657634,2973
"17235",47,2,4,117,20660184,20662915,2731
"17429",47,6,110,118,20667884,20670426,2542
"17535",47,3,23,119,20673446,20676426,2980
"17734",47,2,58,120,20681943,20684864,2921
"17835",47,6,2,121,20687819,20690603,2784
"18031",47,1,75,122,20695912,20698754,2842
"18151",47,3,71,123,20701252,20704127,2875
"18231",47,2,70,124,20706925,20709487,2562
"18332",47,4,90,125,20712240,20714592,2352
"18432",47,5,109,126,20717044,20720481,3437
"18534",47,4,36,127,20723574,20726442,2868
"18730",47,6,8,128,20732058,20735724,3666
"18931",47,6,38,129,20740712,20743921,3209
"19137",47,1,69,130,20749066,20751346,2280
"19239",47,6,92,131,20754138,20756137,1999
"19335",47,6,62,132,20758458,20760314,1856
"19431",47,4,78,133,20763485,20765412,1927
"19530",47,1,21,134,20768152,20770073,1921
"19735",47,4,114,135,20775257,20778067,2810
"19827",47,4,66,136,20781976,20783995,2019
"19939",47,6,44,137,20786591,20788584,1993
"20135",47,2,130,138,20793421,20796022,2601
"10152",48,3,4,1,22413979,22417057,3078
"12142",48,5,84,2,22422326,22426770,4444
"13141",48,6,31,3,22429150,22435398,6248
"15142",48,1,50,4,22441530,22449726,8196
"17141",48,4,107,5,22456159,22459877,3718
"18152",48,6,97,6,22462153,22465185,3032
"19138",48,6,103,7,22468114,22472224,4110
"2040",48,6,127,8,22474598,22481506,6908
"2141",48,3,46,9,22484010,22488657,4647
"2337",48,2,57,10,22494207,22501070,6863
"2432",48,2,117,11,22503783,22505946,2163
"2534",48,1,104,12,22508162,22512848,4686
"2637",48,1,74,13,22519777,22522424,2647
"2731",48,3,100,14,22524738,22530424,5686
"2833",48,3,64,15,22533308,22542961,9653
"2938",48,2,21,16,22548760,22563106,14346
"3135",48,6,109,17,22570800,22574055,3255
"3229",48,5,78,18,22576337,22585735,9398
"3334",48,5,48,19,22588416,22590592,2176
"3532",48,3,112,20,22595410,22600141,4731
"3635",48,5,126,21,22602574,22608613,6039
"3729",48,5,24,22,22611084,22617234,6150
"3933",48,1,32,23,22622634,22625659,3025
"4139",48,5,66,24,22631327,22633686,2359
"4233",48,2,111,25,22635942,22639817,3875
"4330",48,4,95,26,22642550,22647079,4529
"4439",48,3,130,27,22653655,22657792,4137
"4526",48,5,6,28,22660702,22666407,5705
"4734",48,2,105,29,22674147,22676892,2745
"4831",48,5,60,30,22679481,22683604,4123
"4929",48,5,36,31,22687292,22692363,5071
"5130",48,6,79,32,22700227,22702867,2640
"5237",48,6,133,33,22705312,22707992,2680
"5333",48,1,20,34,22710143,22714973,4830
"5536",48,5,108,35,22722542,22726437,3895
"5638",48,3,52,36,22731733,22737503,5770
"5830",48,3,34,37,22746381,22753485,7104
"6035",48,3,22,38,22761153,22766264,5111
"6236",48,1,80,39,22773840,22781774,7934
"6330",48,2,123,40,22784167,22790252,6085
"6432",48,5,138,41,22792606,22798037,5431
"6539",48,2,51,42,22800450,22804854,4404
"6733",48,2,87,43,22811601,22814973,3372
"6833",48,6,73,44,22817261,22820614,3353
"6934",48,3,40,45,22823471,22827000,3529
"7133",48,1,98,46,22833301,22839059,5758
"7229",48,5,102,47,22842465,22844243,1778
"7335",48,6,61,48,22846583,22850413,3830
"7437",48,4,29,49,22853420,22860087,6667
"7640",48,1,68,50,22865768,22871467,5699
"7732",48,6,67,51,22874716,22876774,2058
"7838",48,3,124,52,22879370,22883382,4012
"7935",48,6,115,53,22886331,22888605,2274
"8032",48,1,2,54,22890952,22894867,3915
"8239",48,2,33,55,22903012,22907907,4895
"8424",48,4,83,56,22914823,22920941,6118
"8532",48,1,8,57,22923837,22927843,4006
"8726",48,1,86,58,22935498,22938530,3032
"8837",48,3,76,59,22942041,22945923,3882
"8932",48,5,132,60,22949100,22956695,7595
"9031",48,2,15,61,22963689,22966074,2385
"9235",48,1,122,62,22973043,22975068,2025
"9338",48,1,44,63,22978082,22981814,3732
"9532",48,1,116,64,22988122,22992017,3895
"9630",48,1,92,65,22994096,23000887,6791
"9729",48,1,62,66,23111954,23114659,2705
"9835",48,5,90,67,23117013,23120562,3549
"9937",48,4,47,68,23123007,23125301,2294
"10153",48,4,41,69,23129975,23134059,4084
"10336",48,3,10,70,23138518,23143603,5085
"10533",48,3,70,71,23149636,23153884,4248
"10638",48,2,63,72,23157872,23161140,3268
"10735",48,4,77,73,23163971,23167003,3032
"10832",48,4,17,74,23169912,23173977,4065
"11028",48,3,82,75,23178553,23182095,3542
"11145",48,4,101,76,23187704,23191272,3568
"11234",48,4,35,77,23193763,23196802,3039
"11439",48,4,125,78,23209222,23214012,4790
"11527",48,3,94,79,23231158,23235073,3915
"11638",48,6,121,80,23238126,23241406,3280
"11737",48,2,129,81,23244362,23248047,3685
"11836",48,6,91,82,23251408,23255264,3856
"11934",48,5,120,83,23257571,23260656,3085
"12032",48,6,49,84,23264415,23268480,4065
"12237",48,5,42,85,23272814,23276879,4065
"12432",48,5,30,86,23284266,23286939,2673
"12628",48,2,81,87,23291835,23296162,4327
"12734",48,1,38,88,23298463,23302927,4464
"12936",48,4,11,89,23308549,23310960,2411
"13142",48,2,27,90,23319804,23322745,2941
"13332",48,2,3,91,23331426,23337289,5863
"13532",48,4,59,92,23343100,23346224,3124
"13632",48,2,39,93,23349447,23353165,3718
"13829",48,3,28,94,23359990,23362630,2640
"14035",48,1,110,95,23367899,23370722,2823
"14148",48,3,16,96,23373978,23379762,5784
"14336",48,2,45,97,23385940,23388991,3051
"14531",48,5,114,98,23399065,23402953,3888
"14633",48,2,75,99,23405248,23408535,3287
"14731",48,4,113,100,23410967,23413692,2725
"14831",48,4,89,101,23416249,23422556,6307
"14935",48,6,1,102,23425923,23428157,2234
"15143",48,4,119,103,23434420,23441113,6693
"15236",48,6,7,104,23444368,23447655,3287
"15435",48,2,99,105,23453735,23456087,2352
"15529",48,6,55,106,23459565,23461879,2314
"15633",48,1,14,107,23464141,23467938,3797
"15835",48,6,43,108,23475370,23479638,4268
"16040",48,5,12,109,23485142,23487789,2647
"16235",48,4,71,110,23494679,23497639,2960
"16335",48,4,23,111,23505575,23507692,2117
"16535",48,3,136,112,23512294,23519464,7170
"16634",48,3,118,113,23526446,23529092,2646
"16736",48,5,72,114,23533165,23535884,2719
"16835",48,2,9,115,23543434,23547584,4150
"17035",48,4,65,116,23554376,23557062,2686
"17142",48,5,96,117,23559794,23563278,3484
"17236",48,6,13,118,23567762,23570814,3052
"17430",48,6,25,119,23576299,23579141,2842
"17636",48,4,53,120,23585587,23588469,2882
"17836",48,3,58,121,23593012,23596038,3026
"17932",48,6,37,122,23599732,23602790,3058
"18153",48,1,56,123,23608098,23614379,6281
"18232",48,5,54,124,23617158,23619791,2633
"18433",48,6,19,125,23627250,23630289,3039
"18632",48,4,131,126,23638041,23640956,2915
"18731",48,3,88,127,23648186,23650944,2758
"18835",48,6,85,128,23653788,23657807,4019
"18932",48,2,135,129,23660370,23665095,4725
"19033",48,5,18,130,23668887,23672991,4104
"19240",48,2,69,131,23678162,23680299,2137
"19336",48,4,137,132,23683057,23685554,2497
"19432",48,1,26,133,23688653,23692718,4065
"19634",48,2,93,134,23700549,23704012,3463
"19736",48,3,106,135,23714766,23718700,3934
"19828",48,4,5,136,23721929,23726079,4150
"20030",48,1,128,137,23735970,23739930,3960
"20136",48,1,134,138,23742761,23746035,3274
"10154",49,6,12,1,24621990,24625349,3359
"12143",49,5,137,2,24630663,24634389,3726
"13143",49,2,104,3,24636782,24642075,5293
"14149",49,2,8,4,24644501,24648416,3915
"16132",49,1,79,5,24656306,24659822,3516
"17143",49,4,4,6,24662150,24665267,3117
"19139",49,6,66,7,24670235,24673319,3084
"2041",49,2,68,8,24676118,24681797,5679
"2142",49,5,59,9,24684210,24688137,3927
"2234",49,1,13,10,24690635,24695171,4536
"2433",49,3,39,11,24700289,24704158,3869
"2638",49,1,31,12,24709368,24713002,3634
"2834",49,6,72,13,24717525,24721211,3686
"2939",49,4,136,14,24723526,24727434,3908
"3035",49,1,85,15,24729958,24733108,3150
"3136",49,3,45,16,24737095,24740781,3686
"3335",49,4,76,17,24746109,24750619,4510
"3436",49,1,115,18,24753070,24755809,2739
"3533",49,3,69,19,24758875,24761462,2587
"3636",49,2,98,20,24763744,24767450,3706
"3730",49,6,132,21,24769954,24773725,3771
"3834",49,4,10,22,24776072,24779418,3346
"4035",49,1,37,23,24786746,24789340,2594
"4234",49,5,125,24,24794943,24798243,3300
"4331",49,2,44,25,24800570,24804910,4340
"4527",49,6,102,26,24809721,24813296,3575
"4636",49,2,92,27,24815656,24819153,3497
"4735",49,6,138,28,24821598,24825401,3803
"4832",49,1,127,29,24827892,24830977,3085
"4930",49,2,32,30,24833494,24837768,4274
"5131",49,3,99,31,24842724,24845998,3274
"5238",49,6,120,32,24849142,24852704,3562
"5334",49,3,75,33,24854999,24859011,4012
"5438",49,5,41,34,24861313,24864548,3235
"5639",49,3,9,35,24869921,24874620,4699
"5831",49,1,43,36,24883262,24886595,3333
"6036",49,5,89,37,24891857,24895458,3601
"6133",49,6,18,38,24898211,24901426,3215
"6331",49,4,58,39,24907460,24910976,3516
"6433",49,3,87,40,24913545,24916761,3216
"6540",49,1,91,41,24919140,24922159,3019
"6633",49,1,49,42,24924781,24927585,2804
"6834",49,4,70,43,24932448,24936160,3712
"6935",49,1,19,44,24938547,24941840,3293
"7134",49,6,126,45,24948188,24953796,5608
"7230",49,6,114,46,24956306,24959848,3542
"7336",49,2,128,47,24962418,24965751,3333
"7438",49,4,88,48,24968483,24971777,3294
"7537",49,4,100,49,24974262,24977215,2953
"7641",49,5,131,50,24979667,24982706,3039
"7733",49,4,118,51,24985073,24987961,2888
"7839",49,5,107,52,24990348,24993099,2751
"7936",49,2,134,53,24995531,24998158,2627
"8033",49,5,29,54,25000603,25004884,4281
"8240",49,3,135,55,25009970,25013440,3470
"8339",49,3,21,56,25015735,25019009,3274
"8533",49,5,5,57,25024102,25027840,3738
"8727",49,1,103,58,25033475,25036128,2653
"8838",49,4,22,59,25038671,25042279,3608
"9032",49,3,93,60,25047319,25051867,4548
"9136",49,1,1,61,25054182,25056443,2261
"9339",49,3,63,62,25062248,25065306,3058
"9430",49,5,53,63,25067549,25071019,3470
"9631",49,6,30,64,25076072,25078457,2385
"9836",49,1,61,65,25083197,25086007,2810
"9938",49,4,82,66,25160771,25164045,3274
"10038",49,6,54,67,25166353,25169666,3313
"10235",49,4,16,68,25174386,25178569,4183
"10431",49,2,122,69,25184197,25186406,2209
"10534",49,3,33,70,25188747,25191615,2868
"10736",49,2,50,71,25196812,25199622,2810
"10940",49,4,106,72,25204022,25206930,2908
"11029",49,1,55,73,25209545,25213414,3869
"11146",49,3,129,74,25215683,25218898,3215
"11235",49,2,56,75,25221272,25224944,3672
"11333",49,3,123,76,25227409,25230605,3196
"11440",49,4,28,77,25232880,25236122,3242
"11639",49,3,81,78,25244084,25248253,4169
"11738",49,2,62,79,25250613,25254718,4105
"11837",49,6,84,80,25257097,25259724,2627
"11935",49,4,64,81,25262052,25265169,3117
"12033",49,4,52,82,25268118,25271431,3313
"12238",49,1,73,83,25276765,25279726,2961
"12330",49,5,95,84,25282093,25284870,2777
"12433",49,2,86,85,25287544,25290870,3326
"12536",49,6,36,86,25293224,25296197,2973
"12735",49,5,83,87,25301211,25303048,1837
"12832",49,1,121,88,25305303,25307669,2366
"12937",49,1,7,89,25310029,25313349,3320
"13144",49,1,67,90,25319442,25322421,2979
"13234",49,4,46,91,25324827,25327735,2908
"13433",49,6,48,92,25333122,25334880,1758
"13633",49,4,112,93,25340561,25343599,3038
"13738",49,3,51,94,25346195,25349587,3392
"13935",49,6,90,95,25354117,25356744,2627
"14036",49,5,11,96,25360163,25363006,2843
"14237",49,5,35,97,25368092,25370608,2516
"14437",49,5,71,98,25403375,25407767,4392
"14532",49,2,38,99,25450431,25453116,2685
"14732",49,5,113,100,25459222,25462365,3143
"14832",49,2,116,101,25464784,25467078,2294
"14936",49,4,124,102,25469340,25471340,2000
"15038",49,4,40,103,25473700,25476870,3170
"15237",49,6,42,104,25485492,25488975,3483
"15436",49,6,96,105,25496708,25500198,3490
"15530",49,2,2,106,25503872,25508401,4529
"15738",49,5,77,107,25515409,25518807,3398
"15836",49,4,34,108,25521076,25523742,2666
"16041",49,5,65,109,25529161,25531742,2581
"16133",49,4,94,110,25534162,25537508,3346
"16236",49,3,3,111,25539835,25541894,2059
"16436",49,3,117,112,25546555,25548966,2411
"16536",49,5,101,113,25551274,25553764,2490
"16635",49,1,109,114,25556313,25559509,3196
"16737",49,2,80,115,25563333,25566235,2902
"16836",49,3,111,116,25571190,25573693,2503
"16934",49,4,130,117,25576844,25580118,3274
"17036",49,6,78,118,25582387,25584197,1810
"17144",49,5,47,119,25586459,25588589,2130
"17333",49,1,133,120,25593283,25595969,2686
"17431",49,3,15,121,25598539,25600420,1881
"17637",49,1,25,122,25604879,25607316,2437
"17837",49,3,105,123,25612853,25615389,2536
"17933",49,2,110,124,25617840,25620696,2856
"18032",49,2,26,125,25624664,25627618,2954
"18233",49,3,27,126,25633070,25635861,2791
"18434",49,5,119,127,25640777,25643129,2352
"18535",49,3,57,128,25646006,25649384,3378
"18633",49,6,108,129,25651738,25654398,2660
"18732",49,6,6,130,25656948,25658993,2045
"18933",49,6,24,131,25663739,25666281,2542
"19140",49,2,14,132,25672125,25674589,2464
"19337",49,5,17,133,25679126,25682302,3176
"19531",49,2,20,134,25688531,25691858,3327
"19737",49,5,23,135,25697290,25700512,3222
"19940",49,6,60,136,25705330,25709120,3790
"20031",49,1,97,137,25711657,25714709,3052
"20137",49,2,74,138,25717043,25719611,2568
"10155",50,6,131,1,27026129,27029299,3170
"11147",50,4,117,2,27031823,27034894,3071
"12144",50,5,22,3,27038346,27042607,4261
"14150",50,2,31,4,27047654,27051196,3542
"16134",50,5,124,5,27056216,27059471,3255
"17145",50,6,119,6,27061975,27065563,3588
"18154",50,4,129,7,27068296,27071890,3594
"19141",50,6,95,8,27074440,27077845,3405
"2042",50,5,40,9,27080257,27084067,3810
"2235",50,2,79,10,27089421,27093068,3647
"2338",50,4,27,11,27095291,27099277,3986
"2535",50,5,28,12,27104442,27107997,3555
"2732",50,2,13,13,27113455,27117285,3830
"2940",50,6,125,14,27123142,27127502,4360
"3036",50,5,100,15,27129993,27134090,4097
"3137",50,1,12,16,27136424,27139770,3346
"3336",50,1,96,17,27145595,27148706,3111
"3437",50,5,10,18,27151183,27154935,3752
"3637",50,4,135,19,27160308,27163870,3562
"3731",50,2,109,20,27166505,27170478,3973
"3835",50,2,1,21,27172858,27176479,3621
"4036",50,2,85,22,27181806,27185113,3307
"4140",50,6,101,23,27188245,27191663,3418
"4235",50,1,18,24,27194291,27197650,3359
"4440",50,2,43,25,27202860,27205899,3039
"4637",50,2,115,26,27210880,27213984,3104
"4736",50,1,54,27,27216404,27219795,3391
"4931",50,5,46,28,27226358,27229358,3000
"5132",50,1,6,29,27234666,27238084,3418
"5335",50,1,126,30,27242895,27246117,3222
"5439",50,5,94,31,27248811,27252621,3810
"5537",50,5,106,32,27255818,27259693,3875
"5640",50,3,74,33,27262341,27265648,3307
"5735",50,6,107,34,27268074,27271962,3888
"5832",50,3,38,35,27274590,27278139,3549
"6037",50,3,2,36,27283826,27287179,3353
"6237",50,4,111,37,27293278,27297173,3895
"6332",50,3,104,38,27300063,27303212,3149
"6434",50,1,84,39,27305782,27309520,3738
"6541",50,2,103,40,27312109,27315285,3176
"6634",50,2,49,41,27318306,27321906,3600
"6835",50,4,9,42,27326666,27329548,2882
"7036",50,4,33,43,27335078,27338600,3522
"7231",50,2,127,44,27344582,27347921,3339
"7337",50,2,133,45,27350634,27353392,2758
"7439",50,2,7,46,27356334,27359883,3549
"7642",50,2,55,47,27365583,27368419,2836
"7734",50,6,17,48,27370930,27374250,3320
"7937",50,3,32,49,27379238,27382669,3431
"8132",50,2,37,50,27387892,27391016,3124
"8340",50,3,68,51,27396291,27399343,3052
"8425",50,5,118,52,27401867,27405873,4006
"8534",50,3,110,53,27408527,27411625,3098
"8641",50,3,26,54,27415037,27418880,3843
"8839",50,3,14,55,27424652,27428417,3765
"9033",50,3,56,56,27433686,27437280,3594
"9137",50,1,132,57,27439686,27442705,3019
"9236",50,4,69,58,27445458,27448961,3503
"9340",50,5,130,59,27451883,27455713,3830
"9431",50,1,36,60,27458112,27461014,2902
"9632",50,3,80,61,27466158,27469014,2856
"9730",50,6,5,62,27471590,27474956,3366
"9939",50,6,71,63,27481401,27484754,3353
"10039",50,2,67,64,27487487,27490552,3065
"10156",50,1,60,65,27493206,27496094,2888
"10236",50,5,58,66,27527156,27530450,3294
"10337",50,1,114,67,27533137,27536104,2967
"10432",50,3,116,68,27538536,27541294,2758
"10535",50,3,44,69,27543928,27546281,2353
"10737",50,4,51,70,27551628,27554275,2647
"10941",50,1,78,71,27559230,27561837,2607
"11030",50,6,35,72,27564439,27567472,3033
"11236",50,2,25,73,27573054,27576551,3497
"11441",50,3,62,74,27581414,27584061,2647
"11528",50,1,72,75,27586480,27589270,2790
"11640",50,1,108,76,27591768,27594487,2719
"11739",50,5,82,77,27596971,27600343,3372
"11838",50,5,34,78,27603128,27606500,3372
"12034",50,4,87,79,27611710,27614592,2882
"12145",50,6,137,80,27617070,27619985,2915
"12239",50,1,138,81,27622796,27625946,3150
"12331",50,3,128,82,27628300,27631528,3228
"12434",50,4,39,83,27633869,27637189,3320
"12629",50,6,89,84,27642105,27645313,3208
"12736",50,6,23,85,27647804,27650745,2941
"12938",50,2,121,86,27656315,27659072,2757
"13032",50,3,92,87,27662027,27665439,3412
"13145",50,4,63,88,27668374,27671230,2856
"13235",50,5,88,89,27673721,27677113,3392
"13333",50,5,136,90,27679813,27683087,3274
"13434",50,6,113,91,27685879,27688597,2718
"13533",50,4,123,92,27691755,27694996,3241
"13634",50,6,59,93,27697925,27701480,3555
"13739",50,4,15,94,27704324,27708076,3752
"13936",50,1,102,95,27713253,27716142,2889
"14037",50,5,76,96,27719685,27723351,3666
"14151",50,2,19,97,27725816,27728724,2908
"14337",50,1,42,98,27734843,27737869,3026
"14533",50,6,65,99,27743811,27746640,2829
"14634",50,6,47,100,27749144,27751713,2569
"14833",50,1,48,101,27756903,27759262,2359
"15039",50,2,73,102,27764341,27767779,3438
"15144",50,3,86,103,27770584,27773472,2888
"15238",50,6,11,104,27776205,27779342,3137
"15437",50,6,53,105,27784552,27787604,3052
"15634",50,6,41,106,27792454,27795683,3229
"15837",50,1,120,107,27800762,27803749,2987
"15928",50,4,105,108,27806115,27808847,2732
"16042",50,4,93,109,27811717,27814573,2856
"16135",50,5,112,110,27817090,27819978,2888
"16237",50,5,16,111,27822744,27825299,2555
"16437",50,4,21,112,27830731,27833607,2876
"16636",50,2,97,113,27839562,27842307,2745
"16738",50,5,52,114,27845098,27848516,3418
"16935",50,5,70,115,27853321,27856373,3052
"17037",50,4,81,116,27859341,27862478,3137
"17146",50,4,99,117,27864930,27867838,2908
"17237",50,2,61,118,27870335,27873250,2915
"17334",50,6,77,119,27875662,27879087,3425
"17432",50,6,29,120,27881624,27884917,3293
"17638",50,3,20,121,27890258,27893232,2974
"17838",50,5,4,122,27898873,27902494,3621
"18033",50,1,30,123,27908122,27910828,2706
"18234",50,3,8,124,27915770,27918599,2829
"18435",50,4,45,125,27923097,27925979,2882
"18634",50,5,64,126,27931117,27934130,3013
"18733",50,1,66,127,27936588,27939646,3058
"18836",50,4,3,128,27942039,27945974,3935
"19034",50,2,91,129,27951236,27954262,3026
"19142",50,4,75,130,27957027,27959922,2895
"19241",50,3,98,131,27962518,27965602,3084
"19338",50,1,24,132,27968054,27971171,3117
"19532",50,4,57,133,27976002,27979205,3203
"19635",50,3,134,134,27982303,27985283,2980
"19738",50,1,90,135,27987768,27991035,3267
"19829",50,3,122,136,27993919,27996585,2666
"19941",50,6,83,137,27999180,28002984,3804
"20032",50,3,50,138,28005645,28008618,2973
"10157",51,1,113,1,715059,718457,3398
"11148",51,4,110,2,721000,723862,2862
"12146",51,5,33,3,726765,730745,3980
"14152",51,1,89,4,736263,745249,8986
"15145",51,4,44,5,748701,750831,2130
"17147",51,3,31,6,756715,761512,4797
"19143",51,3,67,7,766539,768702,2163
"2043",51,2,42,8,771729,775232,3503
"2236",51,3,109,9,782527,788938,6411
"2339",51,6,118,10,792639,795985,3346
"2434",51,3,13,11,798665,802632,3967
"2639",51,5,81,12,809091,811960,2869
"2733",51,6,16,13,814411,816895,2484
"2941",51,5,21,14,822262,824830,2568
"3138",51,6,28,15,830903,834654,3751
"3337",51,6,4,16,840243,844066,3823
"3534",51,3,1,17,850067,853328,3261
"3732",51,5,63,18,858911,861407,2496
"3836",51,3,103,19,864323,867623,3300
"3934",51,1,137,20,870245,874016,3771
"4037",51,5,45,21,876651,879023,2372
"4236",51,5,75,22,884148,889121,4973
"4332",51,4,2,23,892273,894958,2685
"4528",51,5,3,24,901482,904730,3248
"4737",51,2,54,25,910672,913110,2438
"4932",51,2,120,26,919529,923490,3961
"5042",51,4,92,27,926118,928980,2862
"5133",51,2,78,28,931576,933510,1934
"5239",51,6,22,29,936014,939726,3712
"5440",51,6,46,30,944910,948478,3568
"5641",51,2,132,31,954159,959466,5307
"5736",51,1,119,32,961741,965133,3392
"5833",51,4,116,33,968055,973238,5183
"5936",51,4,74,34,976062,980480,4418
"6038",51,3,91,35,983259,986977,3718
"6134",51,3,79,36,990004,994056,4052
"6238",51,5,87,37,997573,1001599,4026
"6333",51,6,40,38,1003868,1007247,3379
"6542",51,2,48,39,1014150,1016561,2411
"6734",51,1,83,40,1022248,1025836,3588
"6836",51,4,38,41,1028726,1031255,2529
"7037",51,2,126,42,1036576,1040942,4366
"7135",51,6,124,43,1043622,1046347,2725
"7232",51,4,122,44,1048649,1050635,1986
"7338",51,6,100,45,1054008,1057433,3425
"7440",51,1,77,46,1060591,1063244,2653
"7538",51,5,129,47,1066826,1069996,3170
"7643",51,3,133,48,1072336,1075630,3294
"7735",51,3,127,49,1078258,1081310,3052
"7840",51,2,18,50,1083670,1088043,4373
"8034",51,6,88,51,1094756,1097717,2961
"8133",51,5,93,52,1100377,1103730,3353
"8241",51,2,84,53,1106273,1109887,3614
"8341",51,5,57,54,1112764,1115371,2607
"8426",51,2,30,55,1117875,1120640,2765
"8642",51,1,101,56,1125327,1128248,2921
"8728",51,4,56,57,1130981,1137667,6686
"8840",51,2,72,58,1140295,1142974,2679
"8933",51,6,82,59,1145622,1147700,2078
"9034",51,2,138,60,1150825,1153472,2647
"9138",51,5,111,61,1156172,1161322,5150
"9237",51,1,47,62,1163911,1165884,1973
"9432",51,2,12,63,1170983,1172944,1961
"9633",51,4,80,64,1179958,1182604,2646
"9731",51,1,125,65,1185265,1188369,3104
"9837",51,6,94,66,1248466,1251655,3189
"9940",51,5,39,67,1253904,1257230,3326
"10158",51,1,35,68,1262479,1265747,3268
"10338",51,2,36,69,1271297,1273878,2581
"10536",51,5,51,70,1278762,1282153,3391
"10738",51,2,114,71,1287331,1292004,4673
"10833",51,1,17,72,1294475,1297723,3248
"11031",51,6,130,73,1302998,1306017,3019
"11149",51,1,29,74,1309692,1314038,4346
"11334",51,4,104,75,1319032,1323162,4130
"11442",51,1,65,76,1326588,1330699,4111
"11529",51,2,66,77,1333026,1337091,4065
"11641",51,4,32,78,1339687,1343634,3947
"11839",51,5,9,79,1349322,1353713,4391
"12035",51,3,97,80,1359329,1362283,2954
"12147",51,5,105,81,1364663,1367551,2888
"12240",51,1,53,82,1369879,1375793,5914
"12435",51,1,11,83,1380631,1382663,2032
"12630",51,1,5,84,1388514,1391932,3418
"12833",51,1,71,85,1397148,1399037,1889
"12939",51,6,106,86,1401920,1404684,2764
"13033",51,5,27,87,1407162,1409992,2830
"13236",51,1,131,88,1414646,1417580,2934
"13334",51,2,90,89,1419882,1423136,3254
"13435",51,1,95,90,1425464,1428065,2601
"13534",51,6,136,91,1430373,1433424,3051
"13635",51,5,99,92,1435765,1438294,2529
"13740",51,6,70,93,1440582,1445386,4804
"13830",51,5,135,94,1447589,1451439,3850
"13937",51,5,123,95,1454492,1457531,3039
"14038",51,6,112,96,1465682,1468544,2862
"14153",51,4,14,97,1470983,1474617,3634
"14338",51,4,134,98,1482722,1487971,5249
"14438",51,4,50,99,1490318,1493696,3378
"14635",51,6,76,100,1498358,1501631,3273
"14733",51,2,102,101,1503913,1506011,2098
"14834",51,2,96,102,1508378,1511351,2973
"14937",51,6,34,103,1513744,1517234,3490
"15146",51,3,121,104,1522973,1525640,2667
"15239",51,2,24,105,1528059,1535699,7640
"15438",51,4,20,106,1541497,1544569,3072
"15635",51,6,64,107,1550511,1553419,2908
"15739",51,3,73,108,1556316,1559995,3679
"15838",51,4,8,109,1562283,1567250,4967
"16043",51,4,26,110,1574349,1578806,4457
"16238",51,1,41,111,1584081,1586905,2824
"16438",51,6,10,112,1592272,1596311,4039
"16637",51,2,60,113,1605508,1609920,4412
"16739",51,3,49,114,1612430,1615593,3163
"16936",51,2,108,115,1621431,1625038,3607
"17038",51,3,37,116,1627699,1631058,3359
"17238",51,3,7,117,1636040,1640732,4692
"17433",51,3,43,118,1646838,1650105,3267
"17639",51,4,98,119,1655492,1660308,4816
"17735",51,5,69,120,1662577,1664982,2405
"17839",51,3,115,121,1667172,1669839,2667
"17934",51,4,62,122,1672362,1674440,2078
"18034",51,6,58,123,1676925,1679983,3058
"18155",51,2,6,124,1682330,1687121,4791
"18333",51,3,61,125,1692468,1695415,2947
"18436",51,4,128,126,1697946,1702579,4633
"18536",51,6,52,127,1705292,1708135,2843
"18734",51,5,117,128,1713443,1716652,3209
"18837",51,1,59,129,1718999,1722326,3327
"18934",51,1,23,130,1724889,1727568,2679
"19144",51,1,107,131,1732353,1735424,3071
"19242",51,3,85,132,1739275,1742817,3542
"19339",51,4,68,133,1745119,1748948,3829
"19433",51,4,86,134,1751367,1754256,2889
"19533",51,5,15,135,1756610,1761439,4829
"19739",51,3,19,136,1766669,1769819,3150
"19942",51,3,55,137,1778807,1781624,2817
"20033",51,3,25,138,1784245,1787264,3019
"10159",52,2,125,1,3217346,3221103,3757
"11150",52,6,117,2,3224928,3228653,3725
"12148",52,4,121,3,3231745,3236908,5163
"13146",52,4,31,4,3242086,3245942,3856
"15147",52,4,67,5,3253747,3257014,3267
"16136",52,6,51,6,3261453,3266584,5131
"18156",52,4,37,7,3282722,3286559,3837
"2044",52,3,42,8,3293632,3297703,4071
"2237",52,4,43,9,3303240,3306475,3235
"2435",52,1,88,10,3312672,3316835,4163
"2536",52,1,16,11,3320424,3324149,3725
"2734",52,3,24,12,3331765,3336000,4235
"2942",52,3,96,13,3345903,3352844,6941
"3037",52,5,62,14,3364682,3371388,6706
"3139",52,1,76,15,3408195,3413188,4993
"3230",52,5,122,16,3415672,3418809,3137
"3338",52,4,55,17,3421960,3424614,2654
"3438",52,4,103,18,3429301,3432595,3294
"3535",52,1,46,19,3435948,3439314,3366
"3733",52,4,19,20,3446923,3449988,3065
"3935",52,5,86,21,3458969,3462433,3464
"4038",52,2,59,22,3464937,3469277,4340
"4141",52,2,131,23,3473310,3477486,4176
"4237",52,1,82,24,3480082,3483180,3098
"4333",52,3,30,25,3486455,3491141,4686
"4529",52,1,64,26,3497220,3501619,4399
"4638",52,1,40,27,3505404,3508946,3542
"4833",52,6,111,28,3518209,3523169,4960
"4933",52,5,2,29,3526242,3529954,3712
"5134",52,1,130,30,3536432,3541321,4889
"5240",52,6,15,31,3545459,3548334,2875
"5441",52,3,12,32,3556459,3560041,3582
"5642",52,1,22,33,3566872,3572636,5764
"5834",52,2,47,34,3579141,3582297,3156
"6039",52,2,17,35,3588050,3592880,4830
"6239",52,1,118,36,3598894,3602919,4025
"6334",52,6,75,37,3606417,3610698,4281
"6435",52,3,138,38,3614509,3618234,3725
"6543",52,4,1,39,3623065,3626189,3124
"6735",52,3,48,40,3631693,3634575,2882
"6936",52,3,18,41,3641583,3644883,3300
"7136",52,5,14,42,3652675,3658936,6261
"7339",52,4,109,43,3665807,3671264,5457
"7441",52,6,105,44,3674611,3678473,3862
"7539",52,1,34,45,3680971,3685539,4568
"7736",52,6,123,46,3693567,3697592,4025
"7841",52,3,66,47,3701044,3704456,3412
"7938",52,2,137,48,3707764,3710770,3006
"8035",52,3,60,49,3717372,3722810,5438
"8134",52,5,68,50,3725615,3729817,4202
"8242",52,3,36,51,3732308,3735778,3470
"8427",52,6,9,52,3741694,3746184,4490
"8643",52,2,107,53,3754126,3758008,3882
"8729",52,4,133,54,3760499,3764296,3797
"8841",52,2,11,55,3766905,3770002,3097
"9035",52,3,72,56,3777317,3781258,3941
"9139",52,4,127,57,3784095,3787409,3314
"9238",52,4,13,58,3792586,3796056,3470
"9433",52,2,77,59,3807058,3809639,2581
"9533",52,3,84,60,3812640,3815790,3150
"9634",52,6,93,61,3818895,3822143,3248
"9732",52,3,114,62,3824719,3831497,6778
"9838",52,2,113,63,3834249,3838379,4130
"9941",52,4,61,64,3848923,3852675,3752
"10040",52,3,54,65,3857087,3860479,3392
"10237",52,5,116,66,4072984,4078121,5137
"10339",52,5,104,67,4081089,4085023,3934
"10433",52,6,63,68,4088044,4092187,4143
"10537",52,6,39,69,4096816,4101358,4542
"10739",52,3,126,70,4107868,4113430,5562
"10834",52,5,110,71,4117006,4120470,3464
"10942",52,5,26,72,4123602,4128255,4653
"11151",52,6,129,73,4135628,4138471,2843
"11237",52,3,132,74,4141204,4144406,3202
"11335",52,2,101,75,4152460,4156780,4320
"11443",52,2,95,76,4160480,4164421,3941
"11530",52,5,38,77,4166840,4171205,4365
"11740",52,1,28,78,4177618,4181500,3882
"11936",52,5,50,79,4187286,4190573,3287
"12149",52,2,23,80,4196201,4198626,2425
"12332",52,6,21,81,4204509,4207450,2941
"12537",52,1,10,82,4214738,4219006,4268
"12737",52,4,85,83,4227308,4231987,4679
"12834",52,5,134,84,4235132,4238916,3784
"12940",52,5,20,85,4242688,4246851,4163
"13147",52,6,99,86,4252656,4257492,4836
"13237",52,6,57,87,4260310,4264270,3960
"13335",52,5,56,88,4268082,4272101,4019
"13436",52,2,89,89,4280468,4284788,4320
"13535",52,4,7,90,4288926,4292573,3647
"13741",52,5,74,91,4300260,4304345,4085
"13831",52,4,91,92,4307644,4311940,4296
"13938",52,3,102,93,4316065,4320379,4314
"14039",52,6,45,94,4324536,4327837,3301
"14238",52,1,136,95,4334557,4337955,3398
"14339",52,1,106,96,4340420,4343158,2738
"14439",52,3,108,97,4347126,4350773,3647
"14534",52,1,58,98,4355539,4360342,4803
"14636",52,2,119,99,4366572,4370657,4085
"14734",52,6,81,100,4373187,4376258,3071
"14835",52,3,120,101,4379331,4382291,2960
"14938",52,4,115,102,4385619,4388553,2934
"15040",52,6,27,103,4391044,4393952,2908
"15240",52,5,32,104,4399247,4403221,3974
"15439",52,2,35,105,4409104,4411653,2549
"15636",52,5,92,106,4420765,4423725,2960
"15740",52,6,33,107,4426981,4430883,3902
"15929",52,5,98,108,4437106,4441517,4411
"16044",52,6,3,109,4445897,4449760,3863
"16239",52,1,4,110,4457251,4460277,3026
"16439",52,2,5,111,4470311,4475448,5137
"16638",52,5,8,112,4482142,4487867,5725
"16837",52,3,90,113,4493149,4496495,3346
"16937",52,2,41,114,4499509,4501639,2130
"17148",52,1,94,115,4509346,4514026,4680
"17239",52,5,80,116,4520340,4523641,3301
"17335",52,3,78,117,4527282,4529674,2392
"17434",52,5,44,118,4531831,4535883,4052
"17640",52,3,6,119,4542198,4545139,2941
"17840",52,6,69,120,4553944,4556185,2241
"17935",52,4,25,121,4562337,4564519,2182
"18157",52,6,135,122,4571690,4575873,4183
"18235",52,1,124,123,4579847,4582631,2784
"18334",52,2,29,124,4585939,4589148,3209
"18537",52,1,70,125,4598352,4602090,3738
"18635",52,5,128,126,4605156,4610457,5301
"18735",52,1,100,127,4613647,4615973,2326
"18838",52,4,79,128,4619759,4622797,3038
"18935",52,4,97,129,4627125,4629902,2777
"19035",52,6,87,130,4632851,4637707,4856
"19145",52,1,112,131,4640316,4644302,3986
"19243",52,1,52,132,4647316,4649485,2169
"19434",52,4,73,133,4656539,4659368,2829
"19534",52,4,49,134,4661820,4664846,3026
"19740",52,2,65,135,4693339,4695953,2614
"19830",52,2,83,136,4698868,4701195,2327
"19943",52,2,53,137,4704457,4706038,1581
"20138",52,2,71,138,4717406,4719647,2241
"10160",53,2,40,1,10176653,10181797,5144
"12150",53,1,105,2,10186909,10189438,2529
"13148",53,6,74,3,10191517,10197759,6242
"14154",53,1,129,4,10200400,10203988,3588
"15148",53,4,30,5,10206459,10209263,2804
"17149",53,5,49,6,10213780,10217740,3960
"19146",53,5,115,7,10222526,10225675,3149
"2045",53,6,134,8,10228029,10231460,3431
"2143",53,4,66,9,10233866,10237415,3549
"2238",53,6,56,10,10239938,10243644,3706
"2340",53,2,100,11,10245998,10249069,3071
"2436",53,4,132,12,10251632,10255259,3627
"2537",53,6,62,13,10257822,10260992,3170
"2640",53,3,131,14,10263502,10267149,3647
"2735",53,6,128,15,10269960,10275365,5405
"2835",53,3,119,16,10278150,10283202,5052
"2943",53,6,14,17,10285759,10289203,3444
"3140",53,6,2,18,10294857,10299079,4222
"3339",53,4,24,19,10305034,10309511,4477
"3536",53,1,45,20,10314741,10317695,2954
"3734",53,5,97,21,10322781,10326453,3672
"3837",53,4,126,22,10329010,10333696,4686
"3936",53,3,71,23,10336089,10338611,2522
"4039",53,5,103,24,10341311,10344788,3477
"4142",53,1,51,25,10347351,10350370,3019
"4334",53,1,99,26,10355077,10358233,3156
"4441",53,5,13,27,10360522,10365123,4601
"4639",53,1,33,28,10369784,10372980,3196
"4834",53,1,81,29,10378249,10382359,4110
"4934",53,4,78,30,10384667,10388758,4091
"5043",53,2,4,31,10391282,10395125,3843
"5241",53,5,37,32,10400623,10404406,3783
"5442",53,2,28,33,10410839,10416414,5575
"5643",53,3,41,34,10421676,10425918,4242
"5835",53,1,63,35,10430500,10433918,3418
"5937",53,6,26,36,10436586,10440409,3823
"6135",53,6,8,37,10446783,10450664,3881
"6335",53,1,3,38,10456855,10461306,4451
"6544",53,6,98,39,10466483,10471940,5457
"6635",53,2,82,40,10474431,10477398,2967
"6736",53,5,109,41,10480288,10484412,4124
"6837",53,3,11,42,10486837,10490628,3791
"7038",53,2,130,43,10497060,10500093,3033
"7137",53,5,91,44,10502538,10507825,5287
"7233",53,5,133,45,10512003,10516139,4136
"7340",53,2,34,46,10518885,10521898,3013
"7540",53,4,114,47,10527951,10531278,3327
"7644",53,5,127,48,10533860,10536657,2797
"7737",53,4,108,49,10539083,10541579,2496
"7842",53,4,42,50,10543920,10547776,3856
"8036",53,3,5,51,10553162,10556109,2947
"8243",53,2,112,52,10562019,10564587,2568
"8342",53,4,120,53,10566915,10570581,3666
"8428",53,2,94,54,10573020,10575980,2960
"8535",53,2,106,55,10578321,10580529,2208
"8644",53,5,67,56,10583654,10586608,2954
"8730",53,1,39,57,10589348,10592491,3143
"8934",53,4,72,58,10597603,10601949,4346
"9036",53,5,25,59,10604447,10607355,2908
"9239",53,1,87,60,10611970,10616578,4608
"9341",53,2,52,61,10619082,10622421,3339
"9534",53,3,47,62,10627121,10629323,2202
"9733",53,5,85,63,10634972,10638690,3718
"9839",53,2,58,64,10641501,10646174,4673
"9942",53,4,36,65,10648737,10651233,2496
"10161",53,4,6,66,10756640,10762064,5424
"10340",53,6,38,67,10767000,10770706,3706
"10538",53,1,117,68,10775295,10777791,2496
"10639",53,6,68,69,10780243,10783223,2980
"10740",53,2,16,70,10785740,10788896,3156
"10943",53,3,95,71,10793923,10798328,4405
"11032",53,6,92,72,10800846,10804662,3816
"11152",53,4,54,73,10807035,10810002,2967
"11336",53,2,70,74,10817023,10820095,3072
"11444",53,1,27,75,10822546,10825487,2941
"11642",53,4,84,76,10830181,10833978,3797
"11741",53,3,107,77,10836423,10841129,4706
"11840",53,5,19,78,10843436,10846031,2595
"12036",53,2,64,79,10853248,10857045,3797
"12151",53,3,65,80,10859372,10863503,4131
"12241",53,2,118,81,10866033,10869889,3856
"12333",53,6,32,82,10872445,10876713,4268
"12538",53,4,96,83,10881831,10884622,2791
"12631",53,5,7,84,10887113,10890367,3254
"12835",53,3,89,85,10896179,10901080,4901
"12941",53,3,83,86,10903545,10907636,4091
"13034",53,1,111,87,10909846,10912166,2320
"13149",53,1,57,88,10914742,10917990,3248
"13238",53,4,60,89,10920337,10924095,3758
"13336",53,3,137,90,10926547,10930546,3999
"13437",53,2,124,91,10932959,10936325,3366
"13536",53,5,73,92,10938979,10941390,2411
"13636",53,6,86,93,10943711,10947391,3680
"13742",53,6,122,94,10949738,10952607,2869
"13832",53,2,10,95,10954882,10958365,3483
"14040",53,4,18,96,10963556,10965921,2365
"14239",53,6,104,97,10970772,10974157,3385
"14340",53,1,69,98,10976629,10979870,3241
"14440",53,5,61,99,10982354,10986073,3719
"14535",53,5,31,100,10988786,10992256,3470
"14735",53,5,43,101,10996996,10999629,2633
"14939",53,4,138,102,11004271,11007519,3248
"15041",53,3,29,103,11010121,11014526,4405
"15241",53,6,44,104,11019952,11023494,3542
"15440",53,6,116,105,11028743,11032756,4013
"15531",53,5,55,106,11035064,11037985,2921
"15637",53,1,9,107,11040358,11044208,3850
"15839",53,4,102,108,11049875,11052960,3085
"15930",53,2,22,109,11055340,11059261,3921
"16137",53,3,23,110,11063582,11066549,2967
"16336",53,1,135,111,11072373,11076661,4288
"16440",53,6,20,112,11080119,11082910,2791
"16639",53,5,1,113,11087250,11090204,2954
"16838",53,3,113,114,11095029,11097460,2431
"16938",53,5,121,115,11099859,11103035,3176
"17039",53,3,17,116,11105559,11108630,3071
"17240",53,6,110,117,11113566,11116160,2594
"17336",53,1,75,118,11118625,11121069,2444
"17435",53,6,50,119,11123808,11126108,2300
"17641",53,3,77,120,11131038,11133312,2274
"17736",53,4,48,121,11136018,11138358,2340
"17936",53,1,123,122,11483937,11487028,3091
"18035",53,3,125,123,11489761,11493682,3921
"18158",53,2,76,124,11496082,11499898,3816
"18236",53,2,136,125,11502455,11506056,3601
"18335",53,3,59,126,11508501,11512631,4130
"18437",53,6,80,127,11514880,11518344,3464
"18538",53,1,15,128,11520730,11523645,2915
"18736",53,1,93,129,11528653,11531946,3293
"18839",53,2,46,130,11534450,11539097,4647
"19036",53,3,101,131,11544177,11548091,3914
"19147",53,3,35,132,11550608,11554340,3732
"19340",53,4,90,133,11560106,11564164,4058
"19435",53,3,53,134,11566694,11571008,4314
"19636",53,4,12,135,11575852,11578845,2993
"19831",53,5,79,136,11584297,11587649,3352
"19944",53,1,21,137,11590225,11594159,3934
"20139",53,2,88,138,11599298,11603415,4117
"10162",54,2,99,1,12309829,12312325,2496
"11153",54,4,41,2,12315156,12317221,2065
"13150",54,6,91,3,12322778,12325725,2947
"14155",54,6,115,4,12328314,12330444,2130
"15149",54,3,94,5,12333007,12335778,2771
"16138",54,1,116,6,12338073,12342171,4098
"17150",54,4,23,7,12344544,12347537,2993
"19148",54,2,45,8,12352675,12355217,2542
"2144",54,5,66,9,12359538,12361930,2392
"2239",54,6,37,10,12364532,12368904,4372
"2437",54,2,21,11,12373879,12376683,2804
"2641",54,3,112,12,12381566,12384004,2438
"2736",54,2,105,13,12386508,12388579,2071
"2836",54,2,9,14,12391096,12393521,2425
"3038",54,2,51,15,12398031,12400488,2457
"3231",54,6,13,16,12405130,12408064,2934
"3439",54,6,121,17,12412790,12415849,3059
"3537",54,2,57,18,12418497,12421241,2744
"3638",54,3,64,19,12423687,12426137,2450
"3735",54,4,137,20,12428425,12430314,1889
"3838",54,2,69,21,12433066,12435125,2059
"3937",54,2,87,22,12437720,12440831,3111
"4040",54,6,61,23,12443779,12446504,2725
"4143",54,6,73,24,12449061,12451714,2653
"4238",54,6,97,25,12454682,12458041,3359
"4335",54,6,43,26,12460624,12464048,3424
"4530",54,3,130,27,12469134,12471761,2627
"4640",54,5,30,28,12474298,12476291,1993
"4835",54,4,119,29,12481069,12483396,2327
"4935",54,2,39,30,12486103,12488082,1979
"5135",54,3,4,31,12493410,12496004,2594
"5336",54,5,42,32,12501685,12504567,2882
"5538",54,1,68,33,12510333,12512600,2267
"5644",54,2,33,34,12515386,12517496,2110
"5836",54,1,32,35,12523072,12525457,2385
"6040",54,2,117,36,12531151,12533020,1869
"6136",54,6,85,37,12535439,12539079,3640
"6240",54,1,86,38,12542250,12544080,1830
"6336",54,5,48,39,12547264,12548851,1587
"6545",54,4,101,40,12553976,12555799,1823
"6636",54,6,127,41,12558075,12560434,2359
"6737",54,4,17,42,12563258,12566160,2902
"6937",54,1,20,43,12571958,12573912,1954
"7138",54,6,103,44,12579396,12582402,3006
"7234",54,1,128,45,12584658,12587514,2856
"7341",54,4,83,46,12590214,12592795,2581
"7442",54,5,78,47,12595790,12597606,1816
"7541",54,3,58,48,12600260,12603018,2758
"7645",54,1,38,49,12605450,12607077,1627
"7843",54,3,118,50,12612215,12615346,3131
"7939",54,5,84,51,12617876,12620281,2405
"8037",54,1,122,52,12622576,12624288,1712
"8135",54,4,35,53,12626877,12628523,1646
"8343",54,1,92,54,12634132,12636511,2379
"8429",54,2,27,55,12639165,12641354,2189
"8645",54,1,8,56,12645786,12647505,1719
"8842",54,3,100,57,12652447,12655303,2856
"8935",54,5,36,58,12657911,12659983,2072
"9140",54,1,2,59,12665108,12666630,1522
"9342",54,4,53,60,12672200,12674422,2222
"9535",54,3,16,61,12679488,12681448,1960
"9734",54,6,133,62,12686953,12688769,1816
"9840",54,3,46,63,12691260,12694789,3529
"10041",54,5,72,64,12701026,12703201,2175
"10163",54,2,15,65,12706385,12708163,1778
"10341",54,3,88,66,12748787,12752793,4006
"10434",54,3,40,67,12755421,12758088,2667
"10640",54,4,59,68,12763363,12765310,1947
"10741",54,3,22,69,12767703,12770317,2614
"10944",54,6,7,70,12775495,12777873,2378
"11154",54,3,10,71,12783515,12786351,2836
"11337",54,4,11,72,12791836,12793410,1574
"11531",54,5,6,73,12798620,12800822,2202
"11742",54,3,70,74,12805497,12808862,3365
"11841",54,4,131,75,12811353,12813608,2255
"11937",54,3,34,76,12815968,12819333,3365
"12152",54,1,74,77,12824759,12827674,2915
"12242",54,2,3,78,12830106,12832544,2438
"12436",54,2,123,79,12837832,12840400,2568
"12539",54,4,47,80,12842878,12844590,1712
"12738",54,3,28,81,12849624,12851806,2182
"12942",54,1,110,82,12857363,12859160,1797
"13035",54,3,106,83,12861566,12863598,2032
"13151",54,2,81,84,12865991,12868958,2967
"13239",54,5,90,85,12871481,12873821,2340
"13337",54,2,93,86,12876299,12878272,1973
"13438",54,1,98,87,12880737,12883351,2614
"13537",54,4,95,88,12885914,12887939,2025
"13637",54,5,132,89,12890966,12893404,2438
"13743",54,4,113,90,12896163,12898280,2117
"13833",54,4,29,91,13019295,13022086,2791
"14041",54,5,18,92,13027440,13029478,2038
"14240",54,1,80,93,13034100,13035995,1895
"14341",54,6,31,94,13038414,13041048,2634
"14536",54,5,114,95,13045826,13049068,3242
"14637",54,6,55,96,13051676,13053428,1752
"14736",54,5,96,97,13056141,13057997,1856
"14836",54,5,102,98,13060533,13062592,2059
"14940",54,6,1,99,13065677,13068004,2327
"15150",54,5,24,100,13073240,13075285,2045
"15334",54,5,120,101,13079914,13081619,1705
"15441",54,1,134,102,13084365,13086476,2111
"15532",54,4,89,103,13089280,13091469,2189
"15638",54,3,136,104,13094183,13097378,3195
"15741",54,3,124,105,13100118,13103287,3169
"15840",54,4,107,106,13105700,13107673,1973
"15931",54,5,54,107,13110086,13111745,1659
"16139",54,1,26,108,13117648,13119105,1457
"16337",54,5,138,109,13124858,13127374,2516
"16441",54,1,56,110,13129897,13132067,2170
"16537",54,6,49,111,13134336,13136257,1921
"16740",54,1,50,112,13140591,13143211,2620
"16939",54,2,135,113,13147820,13152166,4346
"17040",54,3,82,114,13154520,13156526,2006
"17151",54,1,44,115,13159475,13160938,1463
"17337",54,6,67,116,13166024,13168324,2300
"17436",54,6,109,117,13171214,13173227,2013
"17536",54,6,79,118,13175659,13178364,2705
"17642",54,1,104,119,13181084,13182691,1607
"17737",54,1,62,120,13185372,13187358,1986
"17841",54,2,63,121,13189967,13191345,1378
"17937",54,4,125,122,13193333,13195045,1712
"18036",54,6,19,123,13197791,13199484,1693
"18237",54,4,71,124,13205661,13207490,1829
"18336",54,2,129,125,13210282,13212517,2235
"18438",54,5,12,126,13215047,13217171,2124
"18636",54,5,108,127,13223191,13225309,2118
"18737",54,5,60,128,13228577,13230570,1993
"18840",54,4,77,129,13232963,13235198,2235
"18936",54,2,75,130,13237774,13239675,1901
"19037",54,4,65,131,13242441,13244290,1849
"19149",54,4,5,132,13247030,13249964,2934
"19341",54,3,76,133,13255605,13257977,2372
"19436",54,5,126,134,13260501,13262997,2496
"19535",54,2,111,135,13265743,13267736,1993
"19637",54,6,25,136,13270240,13272168,1928
"19832",54,3,52,137,13277103,13279306,2203
"20034",54,1,14,138,13283999,13286182,2183
"10164",55,3,123,1,15134064,15138097,4033
"11155",55,5,137,2,15140535,15144339,3804
"12153",55,6,48,3,15147006,15149071,2065
"14156",55,5,125,4,15156216,15158882,2666
"15151",55,1,115,5,15161524,15164327,2803
"16140",55,2,86,6,15167465,15170151,2686
"17152",55,5,59,7,15172786,15175485,2699
"18159",55,6,126,8,15178316,15181564,3248
"19150",55,1,55,9,15184270,15186714,2444
"2046",55,6,114,10,15189735,15193107,3372
"2145",55,4,88,11,15196239,15199513,3274
"2240",55,3,45,12,15201840,15205023,3183
"2438",55,6,66,13,15210926,15213723,2797
"2538",55,5,113,14,15217057,15220507,3450
"2642",55,1,103,15,15222927,15225351,2424
"2737",55,3,27,16,15227927,15231227,3300
"2944",55,3,99,17,15237797,15241032,3235
"3039",55,2,68,18,15243601,15246339,2738
"3141",55,1,13,19,15249118,15251934,2816
"3340",55,3,87,20,15257072,15260647,3575
"3440",55,4,112,21,15265315,15267857,2542
"3538",55,1,61,22,15271623,15275498,3875
"3639",55,2,80,23,15277904,15280335,2431
"3736",55,2,56,24,15282734,15285603,2869
"3839",55,4,106,25,15288310,15290453,2143
"3938",55,4,34,26,15292944,15297022,4078
"4144",55,3,135,27,15303161,15307115,3954
"4239",55,4,58,28,15309449,15313030,3581
"4336",55,1,25,29,15315626,15320017,4391
"4531",55,2,50,30,15325365,15328515,3150
"4738",55,6,138,31,15333653,15336920,3267
"4836",55,1,79,32,15340124,15343234,3110
"4936",55,6,30,33,15345784,15348823,3039
"5136",55,5,119,34,15353857,15358085,4228
"5242",55,5,65,35,15360544,15362903,2359
"5337",55,5,77,36,15366328,15368726,2398
"5443",55,4,76,37,15371244,15374648,3404
"5539",55,6,78,38,15376950,15380034,3084
"5645",55,3,63,39,15382460,15385969,3509
"5737",55,5,47,40,15388441,15391382,2941
"5938",55,2,98,41,15397023,15399827,2804
"6041",55,4,52,42,15402644,15405369,2725
"6241",55,4,22,43,15410645,15413644,2999
"6436",55,3,21,44,15418338,15421808,3470
"6637",55,1,43,45,15427110,15429985,2875
"6838",55,6,72,46,15434614,15438104,3490
"6938",55,5,89,47,15440660,15443738,3078
"7039",55,1,91,48,15447687,15451353,3666
"7139",55,2,62,49,15453916,15456072,2156
"7235",55,1,109,50,15458792,15461269,2477
"7342",55,4,40,51,15464590,15468583,3993
"7542",55,3,93,52,15474636,15477087,2451
"7646",55,5,107,53,15479467,15483584,4117
"7738",55,2,110,54,15486003,15488937,2934
"7844",55,1,31,55,15496814,15499624,2810
"8038",55,3,9,56,15509253,15512873,3620
"8244",55,6,42,57,15518201,15522188,3987
"8430",55,1,67,58,15528607,15531247,2640
"8536",55,5,5,59,15533679,15536038,2359
"8731",55,3,117,60,15541863,15544013,2150
"8843",55,5,35,61,15546497,15549255,2758
"9037",55,4,70,62,15554942,15558321,3379
"9141",55,2,134,63,15561210,15563935,2725
"9240",55,4,28,64,15566387,15569504,3117
"9434",55,5,131,65,15574858,15577806,2948
"9536",55,4,46,66,15610299,15612821,2522
"9735",55,6,60,67,15617678,15621358,3680
"9841",55,1,85,68,15623698,15626646,2948
"9943",55,2,14,69,15628980,15632299,3319
"10165",55,2,92,70,15637823,15641516,3693
"10238",55,1,133,71,15644157,15646470,2313
"10342",55,3,57,72,15648909,15651980,3071
"10435",55,2,104,73,15654230,15658295,4065
"10539",55,6,84,74,15660818,15664262,3444
"10641",55,1,127,75,15666721,15668629,1908
"10742",55,4,64,76,15670996,15673766,2770
"10835",55,1,73,77,15677277,15679871,2594
"10945",55,2,122,78,15682362,15684336,1974
"11033",55,3,69,79,15686689,15689016,2327
"11156",55,6,90,80,15691297,15693539,2242
"11238",55,2,38,81,15695893,15698297,2404
"11445",55,4,136,82,15703632,15705997,2365
"11532",55,3,39,83,15708652,15711919,3267
"11743",55,3,129,84,15717607,15720220,2613
"11842",55,1,37,85,15722607,15725502,2895
"12037",55,2,116,86,15731614,15735241,3627
"12154",55,4,118,87,15737752,15740588,2836
"12243",55,2,2,88,15743040,15746719,3679
"12437",55,2,20,89,15752949,15756373,3424
"12632",55,6,6,90,15762518,15766655,4137
"12836",55,4,100,91,15772270,15775531,3261
"12943",55,4,130,92,15778133,15781257,3124
"13036",55,5,29,93,15783546,15787807,4261
"13240",55,6,36,94,15793278,15795618,2340
"13439",55,3,15,95,15801233,15803572,2339
"13638",55,4,124,96,15808809,15811841,3032
"13744",55,4,16,97,15814423,15818469,4046
"13939",55,1,121,98,15823509,15826757,3248
"14042",55,4,94,99,15829294,15832842,3548
"14157",55,3,33,100,15835719,15838483,2764
"14342",55,2,32,101,15844576,15847085,2509
"14537",55,2,128,102,15852942,15856125,3183
"14638",55,6,54,103,15858537,15861138,2601
"14837",55,1,1,104,15868028,15870557,2529
"15042",55,1,97,105,15875545,15878545,3000
"15152",55,4,4,106,15881068,15884003,2935
"15335",55,5,53,107,15889592,15892618,3026
"15533",55,6,102,108,15897978,15900376,2398
"15639",55,4,82,109,15903011,15905507,2496
"15742",55,1,49,110,15908057,15911403,3346
"15932",55,3,3,111,15916626,15920266,3640
"16141",55,1,19,112,15925496,15928182,2686
"16338",55,1,7,113,15933686,15937196,3510
"16538",55,2,74,114,15950465,15954556,4091
"16640",55,5,23,115,15956949,15959256,2307
"16839",55,2,44,116,15965152,15967041,1889
"17041",55,3,75,117,15972035,15975584,3549
"17153",55,3,111,118,15978088,15980676,2588
"17241",55,5,11,119,15983317,15985643,2326
"17437",55,6,12,120,15991827,15994729,2902
"17643",55,6,120,121,15999887,16002644,2757
"17738",55,5,17,122,16004992,16007873,2881
"17938",55,5,83,123,16013299,16017743,4444
"18037",55,3,51,124,16020019,16023482,3463
"18238",55,5,101,125,16028425,16031261,2836
"18337",55,6,24,126,16034013,16036464,2451
"18539",55,6,108,127,16042138,16045164,3026
"18637",55,3,105,128,16047530,16049896,2366
"18738",55,6,18,129,16052609,16056047,3438
"18937",55,2,26,130,16064446,16067936,3490
"19151",55,2,8,131,16076702,16079283,2581
"19342",55,5,41,132,16084311,16087212,2901
"19536",55,6,132,133,16092030,16095670,3640
"19638",55,5,95,134,16098246,16101612,3366
"19741",55,5,71,135,16104403,16106743,2340
"19833",55,6,96,136,16109332,16111985,2653
"19945",55,4,10,137,16114358,16117959,3601
"20140",55,3,81,138,16124104,16128091,3987
"10166",56,4,63,1,17498836,17503286,4450
"11157",56,5,124,2,17505764,17508888,3124
"12155",56,1,90,3,17511203,17514934,3731
"13152",56,5,16,4,17517438,17520189,2751
"15153",56,5,136,5,17525811,17528889,3078
"16142",56,1,54,6,17531394,17534060,2666
"18160",56,6,41,7,17541427,17545858,4431
"2047",56,1,72,8,17552866,17556140,3274
"2146",56,6,83,9,17558833,17562016,3183
"2241",56,1,42,10,17564840,17569683,4843
"2439",56,3,110,11,17577141,17582331,5190
"2539",56,6,71,12,17584913,17587338,2425
"2643",56,3,26,13,17589763,17592796,3033
"2837",56,4,87,14,17601660,17606450,4790
"2945",56,4,135,15,17609137,17613562,4425
"3040",56,5,64,16,17615863,17619268,3405
"3142",56,6,137,17,17621916,17624674,2758
"3232",56,2,127,18,17627602,17631007,3405
"3341",56,1,126,19,17633838,17637380,3542
"3441",56,2,37,20,17641280,17644557,3277
"3640",56,4,105,21,17651454,17653976,2522
"3737",56,5,40,22,17657095,17660323,3228
"3939",56,1,18,23,17666664,17669788,3124
"4145",56,2,61,24,17676423,17678723,2300
"4240",56,3,50,25,17681430,17684900,3470
"4442",56,5,118,26,17691103,17694770,3667
"4532",56,2,19,27,17697326,17699953,2627
"4739",56,1,96,28,17707745,17711209,3464
"4837",56,1,102,29,17713850,17717065,3215
"4937",56,3,14,30,17720439,17724412,3973
"5137",56,4,75,31,17730557,17734295,3738
"5243",56,6,65,32,17736812,17739315,2503
"5338",56,1,60,33,17742015,17745910,3895
"5444",56,2,121,34,17748506,17751754,3248
"5540",56,3,116,35,17754264,17757663,3399
"5646",56,2,13,36,17760755,17764258,3503
"5837",56,4,99,37,17770344,17772559,2215
"5939",56,6,95,38,17775063,17778154,3091
"6042",56,2,73,39,17780652,17783187,2535
"6137",56,3,8,40,17785606,17788619,3013
"6337",56,4,9,41,17794600,17797319,2719
"6546",56,6,113,42,17803464,17807176,3712
"6638",56,4,69,43,17809386,17811359,1973
"6738",56,1,78,44,17818641,17821386,2745
"6839",56,5,100,45,17823955,17827125,3170
"6939",56,3,86,46,17829524,17832910,3386
"7040",56,4,111,47,17856101,17859918,3817
"7140",56,5,28,48,17862827,17867134,4307
"7343",56,2,85,49,17874403,17878030,3627
"7443",56,4,123,50,17880436,17883789,3353
"7543",56,4,117,51,17886528,17888325,1797
"7647",56,2,97,52,17890979,17893783,2804
"7739",56,3,38,53,17896352,17899404,3052
"7940",56,4,15,54,17905405,17907418,2013
"8136",56,5,112,55,17913099,17916353,3254
"8245",56,3,32,56,17919138,17922465,3327
"8431",56,5,88,57,17928015,17930184,2169
"8537",56,2,115,58,17953691,17957245,3554
"8646",56,6,59,59,17959781,17963134,3353
"8732",56,6,125,60,17965566,17968454,2888
"8844",56,3,44,61,17970972,17973076,2104
"9038",56,3,128,62,17977900,17981540,3640
"9142",56,4,45,63,17984175,17986005,1830
"9343",56,2,91,64,17991175,17993280,2105
"9435",56,4,3,65,17995705,17998358,2653
"9635",56,2,103,66,18047140,18049787,2647
"9736",56,5,22,67,18052304,18055277,2973
"9944",56,3,92,68,18065795,18069285,3490
"10042",56,3,56,69,18071671,18075324,3653
"10167",56,6,23,70,18078096,18080331,2235
"10343",56,6,89,71,18085561,18088051,2490
"10436",56,2,109,72,18090417,18093430,3013
"10540",56,5,4,73,18096137,18099117,2980
"10743",56,1,12,74,18104961,18106817,1856
"10946",56,4,129,75,18112693,18115771,3078
"11034",56,5,10,76,18118491,18120634,2143
"11239",56,2,67,77,18126740,18128511,1771
"11338",56,2,79,78,18131708,18135439,3731
"11446",56,5,58,79,18137996,18140655,2659
"11533",56,6,29,80,18142911,18145335,2424
"11744",56,2,43,81,18150970,18153532,2562
"11938",56,3,134,82,18158592,18161343,2751
"12038",56,1,108,83,18164010,18168030,4020
"12156",56,5,70,84,18170508,18173298,2790
"12244",56,4,39,85,18176325,18179436,3111
"12438",56,1,120,86,18184933,18191901,6968
"12540",56,6,77,87,18194516,18196476,1960
"12633",56,4,93,88,18198732,18200620,1888
"12739",56,2,7,89,18203216,18208052,4836
"12944",56,6,47,90,18214746,18216654,1908
"13153",56,2,31,91,18222420,18225243,2823
"13338",56,1,30,92,18230381,18232282,1901
"13538",56,2,133,93,18237028,18238858,1830
"13639",56,6,5,94,18241512,18243388,1876
"13834",56,5,106,95,18249278,18251257,1979
"13940",56,1,24,96,18253735,18257094,3359
"14158",56,6,35,97,18263239,18266017,2778
"14343",56,6,53,98,18271142,18273690,2548
"14538",56,6,131,99,18278796,18280854,2058
"14639",56,1,66,100,18283391,18285933,2542
"14737",56,3,104,101,18288973,18291691,2718
"14838",56,6,17,102,18298536,18301901,3365
"15043",56,1,132,103,18307308,18310333,3025
"15154",56,5,94,104,18312955,18314987,2032
"15242",56,3,20,105,18318040,18319563,1523
"15442",56,5,46,106,18325256,18327236,1980
"15640",56,5,130,107,18334290,18336825,2535
"15743",56,1,114,108,18339238,18342290,3052
"15841",56,2,49,109,18345003,18347676,2673
"16045",56,3,80,110,18353749,18355428,1679
"16143",56,6,11,111,18358278,18359997,1719
"16339",56,3,122,112,18365848,18368036,2188
"16442",56,4,27,113,18371227,18373122,1895
"16641",56,1,48,114,18377842,18379044,1202
"16840",56,3,68,115,18386091,18388162,2071
"16940",56,3,2,116,18390744,18392443,1699
"17154",56,5,34,117,18398033,18399940,1907
"17338",56,3,62,118,18405085,18407320,2235
"17438",56,6,101,119,18409948,18412739,2791
"17537",56,3,98,120,18415341,18418386,3045
"17644",56,4,51,121,18421452,18423661,2209
"17842",56,5,82,122,18428825,18431256,2431
"17939",56,5,52,123,18433832,18436172,2340
"18161",56,4,81,124,18441892,18444211,2319
"18239",56,3,74,125,18447421,18449460,2039
"18338",56,6,119,126,18452448,18455291,2843
"18439",56,1,6,127,18458272,18460696,2424
"18638",56,4,33,128,18465828,18468285,2457
"18841",56,2,1,129,18473560,18475403,1843
"19038",56,5,76,130,18481345,18484221,2876
"19152",56,2,25,131,18487313,18489672,2359
"19343",56,1,84,132,18494601,18497248,2647
"19437",56,6,107,133,18500595,18502385,1790
"19537",56,4,21,134,18504608,18506503,1895
"19742",56,1,138,135,18511792,18514209,2417
"19834",56,2,55,136,18516544,18518079,1535
"19946",56,4,57,137,18520387,18522491,2104
"20035",56,1,36,138,18526263,18527890,1627
"10168",57,6,28,1,19908590,19911799,3209
"12157",57,5,123,2,19916846,19922734,5888
"13154",57,2,60,3,19925447,19929342,3895
"14159",57,1,77,4,19931526,19936997,5471
"15155",57,1,83,5,19939546,19942860,3314
"16144",57,4,116,6,19945619,19948886,3267
"17155",57,2,102,7,19951233,19955710,4477
"18162",57,1,17,8,19958090,19964966,6876
"2048",57,3,43,9,19969797,19974796,4999
"2242",57,6,76,10,19979098,19984058,4960
"2341",57,2,78,11,19986406,19991497,5091
"2440",57,6,10,12,19994530,20000746,6216
"2644",57,3,13,13,20006466,20012459,5993
"2838",57,4,122,14,20017649,20020721,3072
"2946",57,4,44,15,20022983,20025427,2444
"3143",57,6,64,16,20029892,20034925,5033
"3233",57,1,53,17,20037193,20040585,3392
"3442",57,3,109,18,20045089,20051723,6634
"3539",57,3,85,19,20054011,20057553,3542
"3641",57,2,36,20,20060025,20062587,2562
"3840",57,3,127,21,20068450,20074443,5993
"3940",57,2,42,22,20077366,20081660,4294
"4146",57,2,66,23,20086164,20094066,7902
"4241",57,5,39,24,20096759,20100903,4144
"4443",57,1,95,25,20106342,20113747,7405
"4533",57,5,33,26,20116264,20119786,3522
"4740",57,5,3,27,20125245,20130369,5124
"4938",57,4,62,28,20136082,20140095,4013
"5044",57,5,87,29,20142200,20147344,5144
"5138",57,6,136,30,20149560,20154044,4484
"5244",57,6,124,31,20156561,20158796,2235
"5339",57,5,9,32,20161188,20164116,2928
"5541",57,1,11,33,20169483,20173522,4039
"5738",57,6,22,34,20178882,20185595,6713
"5940",57,1,89,35,20190197,20198700,8503
"6043",57,6,112,36,20201100,20205367,4267
"6138",57,4,104,37,20207623,20212440,4817
"6242",57,1,107,38,20214728,20217303,2575
"6338",57,6,106,39,20219454,20221878,2424
"6437",57,4,8,40,20224389,20230166,5777
"6639",57,5,75,41,20237952,20246814,8862
"6739",57,5,45,42,20249188,20257809,8621
"6940",57,3,55,43,20262326,20265384,3058
"7041",57,3,133,44,20268372,20272208,3836
"7141",57,5,99,45,20274379,20278006,3627
"7236",57,2,48,46,20280177,20282039,1862
"7444",57,3,31,47,20286994,20291634,4640
"7648",57,1,113,48,20297269,20301138,3869
"7740",57,2,132,49,20303244,20307413,4169
"7845",57,2,54,50,20309571,20312688,3117
"8039",57,3,97,51,20317833,20322172,4339
"8137",57,2,126,52,20324330,20328081,3751
"8246",57,4,38,53,20330278,20335840,5562
"8432",57,3,25,54,20340664,20346919,6255
"8647",57,1,47,55,20352907,20356358,3451
"8845",57,2,12,56,20361110,20363744,2634
"9039",57,3,121,57,20369071,20373038,3967
"9143",57,4,32,58,20375333,20378647,3314
"9344",57,2,30,59,20384027,20387255,3228
"9537",57,4,20,60,20394439,20397981,3542
"9737",57,2,114,61,20403093,20407184,4091
"9842",57,2,96,62,20409323,20413950,4627
"9945",57,4,68,63,20416114,20420310,4196
"10043",57,4,86,64,20422500,20428055,5555
"10169",57,6,46,65,20430409,20433631,3222
"10344",57,1,29,66,20460542,20467195,6653
"10541",57,1,131,67,20471621,20474529,2908
"10642",57,1,119,68,20476883,20481124,4241
"10744",57,6,4,69,20486707,20489817,3110
"10947",57,2,120,70,20494067,20497367,3300
"11035",57,5,93,71,20499760,20503086,3326
"11158",57,5,129,72,20505394,20509008,3614
"11240",57,4,110,73,20511617,20514590,2973
"11339",57,4,134,74,20516905,20521068,4163
"11447",57,4,74,75,20523376,20526212,2836
"11534",57,2,138,76,20528389,20531016,2627
"11643",57,1,41,77,20533474,20536134,2660
"11843",57,5,105,78,20544429,20550174,5745
"11939",57,3,73,79,20552417,20559430,7013
"12039",57,5,15,80,20561548,20564332,2784
"12245",57,3,103,81,20568823,20575320,6497
"12334",57,1,71,82,20577517,20581431,3914
"12439",57,5,51,83,20583746,20588458,4712
"12634",57,3,61,84,20593720,20597674,3954
"12740",57,4,80,85,20599989,20605642,5653
"12837",57,4,2,86,20607950,20616022,8072
"13037",57,4,128,87,20621997,20631376,9379
"13155",57,4,56,88,20633625,20636115,2490
"13241",57,5,57,89,20638638,20641991,3353
"13339",57,6,16,90,20644299,20647063,2764
"13539",57,4,92,91,20651522,20655207,3685
"13640",57,6,118,92,20657404,20659979,2575
"13745",57,3,67,93,20662130,20664469,2339
"13835",57,3,115,94,20666764,20669614,2850
"13941",57,2,18,95,20672490,20676562,4072
"14160",57,6,88,96,20682635,20685673,3038
"14241",57,4,98,97,20687792,20690543,2751
"14344",57,6,58,98,20694982,20699511,4529
"14441",57,4,50,99,20701662,20704537,2875
"14640",57,1,35,100,20710199,20712636,2437
"14839",57,3,49,101,20720369,20724905,4536
"15044",57,4,14,102,20729121,20732866,3745
"15243",57,1,5,103,20740442,20746011,5569
"15443",57,5,111,104,20751424,20754430,3006
"15534",57,2,24,105,20758509,20763365,4856
"15744",57,3,1,106,20771418,20775843,4425
"15933",57,2,90,107,20781491,20784889,3398
"16046",57,2,6,108,20791112,20796550,5438
"16240",57,5,63,109,20801054,20803681,2627
"16340",57,6,130,110,20805819,20809819,4000
"16443",57,5,21,111,20817271,20823866,6595
"16642",57,2,72,112,20842521,20849541,7020
"16741",57,3,79,113,20851705,20854064,2359
"16841",57,6,70,114,20856182,20861371,5189
"16941",57,1,23,115,20868255,20872143,3888
"17156",57,4,26,116,20876902,20880693,3791
"17339",57,6,94,117,20886452,20893217,6765
"17439",57,2,84,118,20895355,20900871,5516
"17538",57,5,27,119,20903087,20905681,2594
"17739",57,5,81,120,20910467,20917819,7352
"17843",57,2,108,121,20923121,20928716,5595
"17940",57,1,101,122,20930867,20933932,3065
"18038",57,5,117,123,20936246,20941011,4765
"18163",57,1,137,124,20946953,20949802,2849
"18240",57,3,37,125,20952104,20958162,6058
"18440",57,6,100,126,20963294,20966810,3516
"18540",57,5,69,127,20970320,20976484,6164
"18639",57,5,135,128,20978850,20982706,3856
"18739",57,6,82,129,20985079,20988752,3673
"18842",57,3,19,130,20991119,20994942,3823
"19039",57,6,40,131,21002113,21004864,2751
"19244",57,6,52,132,21009898,21013264,3366
"19438",57,3,7,133,21017879,21023643,5764
"19639",57,1,59,134,21029579,21032102,2523
"19743",57,6,34,135,21034978,21040599,5621
"19947",57,1,65,136,21046103,21048992,2889
"20036",57,3,91,137,21051626,21056521,4895
"20141",57,1,125,138,21058725,21064470,5745
"10170",58,6,69,1,22343947,22348790,4843
"11159",58,3,78,2,22352340,22359555,7215
"12158",58,4,25,3,22362301,22368464,6163
"14161",58,6,9,4,22374250,22379243,4993
"16145",58,3,6,5,22385773,22391067,5294
"18164",58,4,127,6,22396650,22402146,5496
"19153",58,5,32,7,22405389,22408755,3366
"2147",58,2,113,8,22415350,22420056,4706
"2243",58,3,114,9,22422665,22428507,5842
"2342",58,3,90,10,22431528,22439129,7601
"2441",58,6,129,11,22441744,22450849,9105
"2540",58,4,43,12,22453418,22456640,3222
"2738",58,5,68,13,22462197,22466647,4450
"2839",58,4,97,14,22469145,22472837,3692
"2947",58,1,124,15,22475224,22478439,3215
"3041",58,4,85,16,22480865,22485544,4679
"3144",58,6,33,17,22488048,22493492,5444
"3342",58,4,67,18,22502585,22505303,2718
"3443",58,1,34,19,22507840,22516415,8575
"3642",58,2,23,20,22523717,22527122,3405
"3841",58,3,108,21,22532430,22542443,10013
"3941",58,2,137,22,22546562,22549705,3143
"4041",58,6,87,23,22552549,22557562,5013
"4147",58,1,112,24,22560961,22565857,4896
"4242",58,3,12,25,22568772,22573870,5098
"4444",58,4,133,26,22579172,22582119,2947
"4534",58,2,95,27,22584747,22594120,9373
"4641",58,5,50,28,22597049,22602696,5647
"4838",58,4,37,29,22612226,22617729,5503
"5045",58,6,27,30,22623907,22628063,4156
"5245",58,2,17,31,22634123,22643744,9621
"5445",58,3,102,32,22649549,22653503,3954
"5542",58,2,53,33,22656111,22659510,3399
"5739",58,3,138,34,22664909,22668046,3137
"5838",58,5,98,35,22670590,22673602,3012
"5941",58,2,131,36,22676956,22679818,2862
"6044",58,2,11,37,22682760,22687394,4634
"6243",58,4,49,38,22693238,22697793,4555
"6438",58,4,103,39,22702729,22710127,7398
"6547",58,6,99,40,22712991,22718193,5202
"6640",58,4,31,41,22720593,22729782,9189
"6840",58,5,2,42,22736842,22743711,6869
"7042",58,6,39,43,22751327,22761418,10091
"7237",58,1,100,44,22768485,22772909,4424
"7344",58,4,61,45,22775322,22779701,4379
"7445",58,6,15,46,22782094,22790198,8104
"7649",58,1,70,47,22796983,22807265,10282
"7741",58,4,121,48,22809978,22816788,6810
"7846",58,3,36,49,22819044,22822873,3829
"8040",58,5,8,50,22829012,22832031,3019
"8247",58,1,88,51,22839254,22848248,8994
"8344",58,3,60,52,22850549,22857660,7111
"8433",58,4,7,53,22860145,22864576,4431
"8648",58,4,109,54,22872093,22877054,4961
"8733",58,3,18,55,22880656,22886152,5496
"8936",58,5,62,56,22896147,22902192,6045
"9040",58,6,105,57,22904487,22907304,2817
"9144",58,1,16,58,22910083,22912722,2639
"9345",58,3,96,59,22917547,22924887,7340
"9436",58,6,93,60,22927443,22931462,4019
"9538",58,5,74,61,22935483,22940718,5235
"9636",58,6,135,62,22943503,22950222,6719
"9738",58,4,55,63,22952850,22955274,2424
"9843",58,2,65,64,22958674,22961798,3124
"9946",58,5,38,65,22964158,22968687,4529
"10171",58,5,86,66,23017129,23024011,6882
"10239",58,1,46,67,23026593,23029796,3203
"10437",58,3,132,68,23036548,23043516,6968
"10542",58,1,40,69,23046150,23053013,6863
"10745",58,6,57,70,23058432,23061327,2895
"10836",58,2,71,71,23063766,23067524,3758
"10948",58,6,21,72,23070100,23081851,11751
"11160",58,6,45,73,23086878,23089963,3085
"11340",58,5,56,74,23096513,23103585,7072
"11448",58,4,91,75,23105860,23110147,4287
"11535",58,1,22,76,23113187,23120762,7575
"11745",58,2,59,77,23126358,23133626,7268
"11844",58,5,104,78,23136280,23143444,7164
"11940",58,2,83,79,23145902,23155654,9752
"12040",58,2,5,80,23158216,23165164,6948
"12246",58,6,117,81,23170982,23175112,4130
"12335",58,1,28,82,23177669,23182361,4692
"12541",58,6,81,83,23189833,23193891,4058
"12635",58,1,118,84,23196886,23201382,4496
"12741",58,4,13,85,23203919,23208932,5013
"12945",58,4,1,86,23215142,23219449,4307
"13156",58,5,128,87,23225430,23229064,3634
"13242",58,4,115,88,23231496,23240123,8627
"13340",58,6,51,89,23242666,23248104,5438
"13540",58,1,10,90,23253903,23259968,6065
"13746",58,2,41,91,23265890,23274733,8843
"13942",58,6,111,92,23279904,23294780,14876
"14043",58,4,19,93,23316273,23322416,6143
"14242",58,6,63,94,23331594,23341607,10013
"14345",58,3,126,95,23348294,23355575,7281
"14442",58,1,136,96,23488166,23493303,5137
"14539",58,6,75,97,23495749,23503042,7293
"14641",58,5,44,98,23505436,23508383,2947
"14840",58,1,106,99,23513998,23518671,4673
"14941",58,5,92,100,23520992,23526410,5418
"15045",58,3,72,101,23528725,23534901,6176
"15156",58,3,48,102,23538575,23540248,1673
"15336",58,5,134,103,23546098,23550758,4660
"15444",58,2,77,104,23553347,23558660,5313
"15535",58,5,116,105,23561067,23566687,5620
"15641",58,2,29,106,23569002,23574296,5294
"15842",58,5,14,107,23580048,23589506,9458
"16047",58,1,130,108,23598187,23603526,5339
"16146",58,5,122,109,23605900,23608775,2875
"16241",58,5,110,110,23611691,23613873,2182
"16341",58,2,119,111,23616044,23628528,12484
"16444",58,2,107,112,23630954,23633999,3045
"16539",58,2,47,113,23636379,23639149,2770
"16742",58,5,20,114,23644070,23646045,1975
"16942",58,1,4,115,23651524,23654647,3123
"17157",58,2,35,116,23659785,23662837,3052
"17340",58,1,64,117,23669093,23673269,4176
"17440",58,3,30,118,23676081,23679204,3123
"17645",58,1,58,119,23683604,23686427,2823
"17740",58,3,42,120,23690526,23693905,3379
"17941",58,2,101,121,23703102,23711135,8033
"18039",58,3,84,122,23713495,23717828,4333
"18165",58,6,123,123,23720090,23724103,4013
"18241",58,2,125,124,23726646,23732862,6216
"18339",58,1,76,125,23735307,23738973,3666
"18441",58,5,26,126,23742144,23746156,4012
"18640",58,3,54,127,23751903,23755758,3855
"18843",58,6,3,128,23763387,23768759,5372
"19040",58,2,89,129,23773643,23780263,6620
"19154",58,1,52,130,23782950,23786930,3980
"19344",58,3,120,131,23793239,23800095,6856
"19439",58,5,80,132,23802697,23810155,7458
"19538",58,1,94,133,23812534,23825698,13164
"19640",58,3,66,134,23828117,23836783,8666
"19744",58,4,79,135,23839268,23844013,4745
"19835",58,1,82,136,23846785,23850876,4091
"19948",58,4,73,137,23854223,23859445,5222
"20037",58,3,24,138,23862132,23867583,5451
"10172",59,4,138,1,24574564,24577884,3320
"11161",59,6,32,2,24582166,24585519,3353
"13157",59,3,53,3,24594514,24597931,3417
"15157",59,2,22,4,24603017,24606474,3457
"17158",59,6,92,5,24613038,24615919,2881
"18166",59,4,12,6,24620090,24622528,2438
"2049",59,3,89,7,24628353,24632914,4561
"2148",59,6,14,8,24636601,24641222,4621
"2343",59,5,31,9,24646615,24649817,3202
"2541",59,5,49,10,24654557,24657733,3176
"2739",59,3,77,11,24684801,24688022,3221
"2840",59,2,4,12,24690716,24692951,2235
"3042",59,5,43,13,24699011,24702762,3751
"3234",59,1,135,14,24708658,24712364,3706
"3343",59,2,124,15,24715364,24717541,2177
"3444",59,3,125,16,24720319,24723096,2777
"3540",59,2,64,17,24729143,24731809,2666
"3643",59,1,33,18,24740948,24744385,3437
"3842",59,5,91,19,24772146,24775512,3366
"3942",59,3,71,20,24777878,24780872,2994
"4042",59,2,28,21,24783297,24786584,3287
"4243",59,4,42,22,24796618,24800010,3392
"4445",59,4,132,23,24806135,24809762,3627
"4535",59,2,40,24,24813423,24816416,2993
"4741",59,2,88,25,24824868,24828600,3732
"4839",59,6,104,26,24831699,24835117,3418
"4939",59,4,6,27,24838007,24842425,4418
"5139",59,1,93,28,24847197,24849739,2542
"5246",59,2,130,29,24852550,24855602,3052
"5340",59,4,90,30,24859786,24863178,3392
"5446",59,1,45,31,24872891,24875584,2693
"5647",59,5,79,32,24883892,24887892,4000
"5740",59,5,13,33,24890389,24893376,2987
"5942",59,4,66,34,24899560,24901964,2404
"6045",59,5,67,35,24906822,24909082,2260
"6139",59,5,73,36,24927372,24930555,3183
"6244",59,5,85,37,24933810,24936679,2869
"6339",59,1,51,38,24939334,24941497,2163
"6548",59,5,55,39,24950439,24952883,2444
"6641",59,2,34,40,24957145,24960295,3150
"6841",59,4,18,41,24966675,24969113,2438
"7043",59,3,11,42,24974244,24977107,2863
"7238",59,1,117,43,24982519,24984715,2196
"7345",59,6,68,44,24988513,24991487,2974
"7446",59,5,103,45,24994095,24996990,2895
"7544",59,1,15,46,25004174,25006455,2281
"7742",59,6,20,47,25014397,25016645,2248
"7941",59,3,59,48,25021692,25024535,2843
"8041",59,4,96,49,25027013,25030391,3378
"8138",59,5,115,50,25037020,25038751,1731
"8248",59,3,47,51,25041556,25043464,1908
"8434",59,5,133,52,25048432,25051281,2849
"8538",59,2,82,53,25054661,25057125,2464
"8649",59,5,7,54,25059492,25062472,2980
"8846",59,1,39,55,25068486,25071498,3012
"9041",59,2,118,56,25076715,25079950,3235
"9145",59,2,106,57,25082879,25085186,2307
"9241",59,3,5,58,25088075,25091166,3091
"9437",59,1,63,59,25097050,25100134,3084
"9539",59,1,69,60,25102723,25105063,2340
"9637",59,5,121,61,25107789,25110037,2248
"9739",59,3,83,62,25113097,25115129,2032
"9844",59,4,120,63,25123065,25125306,2241
"9947",59,1,105,64,25127856,25129568,1712
"10044",59,4,126,65,25133098,25136862,3764
"10173",59,1,75,66,25182663,25185964,3301
"10240",59,3,101,67,25188435,25190585,2150
"10345",59,6,128,68,25193350,25196735,3385
"10438",59,3,17,69,25199318,25201814,2496
"10643",59,6,134,70,25206684,25209128,2444
"10746",59,1,27,71,25211286,25213841,2555
"10949",59,1,3,72,25219260,25221345,2085
"11162",59,4,24,73,25227621,25230783,3162
"11341",59,5,25,74,25235621,25238509,2888
"11536",59,3,23,75,25243746,25246700,2954
"11746",59,4,54,76,25252021,25254700,2679
"11941",59,2,52,77,25261440,25263949,2509
"12159",59,4,108,78,25268885,25271819,2934
"12247",59,5,1,79,25274414,25277205,2791
"12440",59,2,76,80,25284226,25287826,3600
"12542",59,1,123,81,25290520,25293029,2509
"12636",59,6,50,82,25295514,25297428,1914
"12838",59,6,62,83,25302436,25304546,2110
"12946",59,2,94,84,25306678,25309442,2764
"13038",59,3,107,85,25312293,25315299,3006
"13158",59,5,109,86,25336249,25339882,3633
"13243",59,2,136,87,25342628,25345543,2915
"13341",59,1,81,88,25348779,25351419,2640
"13440",59,5,19,89,25354217,25356269,2052
"13641",59,4,84,90,25382114,25385323,3209
"13747",59,2,10,91,25387820,25390689,2869
"13943",59,3,29,92,25396128,25399651,3523
"14162",59,6,38,93,25406279,25409220,2941
"14346",59,3,113,94,25413881,25416142,2261
"14443",59,4,72,95,25418529,25421535,3006
"14540",59,3,65,96,25424490,25427391,2901
"14642",59,6,86,97,25431457,25433653,2196
"14738",59,6,80,98,25435928,25438457,2529
"14841",59,1,87,99,25441438,25445686,4248
"14942",59,1,57,100,25448485,25450974,2489
"15046",59,1,21,101,25458400,25461635,3235
"15244",59,6,74,102,25470735,25474257,3522
"15337",59,6,110,103,25479670,25481898,2228
"15445",59,6,44,104,25484297,25486833,2536
"15642",59,6,122,105,25498285,25500533,2248
"15745",59,2,70,106,25540001,25543333,3332
"15843",59,3,131,107,25545766,25548380,2614
"15934",59,6,26,108,25555093,25557602,2509
"16147",59,4,36,109,25562760,25565296,2536
"16342",59,5,61,110,25570852,25573205,2353
"16445",59,3,41,111,25576232,25579421,3189
"16643",59,4,78,112,25586003,25588363,2360
"16743",59,6,98,113,25590971,25596853,5882
"16842",59,2,100,114,25599946,25603592,3646
"16943",59,4,60,115,25606757,25609540,2783
"17042",59,1,9,116,25617130,25620280,3150
"17242",59,4,48,117,25626843,25628437,1594
"17441",59,6,2,118,25634883,25637274,2391
"17646",59,3,137,119,25643328,25646223,2895
"17741",59,1,99,120,25648602,25651327,2725
"17844",59,1,111,121,25653916,25656099,2183
"17942",59,4,102,122,25658466,25661106,2640
"18040",59,2,46,123,25663963,25666511,2548
"18242",59,3,95,124,25677134,25680421,3287
"18340",59,5,97,125,25686794,25688997,2203
"18442",59,4,114,126,25691651,25693631,1980
"18541",59,5,127,127,25699004,25701167,2163
"18641",59,3,35,128,25705534,25708580,3046
"18844",59,3,119,129,25720836,25724012,3176
"18938",59,6,116,130,25726699,25730097,3398
"19041",59,2,112,131,25733876,25737000,3124
"19155",59,1,129,132,25740870,25744111,3241
"19245",59,2,16,133,25747903,25750151,2248
"19440",59,6,56,134,25756028,25759570,3542
"19539",59,6,8,135,25764074,25767152,3078
"19745",59,4,30,136,25773205,25775617,2412
"19949",59,2,58,137,25780271,25783473,3202
"20038",59,5,37,138,25791324,25795128,3804
"10174",60,1,104,1,1080589,1081961,1372
"11163",60,5,126,2,1084582,1089530,4948
"12160",60,2,45,3,1092054,1093805,1751
"14163",60,5,6,4,1098440,1100825,2385
"16148",60,4,5,5,1106211,1108315,2104
"18167",60,5,42,6,1113493,1117153,3660
"2050",60,6,85,7,1122180,1124212,2032
"2149",60,6,79,8,1126402,1128369,1967
"2244",60,1,44,9,1130847,1132232,1385
"2442",60,3,76,10,1136900,1139161,2261
"2542",60,5,114,11,1141743,1144697,2954
"2645",60,3,118,12,1147436,1149129,1693
"2740",60,6,37,13,1152607,1154135,1528
"2948",60,5,120,14,1158999,1160848,1849
"3043",60,6,133,15,1163248,1164986,1738
"3145",60,1,116,16,1167261,1169483,2222
"3235",60,6,103,17,1172033,1173352,1319
"3344",60,2,75,18,1175843,1177666,1823
"3445",60,5,90,19,1180014,1182150,2136
"3541",60,1,8,20,1184661,1186177,1516
"3738",60,5,108,21,1192367,1194563,2196
"3843",60,3,106,22,1196864,1198936,2072
"3943",60,6,55,23,1201570,1202818,1248
"4043",60,5,54,24,1205355,1207466,2111
"4244",60,1,80,25,1212493,1214643,2150
"4337",60,4,107,26,1217990,1220166,2176
"4446",60,3,40,27,1224036,1225748,1712
"4642",60,2,81,28,1232004,1234075,2071
"4742",60,2,39,29,1236873,1239200,2327
"4940",60,2,117,30,1244005,1245305,1300
"5046",60,3,28,31,1248678,1250893,2215
"5247",60,1,2,32,1256032,1257587,1555
"5447",60,2,63,33,1263182,1264953,1771
"5543",60,4,119,34,1267372,1270123,2751
"5648",60,5,30,35,1272804,1274568,1764
"5839",60,3,64,36,1279164,1281614,2450
"5943",60,6,31,37,1284164,1286314,2150
"6140",60,1,56,38,1291282,1293857,2575
"6245",60,1,110,39,1296224,1297942,1718
"6340",60,4,53,40,1300819,1302230,1411
"6549",60,2,57,41,1307525,1308969,1444
"6642",60,3,94,42,1312009,1314048,2039
"6740",60,1,92,43,1316898,1319787,2889
"6842",60,2,93,44,1322167,1324591,2424
"6941",60,6,13,45,1327317,1329095,1778
"7142",60,1,38,46,1334586,1336304,1718
"7346",60,5,24,47,1341259,1344174,2915
"7545",60,1,14,48,1349273,1351024,1751
"7743",60,2,15,49,1356450,1357756,1306
"7942",60,3,130,50,1362503,1365384,2881
"8042",60,4,71,51,1367941,1370176,2235
"8139",60,1,98,52,1373405,1375254,1849
"8249",60,2,105,53,1377830,1379457,1627
"8345",60,6,67,54,1381785,1383824,2039
"8435",60,2,33,55,1386419,1387503,1084
"8650",60,2,123,56,1393289,1395746,2457
"8734",60,5,12,57,1398080,1399609,1529
"8937",60,3,124,58,1404590,1405806,1216
"9042",60,6,109,59,1408303,1410198,1895
"9146",60,2,69,60,1412833,1414139,1306
"9242",60,2,99,61,1416578,1417806,1228
"9346",60,6,25,62,1420114,1421545,1431
"9540",60,4,41,63,1426330,1427637,1307
"9740",60,6,61,64,1432670,1433801,1131
"9845",60,4,35,65,1436442,1437637,1195
"10045",60,1,68,66,1469026,1470293,1267
"10175",60,3,88,67,1472869,1474574,1705
"10241",60,1,20,68,1477072,1478470,1398
"10439",60,1,50,69,1483994,1485033,1039
"10644",60,4,23,70,1492151,1494412,2261
"10837",60,6,73,71,1499479,1500602,1123
"10950",60,5,48,72,1503283,1504152,869
"11164",60,3,46,73,1509656,1511348,1692
"11342",60,3,34,74,1516924,1519277,2353
"11537",60,1,74,75,1525788,1527702,1914
"11644",60,3,22,76,1530527,1531970,1443
"11845",60,5,18,77,1536638,1538160,1522
"12041",60,3,70,78,1543044,1544475,1431
"12161",60,2,111,79,1546887,1548331,1444
"12248",60,6,49,80,1551397,1552652,1255
"12441",60,5,66,81,1557260,1559194,1934
"12543",60,1,134,82,1561627,1563182,1555
"12637",60,1,32,83,1565777,1567365,1588
"12839",60,2,135,84,1572287,1574980,2693
"12947",60,2,21,85,1577477,1578928,1451
"13159",60,5,36,86,1584027,1585595,1568
"13342",60,4,29,87,1590864,1592386,1522
"13541",60,1,26,88,1596910,1598190,1280
"13748",60,5,96,89,1603577,1605021,1444
"13836",60,4,11,90,1607492,1608681,1189
"14044",60,4,17,91,1616428,1618270,1842
"14243",60,1,122,92,1622912,1623983,1071
"14347",60,6,127,93,1626572,1627702,1130
"14444",60,2,9,94,1630383,1631507,1124
"14643",60,6,7,95,1636370,1637611,1241
"14842",60,5,78,96,1643076,1644827,1751
"14943",60,3,112,97,1647299,1648377,1078
"15047",60,2,27,98,1650678,1652031,1353
"15245",60,3,100,99,1656855,1658358,1503
"15338",60,3,136,100,1661339,1662437,1098
"15446",60,4,65,101,1664901,1665933,1032
"15536",60,5,132,102,1668379,1669796,1417
"15643",60,4,59,103,1672059,1673679,1620
"15746",60,4,83,104,1676052,1677725,1673
"15844",60,1,86,105,1679987,1681163,1176
"15935",60,6,91,106,1683615,1685830,2215
"16048",60,3,10,107,1688720,1691203,2483
"16242",60,4,47,108,1698106,1700197,2091
"16446",60,1,128,109,1705250,1707838,2588
"16540",60,3,16,110,1710525,1711701,1176
"16744",60,3,52,111,1716794,1718427,1633
"16944",60,6,115,112,1723801,1724794,993
"17043",60,4,137,113,1727232,1728526,1294
"17159",60,5,102,114,1731102,1732676,1574
"17243",60,6,19,115,1735135,1736598,1463
"17442",60,6,1,116,1741468,1742925,1457
"17647",60,3,82,117,1748351,1750037,1686
"17742",60,6,121,118,1752842,1753723,881
"17845",60,5,72,119,1755946,1757155,1209
"17943",60,3,4,120,1759457,1760757,1300
"18168",60,1,62,121,1766300,1767973,1673
"18243",60,4,101,122,1770889,1772470,1581
"18341",60,5,84,123,1776549,1777601,1052
"18443",60,2,129,124,1779955,1780974,1019
"18542",60,2,87,125,1783746,1785660,1914
"18642",60,6,97,126,1788184,1789432,1248
"18740",60,4,95,127,1793034,1795380,2346
"18845",60,4,131,128,1797864,1799400,1536
"18939",60,4,125,129,1802093,1802746,653
"19042",60,5,138,130,1805087,1806642,1555
"19156",60,3,58,131,1809133,1810498,1365
"19246",60,4,89,132,1812715,1814741,2026
"19345",60,4,77,133,1817035,1818708,1673
"19441",60,6,43,134,1820761,1822493,1732
"19641",60,2,3,135,1827951,1830500,2549
"19836",60,2,51,136,1835919,1837448,1529
"20039",60,5,60,137,1842325,1843664,1339
"20142",60,4,113,138,1846103,1847416,1313
