"","sub","cond","item","seq","start_time","end_time","duration_ms"
"10",1,6,30,1,413448,417121,3673
"12",1,4,100,2,425436,429175,3739
"13",1,5,137,3,431633,437404,5771
"14",1,3,117,4,440051,444666,4615
"15",1,1,31,5,447196,450300,3104
"17",1,2,8,6,455490,460961,5471
"19",1,2,26,7,465700,469256,3556
"21",1,2,2,8,477453,483453,6000
"23",1,4,46,9,489029,503807,14778
"25",1,1,97,10,509043,511356,2313
"26",1,3,21,11,513756,517435,3679
"28",1,1,121,12,523050,527331,4281
"29",1,1,127,13,530136,533109,2973
"30",1,6,84,14,535823,538358,2535
"31",1,4,16,15,540594,545104,4510
"33",1,2,92,16,550673,558700,8027
"34",1,4,4,17,561328,567419,6091
"36",1,4,22,18,571701,575491,3790
"38",1,5,125,19,582793,585819,3026
"39",1,2,32,20,588480,594381,5901
"41",1,2,74,21,599690,603774,4084
"42",1,6,42,22,606363,611356,4993
"44",1,5,5,23,616730,620834,4104
"46",1,2,80,24,627567,636195,8628
"47",1,4,40,25,638777,645836,7059
"49",1,6,72,26,651490,656739,5249
"50",1,4,136,27,658981,664602,5621
"51",1,1,67,28,666929,669158,2229
"52",1,1,91,29,672740,676845,4105
"53",1,1,73,30,679806,682819,3013
"54",1,3,75,31,685277,688532,3255
"55",1,4,70,32,690794,693748,2954
"56",1,2,110,33,696075,700748,4673
"57",1,3,27,34,703357,706892,3535
"59",1,3,105,35,712050,717050,5000
"60",1,3,3,36,719495,722514,3019
"62",1,6,6,37,727561,735652,8091
"64",1,1,19,38,740189,745307,5118
"66",1,1,85,39,752098,757092,4994
"67",1,2,122,40,759452,762438,2986
"68",1,4,88,41,764714,767400,2686
"69",1,2,98,42,769629,772505,2876
"70",1,2,38,43,775276,778381,3105
"72",1,3,93,44,785532,789780,4248
"73",1,2,68,45,792114,795532,3418
"74",1,4,52,46,797781,800683,2902
"76",1,5,77,47,807396,812089,4693
"77",1,4,94,48,814338,820017,5679
"78",1,2,134,49,822502,825593,3091
"79",1,3,123,50,827966,830809,2843
"80",1,1,13,51,833529,837888,4359
"82",1,1,61,52,846288,855392,9104
"83",1,4,28,53,857877,862818,4941
"85",1,1,115,54,867505,871420,3915
"86",1,1,43,55,873969,877649,3680
"88",1,3,15,56,882990,886153,3163
"90",1,4,58,57,890905,894395,3490
"91",1,6,18,58,896964,899533,2569
"93",1,6,114,59,904716,908076,3360
"94",1,1,1,60,910455,912762,2307
"96",1,2,20,61,917469,921737,4268
"98",1,2,86,62,927175,929842,2667
"99",1,1,7,63,932372,936927,4555
"101",1,5,95,64,942732,949595,6863
"102",1,1,79,65,952171,958576,6405
"103",1,4,76,66,1036882,1043032,6150
"104",1,2,50,67,1045589,1048830,3241
"106",1,5,83,68,1053504,1056818,3314
"107",1,3,51,69,1059465,1065008,5543
"109",1,6,36,70,1069943,1072884,2941
"111",1,4,106,71,1078185,1081610,3425
"112",1,3,69,72,1083931,1088153,4222
"113",1,1,49,73,1090742,1096075,5333
"115",1,1,103,74,1100867,1103736,2869
"116",1,3,111,75,1106580,1110031,3451
"117",1,6,12,76,1112645,1116410,3765
"119",1,5,11,77,1122790,1126835,4045
"121",1,3,129,78,1131313,1133575,2262
"122",1,6,96,79,1136150,1144726,8576
"123",1,5,53,80,1147059,1155105,8046
"125",1,6,54,81,1159198,1167766,8568
"127",1,1,109,82,1173323,1180735,7412
"128",1,6,60,83,1183552,1187389,3837
"129",1,6,108,84,1190134,1193997,3863
"130",1,1,37,85,1196252,1201030,4778
"132",1,4,64,86,1207959,1211560,3601
"133",1,1,25,87,1213933,1216338,2405
"135",1,2,104,88,1221718,1226947,5229
"136",1,6,66,89,1229607,1232823,3216
"137",1,3,87,90,1235405,1242222,6817
"138",1,5,89,91,1244752,1248072,3320
"139",1,5,65,92,1250380,1254798,4418
"140",1,4,112,93,1257021,1261877,4856
"141",1,2,44,94,1264250,1268662,4412
"143",1,3,57,95,1283278,1287036,3758
"144",1,5,35,96,1289880,1293108,3228
"146",1,3,33,97,1299344,1308109,8765
"148",1,2,128,98,1313855,1321273,7418
"149",1,5,113,99,1323516,1329529,6013
"150",1,4,124,100,1332098,1337961,5863
"151",1,5,41,101,1340229,1346536,6307
"153",1,3,135,102,1351714,1356321,4607
"154",1,6,90,103,1359100,1363237,4137
"155",1,5,131,104,1366238,1370192,3954
"156",1,6,126,105,1372748,1377440,4692
"157",1,6,102,106,1379794,1384251,4457
"158",1,4,34,107,1387128,1391200,4072
"160",1,6,138,108,1396272,1398848,2576
"161",1,3,39,109,1402390,1407024,4634
"163",1,6,48,110,1413188,1416221,3033
"165",1,4,130,111,1421411,1429595,8184
"166",1,3,45,112,1432268,1436333,4065
"168",1,5,17,113,1442288,1445798,3510
"170",1,2,56,114,1450675,1455040,4365
"171",1,6,120,115,1457904,1462440,4536
"172",1,3,99,116,1464774,1470597,5823
"173",1,5,59,117,1474624,1481931,7307
"174",1,1,55,118,1484102,1489311,5209
"175",1,5,29,119,1491599,1504142,12543
"177",1,5,71,120,1509992,1514064,4072
"178",1,3,63,121,1516300,1519646,3346
"179",1,4,118,122,1521869,1537078,15209
"180",1,1,133,123,1539831,1543765,3934
"181",1,2,14,124,1546197,1549655,3458
"183",1,3,9,125,1555152,1558459,3307
"185",1,6,132,126,1564048,1569179,5131
"186",1,3,81,127,1571532,1579009,7477
"187",1,5,119,128,1581690,1589324,7634
"188",1,6,78,129,1591828,1597259,5431
"189",1,5,101,130,1600005,1604175,4170
"190",1,5,47,131,1609927,1615169,5242
"192",1,2,62,132,1620209,1624947,4738
"193",1,5,23,133,1627569,1632052,4483
"195",1,4,10,134,1636883,1651550,14667
"197",1,6,24,135,1656211,1660649,4438
"199",1,5,107,136,1665924,1676212,10288
"200",1,4,82,137,1678566,1680742,2176
"201",1,2,116,138,1683017,1686062,3045
