"","subj","cond","item","start","end","duration_ms","duration_s","deg"
"7",1,6,14,1868017,1871801,3784,3.8,"0"
"9",1,7,31,1877869,1881905,4036,4,"20"
"11",1,2,26,1887379,1891139,3760,3.8,"0"
"13",1,5,45,1896003,1899555,3552,3.6,"20"
"14",1,6,22,1902090,1905691,3601,3.6,"0"
"16",1,2,66,1910944,1915931,4987,5,"0"
"17",1,4,60,1918197,1921197,3000,3,"0"
"18",1,5,29,1923216,1927069,3853,3.9,"20"
"20",1,5,37,1932288,1935842,3554,3.6,"20"
"21",1,3,27,1938436,1942688,4252,4.3,"20"
"23",1,3,11,1947817,1950700,2883,2.9,"20"
"25",1,8,40,1956810,1961206,4396,4.4,"0"
"26",1,7,47,1963490,1966338,2848,2.8,"20"
"27",1,6,54,1969512,1973437,3925,3.9,"0"
"28",1,7,79,1976344,1979873,3529,3.5,"20"
"29",1,5,61,1982449,1987346,4897,4.9,"20"
"30",1,8,16,1989140,1993830,4690,4.7,"0"
"32",1,7,15,1998721,2001737,3016,3,"20"
"34",1,8,24,2006991,2010263,3272,3.3,"0"
"36",1,3,59,2015646,2020206,4560,4.6,"20"
"37",1,1,65,2023434,2028921,5487,5.5,"20"
"38",1,1,33,2031244,2033860,2616,2.6,"20"
"39",1,8,56,2036896,2040205,3309,3.3,"0"
"40",1,8,80,2042522,2045624,3102,3.1,"0"
"41",1,4,20,2049110,2052341,3231,3.2,"0"
"43",1,4,12,2057968,2061493,3525,3.5,"0"
"45",1,4,44,2067182,2070447,3265,3.3,"0"
"46",1,2,42,2072964,2076558,3594,3.6,"0"
"47",1,8,64,2080631,2085093,4462,4.5,"0"
"48",1,6,30,2087781,2091332,3551,3.6,"0"
"50",1,6,70,2095971,2099825,3854,3.9,"0"
"51",1,2,18,2101839,2105801,3962,4,"0"
"53",1,1,57,2111088,2114950,3862,3.9,"20"
"54",1,5,77,2117079,2120967,3888,3.9,"20"
"55",1,5,53,2123870,2129279,5409,5.4,"20"
"56",1,2,50,2131199,2134600,3401,3.4,"0"
"57",1,1,1,2137364,2141347,3983,4,"20"
"59",1,1,73,2145836,2150217,4381,4.4,"20"
"60",1,7,7,2152368,2156500,4132,4.1,"20"
"62",1,5,21,2163254,2167420,4166,4.2,"20"
"64",1,8,32,2172090,2175847,3757,3.8,"0"
"66",1,3,75,2181119,2185558,4439,4.4,"20"
"67",1,7,23,2187638,2191207,3569,3.6,"20"
"69",1,1,41,2195427,2198215,2788,2.8,"20"
"70",1,1,49,2200302,2203172,2870,2.9,"20"
"71",1,7,55,2205193,2209533,4340,4.3,"20"
"72",1,6,6,2214264,2218978,4714,4.7,"0"
"74",1,7,71,2223681,2227225,3544,3.5,"20"
"75",1,2,10,2229737,2233885,4148,4.1,"0"
"77",1,4,36,2239583,2243419,3836,3.8,"0"
"78",1,4,52,2245142,2248560,3418,3.4,"0"
"79",1,5,69,2250383,2254185,3802,3.8,"20"
"80",1,6,62,2257146,2261350,4204,4.2,"0"
"81",1,3,19,2263335,2266346,3011,3,"20"
"83",1,2,2,2272453,2275290,2837,2.8,"0"
"85",1,3,35,2281672,2285649,3977,4,"20"
"86",1,2,74,2287488,2290998,3510,3.5,"0"
"87",1,3,67,2293218,2296999,3781,3.8,"20"
"88",1,4,4,2298853,2302971,4118,4.1,"0"
"90",1,6,78,2307246,2310977,3731,3.7,"0"
"91",1,8,8,2312798,2315809,3011,3,"0"
"93",1,3,3,2321858,2326239,4381,4.4,"20"
"95",1,6,38,2331455,2335317,3862,3.9,"0"
"96",1,6,46,2337198,2340391,3193,3.2,"0"
"97",1,1,9,2342219,2346040,3821,3.8,"20"
"99",1,3,51,2350371,2354439,4068,4.1,"20"
"100",1,7,39,2356878,2360174,3296,3.3,"20"
"101",1,2,34,2363221,2367265,4044,4,"0"
"102",1,3,43,2369217,2372795,3578,3.6,"20"
"103",1,5,13,2374812,2378558,3746,3.7,"20"
"105",1,4,76,2383041,2386880,3839,3.8,"0"
"106",1,1,25,2388982,2392229,3247,3.2,"20"
"108",1,1,17,2397225,2401407,4182,4.2,"20"
"110",1,4,28,2406243,2409670,3427,3.4,"0"
"112",1,8,48,2415778,2419464,3686,3.7,"0"
"113",1,7,63,2421721,2426034,4313,4.3,"20"
"114",1,5,5,2427775,2432318,4543,4.5,"20"
"116",1,2,58,2437355,2441135,3780,3.8,"0"
"117",1,8,72,2443000,2446608,3608,3.6,"0"
"118",1,4,68,2448636,2451826,3190,3.2,"0"
"73",2,5,52,3343283,3347377,4094,4.1,"20"
"8",2,3,18,3349582,3353358,3776,3.8,"20"
"10",2,7,14,3359318,3363609,4291,4.3,"20"
"12",2,8,71,3369287,3372512,3225,3.2,"0"
"131",2,3,74,3374722,3377902,3180,3.2,"20"
"141",2,7,38,3380754,3384519,3765,3.8,"20"
"15",2,8,15,3388455,3392451,3996,4,"0"
"171",2,4,35,3398422,3402862,4440,4.4,"0"
"181",2,2,17,3405014,3409128,4114,4.1,"0"
"201",2,3,2,3414738,3418545,3807,3.8,"20"
"22",2,2,73,3423764,3428501,4737,4.7,"0"
"231",2,1,24,3430319,3433969,3650,3.6,"20"
"251",2,4,11,3439145,3442660,3515,3.5,"0"
"271",2,5,4,3447721,3451139,3418,3.4,"20"
"291",2,1,8,3456788,3460827,4039,4,"20"
"31",2,1,16,3465818,3469714,3896,3.9,"20"
"33",2,8,63,3474055,3477379,3324,3.3,"0"
"341",2,2,49,3479303,3482891,3588,3.6,"0"
"35",2,5,36,3485024,3489020,3996,4,"20"
"361",2,6,13,3492165,3497279,5114,5.1,"0"
"381",2,4,67,3502191,3507154,4963,5,"0"
"391",2,8,23,3509264,3512545,3281,3.3,"0"
"411",2,7,54,3516872,3520647,3775,3.8,"20"
"42",2,8,31,3522927,3526149,3222,3.2,"0"
"44",2,2,25,3530523,3534088,3565,3.6,"0"
"461",2,1,64,3538590,3542032,3442,3.4,"20"
"471",2,5,68,3544213,3547422,3209,3.2,"20"
"481",2,7,6,3549191,3553194,4003,4,"20"
"501",2,6,45,3557657,3560347,2690,2.7,"0"
"511",2,5,20,3562082,3565406,3324,3.3,"20"
"531",2,8,7,3570445,3573556,3111,3.1,"0"
"551",2,5,44,3578829,3582618,3789,3.8,"20"
"561",2,2,41,3584403,3587947,3544,3.5,"0"
"571",2,4,19,3589758,3593744,3986,4,"0"
"591",2,8,47,3598597,3601376,2779,2.8,"0"
"601",2,4,51,3603281,3607020,3739,3.7,"0"
"61",2,2,57,3609081,3612497,3416,3.4,"0"
"621",2,6,21,3614484,3617784,3300,3.3,"0"
"641",2,6,61,3622713,3628405,5692,5.7,"0"
"65",2,6,53,3632039,3636388,4349,4.3,"0"
"661",2,7,70,3638350,3641890,3540,3.5,"20"
"671",2,6,37,3644211,3646797,2586,2.6,"0"
"68",2,1,32,3648962,3652373,3411,3.4,"20"
"701",2,6,69,3657004,3660661,3657,3.7,"0"
"711",2,8,55,3663194,3666788,3594,3.6,"0"
"721",2,5,12,3668585,3672527,3942,3.9,"20"
"741",2,3,42,3676725,3680972,4247,4.2,"20"
"751",2,7,78,3683222,3686844,3622,3.6,"20"
"76",2,4,3,3688692,3691981,3289,3.3,"0"
"781",2,4,75,3696513,3699827,3314,3.3,"0"
"791",2,3,34,3701773,3706283,4510,4.5,"20"
"801",2,3,26,3708330,3712390,4060,4.1,"20"
"82",2,5,60,3716894,3719765,2871,2.9,"20"
"831",2,8,79,3721878,3724950,3072,3.1,"0"
"84",2,2,33,3726843,3729348,2505,2.5,"0"
"851",2,7,46,3732778,3735780,3002,3,"20"
"861",2,3,50,3738383,3740833,2450,2.5,"20"
"871",2,2,65,3742714,3746064,3350,3.4,"0"
"881",2,3,10,3747837,3751455,3618,3.6,"20"
"901",2,7,62,3756052,3760226,4174,4.2,"20"
"911",2,6,5,3762208,3766048,3840,3.8,"0"
"931",2,1,56,3771086,3773872,2786,2.8,"20"
"94",2,4,43,3775804,3778516,2712,2.7,"0"
"951",2,3,66,3780318,3783767,3449,3.4,"20"
"961",2,1,40,3785670,3788961,3291,3.3,"20"
"971",2,7,30,3790750,3794081,3331,3.3,"20"
"991",2,4,59,3798032,3801702,3670,3.7,"0"
"1001",2,6,77,3803410,3806760,3350,3.4,"0"
"1011",2,2,9,3808631,3812772,4141,4.1,"0"
"1031",2,4,27,3817228,3820615,3387,3.4,"0"
"1051",2,1,72,3825118,3829895,4777,4.8,"20"
"1061",2,1,48,3832958,3836417,3459,3.5,"20"
"107",2,2,1,3838097,3842250,4153,4.2,"0"
"109",2,1,80,3846365,3848904,2539,2.5,"20"
"1101",2,8,39,3850818,3853669,2851,2.9,"0"
"111",2,5,28,3855814,3858447,2633,2.6,"20"
"1131",2,7,22,3862973,3866459,3486,3.5,"20"
"115",2,5,76,3871235,3874309,3074,3.1,"20"
"1161",2,6,29,3876310,3879793,3483,3.5,"0"
"1181",2,3,58,3885597,3889242,3645,3.6,"20"
"710",3,4,10,5314363,5319862,5499,5.5,"0"
"98",3,2,32,5335370,5340509,5139,5.1,"0"
"119",3,2,40,5346017,5350145,4128,4.1,"0"
"121",3,4,74,5355451,5360537,5086,5.1,"0"
"132",3,6,76,5362425,5366071,3646,3.6,"0"
"142",3,2,16,5370716,5375161,4445,4.4,"0"
"161",3,3,1,5380505,5384561,4056,4.1,"20"
"182",3,2,56,5392613,5395526,2913,2.9,"0"
"19",3,2,48,5398029,5402203,4174,4.2,"0"
"202",3,7,21,5406109,5409812,3703,3.7,"20"
"221",3,1,63,5414753,5419964,5211,5.2,"20"
"232",3,7,37,5423023,5427108,4085,4.1,"20"
"24",3,4,18,5431058,5434762,3704,3.7,"0"
"261",3,1,47,5440775,5443956,3181,3.2,"20"
"272",3,3,17,5447173,5451003,3830,3.8,"20"
"292",3,8,30,5462729,5466976,4247,4.2,"0"
"311",3,7,69,5478604,5483033,4429,4.4,"20"
"321",3,2,64,5485839,5490619,4780,4.8,"0"
"331",3,6,28,5494512,5497977,3465,3.5,"0"
"351",3,5,35,5502699,5507355,4656,4.7,"20"
"362",3,1,79,5509925,5512852,2927,2.9,"20"
"371",3,8,38,5514777,5518320,3543,3.5,"0"
"382",3,5,43,5521257,5525035,3778,3.8,"20"
"392",3,6,44,5528418,5532331,3913,3.9,"0"
"401",3,5,3,5537224,5541807,4583,4.6,"20"
"421",3,3,25,5552608,5555916,3308,3.3,"20"
"441",3,3,9,5562777,5567697,4920,4.9,"20"
"462",3,7,13,5572483,5577203,4720,4.7,"20"
"482",3,8,54,5585704,5590504,4800,4.8,"0"
"49",3,8,22,5594936,5599071,4135,4.1,"0"
"512",3,3,41,5604682,5608432,3750,3.8,"20"
"52",3,1,71,5614535,5618250,3715,3.7,"20"
"532",3,1,15,5623190,5626603,3413,3.4,"20"
"552",3,2,24,5631277,5635191,3914,3.9,"0"
"572",3,8,70,5641764,5646742,4978,5,"0"
"58",3,2,72,5651380,5656088,4708,4.7,"0"
"592",3,6,68,5660383,5663695,3312,3.3,"0"
"602",3,4,26,5669399,5672640,3241,3.2,"0"
"622",3,8,6,5677788,5682510,4722,4.7,"0"
"642",3,6,20,5689158,5693078,3920,3.9,"0"
"662",3,5,11,5698693,5702427,3734,3.7,"20"
"681",3,6,4,5708940,5712126,3186,3.2,"0"
"702",3,2,8,5716916,5720049,3133,3.1,"0"
"722",3,1,55,5725700,5728546,2846,2.8,"20"
"731",3,8,46,5731130,5734321,3191,3.2,"0"
"742",3,7,53,5738425,5742423,3998,4,"20"
"752",3,5,27,5745342,5747861,2519,2.5,"20"
"771",3,5,67,5754261,5757810,3549,3.5,"20"
"782",3,4,50,5762248,5765758,3510,3.5,"0"
"792",3,5,19,5768165,5771889,3724,3.7,"20"
"811",3,5,51,5778647,5782535,3888,3.9,"20"
"821",3,1,23,5789540,5792906,3366,3.4,"20"
"841",3,1,31,5798106,5801755,3649,3.6,"20"
"862",3,4,42,5809232,5813577,4345,4.3,"0"
"872",3,1,7,5815863,5819209,3346,3.3,"20"
"89",3,4,34,5824723,5827887,3164,3.2,"0"
"902",3,3,57,5832972,5837352,4380,4.4,"20"
"912",3,8,78,5839569,5842997,3428,3.4,"0"
"92",3,5,75,5845795,5848465,2670,2.7,"20"
"932",3,3,33,5851214,5854138,2924,2.9,"20"
"941",3,6,60,5857107,5860573,3466,3.5,"0"
"952",3,5,59,5863267,5867586,4319,4.3,"20"
"962",3,3,65,5869434,5873185,3751,3.8,"20"
"972",3,6,12,5875667,5879494,3827,3.8,"0"
"992",3,8,14,5886325,5889800,3475,3.5,"0"
"1012",3,8,62,5894161,5900855,6694,6.7,"0"
"1021",3,3,49,5905227,5908170,2943,2.9,"20"
"1032",3,7,61,5912866,5916118,3252,3.3,"20"
"104",3,3,73,5918493,5921996,3503,3.5,"20"
"1052",3,2,80,5924363,5927296,2933,2.9,"0"
"1062",3,6,52,5929542,5932569,3027,3,"0"
"1071",3,1,39,5935986,5939225,3239,3.2,"20"
"1081",3,4,66,5941086,5945283,4197,4.2,"0"
"1091",3,7,29,5948338,5952404,4066,4.1,"20"
"1111",3,7,77,5960024,5964181,4157,4.2,"20"
"1121",3,7,5,5965993,5970277,4284,4.3,"20"
"1141",3,4,2,5975273,5978797,3524,3.5,"0"
"1162",3,4,58,5983844,5988800,4956,5,"0"
"1171",3,7,45,5991029,5994785,3756,3.8,"20"
"1182",3,6,36,5997373,6000104,2731,2.7,"0"
"712",4,3,16,7154766,7159177,4411,4.4,"20"
"910",4,8,45,7166121,7169141,3020,3,"0"
"1010",4,5,50,7174126,7178196,4070,4.1,"20"
"1110",4,3,40,7180208,7183759,3551,3.6,"20"
"122",4,7,60,7185760,7189486,3726,3.7,"20"
"133",4,1,38,7191532,7195641,4109,4.1,"20"
"143",4,4,9,7200808,7204419,3611,3.6,"0"
"162",4,8,13,7210142,7213797,3655,3.7,"0"
"183",4,3,24,7225427,7229410,3983,4,"20"
"203",4,8,29,7235329,7241207,5878,5.9,"0"
"222",4,3,32,7249237,7252426,3189,3.2,"20"
"241",4,8,61,7261736,7268450,6714,6.7,"0"
"252",4,2,15,7272076,7274513,2437,2.4,"0"
"273",4,2,63,7280725,7284714,3989,4,"0"
"281",4,7,12,7290356,7293078,2722,2.7,"20"
"301",4,6,75,7299510,7303701,4191,4.2,"0"
"312",4,8,21,7305725,7309272,3547,3.5,"0"
"332",4,5,26,7320142,7324032,3890,3.9,"20"
"352",4,4,65,7333644,7338207,4563,4.6,"0"
"363",4,5,2,7340163,7344092,3929,3.9,"20"
"383",4,1,54,7353149,7358680,5531,5.5,"20"
"393",4,2,31,7366472,7373753,7281,7.3,"0"
"412",4,7,28,7387548,7391276,3728,3.7,"20"
"431",4,7,20,7396796,7400830,4034,4,"20"
"451",4,1,6,7406803,7414317,7514,7.5,"20"
"472",4,2,7,7419698,7430872,11174,11.2,"0"
"491",4,7,36,7436695,7440644,3949,3.9,"20"
"502",4,6,19,7447038,7449494,2456,2.5,"0"
"521",4,4,57,7456381,7461367,4986,5,"0"
"533",4,3,56,7469038,7471989,2951,3,"20"
"541",4,4,41,7477032,7480397,3365,3.4,"0"
"553",4,3,8,7487721,7491201,3480,3.5,"20"
"573",4,4,49,7496662,7499998,3336,3.3,"0"
"581",4,1,22,7506559,7511991,5432,5.4,"20"
"603",4,3,80,7528624,7531515,2891,2.9,"20"
"611",4,2,39,7546473,7549822,3349,3.3,"0"
"623",4,4,25,7553520,7556918,3398,3.4,"0"
"643",4,1,70,7561773,7566402,4629,4.6,"20"
"651",4,5,42,7568334,7572013,3679,3.7,"20"
"663",4,5,18,7573931,7577068,3137,3.1,"20"
"682",4,6,3,7582675,7588213,5538,5.5,"0"
"703",4,5,66,7595460,7599503,4043,4,"20"
"713",4,2,71,7601535,7604310,2775,2.8,"0"
"723",4,2,55,7606270,7609729,3459,3.5,"0"
"732",4,5,34,7613315,7617685,4370,4.4,"20"
"743",4,7,68,7621948,7626223,4275,4.3,"20"
"753",4,2,23,7628203,7631605,3402,3.4,"0"
"772",4,6,11,7636607,7639693,3086,3.1,"0"
"793",4,4,17,7648111,7655035,6924,6.9,"0"
"812",4,3,64,7663535,7666434,2899,2.9,"20"
"822",4,6,59,7672765,7676215,3450,3.5,"0"
"832",4,3,72,7681120,7686175,5055,5.1,"20"
"842",4,4,33,7693507,7696493,2986,3,"0"
"852",4,5,74,7698913,7703243,4330,4.3,"20"
"863",4,7,52,7711081,7715573,4492,4.5,"20"
"873",4,7,44,7718809,7723648,4839,4.8,"20"
"882",4,6,67,7725449,7729486,4037,4,"0"
"891",4,6,35,7731466,7735884,4418,4.4,"0"
"903",4,6,51,7737723,7742300,4577,4.6,"0"
"913",4,7,76,7744533,7748906,4373,4.4,"20"
"921",4,1,46,7751136,7754046,2910,2.9,"20"
"933",4,2,47,7755849,7761590,5741,5.7,"0"
"942",4,4,73,7763681,7767045,3364,3.4,"0"
"953",4,1,62,7769009,7773390,4381,4.4,"20"
"963",4,8,53,7779016,7782720,3704,3.7,"0"
"973",4,1,30,7785209,7788295,3086,3.1,"20"
"993",4,8,69,7794780,7799423,4643,4.6,"0"
"1002",4,8,77,7801595,7805293,3698,3.7,"0"
"1013",4,5,10,7807088,7811458,4370,4.4,"20"
"1033",4,3,48,7818515,7823976,5461,5.5,"20"
"1041",4,1,78,7825969,7829222,3253,3.3,"20"
"1053",4,5,58,7832126,7835793,3667,3.7,"20"
"1063",4,7,4,7837702,7840900,3198,3.2,"20"
"1082",4,8,5,7846215,7850245,4030,4,"0"
"1102",4,4,1,7855308,7858252,2944,2.9,"0"
"1122",4,6,43,7867074,7870643,3569,3.6,"0"
"1132",4,1,14,7873080,7877205,4125,4.1,"20"
"1151",4,8,37,7883425,7886466,3041,3,"0"
"1163",4,6,27,7888395,7891727,3332,3.3,"0"
"1183",4,2,79,7901468,7908275,6807,6.8,"0"
"714",5,2,6,8888686,8893054,4368,4.4,"0"
"914",5,5,49,8899651,8904639,4988,5,"20"
"1014",5,6,2,8906745,8912024,5279,5.3,"0"
"123",5,5,9,8918418,8926059,7641,7.6,"20"
"144",5,4,80,8932013,8936222,4209,4.2,"0"
"151",5,6,50,8938159,8941682,3523,3.5,"0"
"163",5,7,35,8943630,8948674,5044,5,"20"
"172",5,1,37,8951124,8955261,4137,4.1,"20"
"184",5,8,52,8957668,8962477,4809,4.8,"0"
"191",5,5,73,8967378,8972060,4682,4.7,"20"
"204",5,6,34,8973941,8978958,5017,5,"0"
"211",5,2,54,8982431,8987190,4759,4.8,"0"
"223",5,4,32,8989274,8995990,6716,6.7,"0"
"242",5,2,46,9005995,9011105,5110,5.1,"0"
"253",5,5,41,9012967,9017142,4175,4.2,"20"
"262",5,8,76,9019043,9022404,3361,3.4,"0"
"274",5,4,64,9024450,9027763,3313,3.3,"0"
"282",5,3,63,9029732,9034652,4920,4.9,"20"
"293",5,5,33,9036481,9040297,3816,3.8,"20"
"302",5,4,40,9042248,9046470,4222,4.2,"0"
"313",5,3,79,9048379,9055136,6757,6.8,"20"
"322",5,2,38,9057049,9063423,6374,6.4,"0"
"333",5,8,28,9065240,9069167,3927,3.9,"0"
"353",5,3,39,9075497,9081583,6086,6.1,"20"
"364",5,6,58,9083928,9088498,4570,4.6,"0"
"372",5,1,77,9090416,9097144,6728,6.7,"20"
"384",5,4,24,9098887,9103055,4168,4.2,"0"
"402",5,1,21,9108612,9113949,5337,5.3,"20"
"422",5,4,48,9119533,9125903,6370,6.4,"0"
"432",5,8,68,9128256,9132219,3963,4,"0"
"442",5,8,20,9134142,9138410,4268,4.3,"0"
"463",5,7,27,9144284,9150116,5832,5.8,"20"
"483",5,3,47,9157070,9160963,3893,3.9,"20"
"492",5,1,29,9162739,9169443,6704,6.7,"20"
"513",5,7,43,9176267,9181556,5289,5.3,"20"
"522",5,8,60,9183397,9187742,4345,4.3,"0"
"534",5,7,19,9189791,9193797,4006,4,"20"
"554",5,8,4,9201781,9206102,4321,4.3,"0"
"574",5,4,8,9210999,9215407,4408,4.4,"0"
"593",5,3,7,9220813,9225843,5030,5,"20"
"612",5,6,66,9233944,9240453,6509,6.5,"0"
"624",5,4,72,9242494,9249455,6961,7,"0"
"63",5,2,22,9251383,9255311,3928,3.9,"0"
"652",5,1,45,9260528,9264260,3732,3.7,"20"
"664",5,6,18,9266107,9272545,6438,6.4,"0"
"683",5,1,53,9282034,9287457,5423,5.4,"20"
"691",5,7,59,9289429,9297762,8333,8.3,"20"
"704",5,4,16,9299597,9303255,3658,3.7,"0"
"724",5,1,13,9308696,9314158,5462,5.5,"20"
"744",5,5,17,9319248,9325513,6265,6.3,"20"
"761",5,6,74,9330883,9337130,6247,6.2,"0"
"773",5,7,3,9339178,9343631,4453,4.5,"20"
"794",5,3,31,9348697,9354772,6075,6.1,"20"
"813",5,5,25,9360458,9363973,3515,3.5,"20"
"833",5,8,44,9368662,9374436,5774,5.8,"0"
"843",5,3,55,9376274,9381025,4751,4.8,"20"
"853",5,2,30,9382722,9386437,3715,3.7,"0"
"874",5,7,75,9391630,9397381,5751,5.8,"20"
"883",5,1,61,9399268,9404006,4738,4.7,"20"
"892",5,4,56,9405739,9411247,5508,5.5,"0"
"904",5,5,1,9413174,9416520,3346,3.3,"20"
"922",5,5,57,9421836,9426046,4210,4.2,"20"
"934",5,1,5,9427762,9433650,5888,5.9,"20"
"954",5,7,51,9441236,9445722,4486,4.5,"20"
"964",5,1,69,9447438,9452575,5137,5.1,"20"
"974",5,3,23,9454486,9458821,4335,4.3,"20"
"994",5,2,62,9464229,9470517,6288,6.3,"0"
"1003",5,6,42,9472304,9478054,5750,5.8,"0"
"1015",5,5,65,9480032,9484925,4893,4.9,"20"
"1022",5,2,70,9486758,9492153,5395,5.4,"0"
"1034",5,3,15,9493935,9496710,2775,2.8,"20"
"1054",5,2,14,9504116,9507654,3538,3.5,"0"
"1072",5,8,12,9513295,9517855,4560,4.6,"0"
"1092",5,2,78,9522991,9530422,7431,7.4,"0"
"1103",5,6,10,9532250,9539777,7527,7.5,"0"
"1123",5,3,71,9546019,9556760,10741,10.7,"20"
"1133",5,8,36,9558858,9564494,5636,5.6,"0"
"1142",5,6,26,9566260,9574827,8567,8.6,"0"
"1164",5,7,67,9581497,9589271,7774,7.8,"20"
"1172",5,7,11,9591206,9598928,7722,7.7,"20"
"715",6,3,30,10697540,10700444,2904,2.9,"20"
"915",6,5,80,10706383,10708941,2558,2.6,"20"
"1016",6,7,66,10712128,10715050,2922,2.9,"20"
"1112",6,3,78,10719102,10722301,3199,3.2,"20"
"124",6,6,65,10724144,10727207,3063,3.1,"0"
"134",6,4,47,10730559,10732869,2310,2.3,"0"
"145",6,5,40,10735675,10738460,2785,2.8,"20"
"152",6,3,6,10741245,10745096,3851,3.9,"20"
"173",6,7,18,10754487,10756812,2325,2.3,"20"
"192",6,5,24,10763262,10766838,3576,3.6,"20"
"212",6,8,19,10773420,10776763,3343,3.3,"0"
"233",6,8,67,10784682,10787383,2701,2.7,"0"
"243",6,3,62,10790731,10794553,3822,3.8,"20"
"254",6,4,63,10797466,10799861,2395,2.4,"0"
"263",6,5,48,10802940,10806002,3062,3.1,"20"
"275",6,1,20,10809245,10811761,2516,2.5,"20"
"294",6,2,21,10818925,10821071,2146,2.1,"0"
"314",6,6,73,10828924,10832287,3363,3.4,"0"
"323",6,4,7,10836463,10839285,2822,2.8,"0"
"342",6,4,15,10847744,10850751,3007,3,"0"
"365",6,2,5,10861881,10864212,2331,2.3,"0"
"385",6,2,13,10870942,10874248,3306,3.3,"0"
"403",6,8,3,10888195,10890710,2515,2.5,"0"
"423",6,4,55,10902229,10905029,2800,2.8,"0"
"433",6,2,69,10911566,10914240,2674,2.7,"0"
"443",6,8,51,10916695,10919672,2977,3,"0"
"452",6,4,39,10922493,10924677,2184,2.2,"0"
"464",6,2,29,10929416,10932006,2590,2.6,"0"
"484",6,1,12,10945968,10948272,2304,2.3,"20"
"503",6,4,79,10958483,10961063,2580,2.6,"0"
"514",6,7,26,10968391,10970449,2058,2.1,"20"
"535",6,7,34,10980796,10984444,3648,3.6,"20"
"542",6,3,22,11020807,11024064,3257,3.3,"20"
"562",6,3,54,11031539,11034562,3023,3,"20"
"575",6,4,71,11039829,11042314,2485,2.5,"0"
"582",6,3,70,11044293,11047356,3063,3.1,"20"
"594",6,8,11,11049361,11052025,2664,2.7,"0"
"613",6,7,2,11059142,11064023,4881,4.9,"20"
"631",6,6,57,11070106,11075214,5108,5.1,"0"
"644",6,7,10,11086329,11090024,3695,3.7,"20"
"665",6,6,17,11102643,11106391,3748,3.7,"0"
"684",6,1,36,11113698,11117398,3700,3.7,"20"
"692",6,1,60,11120306,11124150,3844,3.8,"20"
"705",6,5,72,11134835,11137341,2506,2.5,"20"
"716",6,6,25,11140638,11143121,2483,2.5,"0"
"733",6,5,64,11150519,11153152,2633,2.6,"20"
"745",6,3,46,11155281,11158900,3619,3.6,"20"
"754",6,1,68,11160716,11163334,2618,2.6,"20"
"762",6,6,49,11166167,11171333,5166,5.2,"0"
"774",6,1,4,11173355,11176681,3326,3.3,"20"
"795",6,2,61,11234944,11238710,3766,3.8,"0"
"802",6,7,42,11242847,11246684,3837,3.8,"20"
"814",6,8,35,11249219,11251897,2678,2.7,"0"
"823",6,1,28,11253979,11257624,3645,3.6,"20"
"844",6,5,16,11264929,11267946,3017,3,"20"
"864",6,4,31,11273951,11277576,3625,3.6,"0"
"884",6,8,75,11286106,11289050,2944,2.9,"0"
"893",6,4,23,11294599,11298008,3409,3.4,"0"
"916",6,2,77,11303204,11308884,5680,5.7,"0"
"923",6,2,45,11310873,11313406,2533,2.5,"0"
"935",6,3,38,11315595,11318419,2824,2.8,"20"
"943",6,1,44,11321490,11324104,2614,2.6,"20"
"955",6,6,1,11326608,11329179,2571,2.6,"0"
"975",6,1,52,11348329,11351112,2783,2.8,"20"
"981",6,1,76,11354844,11358498,3654,3.7,"20"
"995",6,7,50,11397608,11400368,2760,2.8,"20"
"1004",6,6,41,11402825,11405128,2303,2.3,"0"
"1017",6,8,27,11407730,11411663,3933,3.9,"0"
"1035",6,3,14,11418004,11421054,3050,3,"20"
"1055",6,5,8,11433973,11437308,3335,3.3,"20"
"1073",6,2,37,11448128,11450286,2158,2.2,"0"
"1083",6,2,53,11453124,11455894,2770,2.8,"0"
"1093",6,7,74,11472499,11475841,3342,3.3,"20"
"1104",6,8,43,11479700,11482405,2705,2.7,"0"
"1113",6,6,33,11490405,11492510,2105,2.1,"0"
"1124",6,5,56,11540097,11541333,1236,1.2,"20"
"1134",6,5,32,11543724,11545751,2027,2,"20"
"1152",6,6,9,11551656,11554208,2552,2.6,"0"
"1173",6,8,59,11562461,11565330,2869,2.9,"0"
"1184",6,7,58,11569314,11572086,2772,2.8,"20"
"717",7,5,71,14473164,14476785,3621,3.6,"20"
"810",7,5,23,14485235,14488508,3273,3.3,"20"
"1018",7,6,56,14499562,14504433,4871,4.9,"0"
"1114",7,4,62,14510231,14518391,8160,8.2,"0"
"125",7,2,68,14521854,14525014,3160,3.2,"0"
"135",7,8,74,14531376,14535758,4382,4.4,"0"
"146",7,7,41,14537915,14543510,5595,5.6,"20"
"153",7,1,19,14548083,14554385,6302,6.3,"20"
"174",7,8,10,14573029,14577352,4323,4.3,"0"
"193",7,2,12,14585439,14589042,3603,3.6,"0"
"213",7,7,17,14596748,14602393,5645,5.6,"20"
"234",7,1,27,14617332,14622215,4883,4.9,"20"
"255",7,8,18,14633354,14642502,9148,9.1,"0"
"276",7,3,13,14648680,14652089,3409,3.4,"20"
"295",7,8,34,14680364,14690408,10044,10,"0"
"303",7,1,35,14692363,14697397,5034,5,"20"
"315",7,5,39,14702275,14708280,6005,6,"20"
"324",7,7,9,14710284,14715547,5263,5.3,"20"
"343",7,4,78,14724583,14727903,3320,3.3,"0"
"354",7,6,8,14732554,14738506,5952,6,"0"
"373",7,5,31,14746633,14752201,5568,5.6,"20"
"394",7,4,38,14761957,14769643,7686,7.7,"0"
"404",7,2,44,14777911,14783875,5964,6,"0"
"413",7,1,59,14787312,14793167,5855,5.9,"20"
"424",7,1,51,14797733,14801615,3882,3.9,"20"
"434",7,6,40,14807961,14815757,7796,7.8,"0"
"444",7,7,33,14823890,14827702,3812,3.8,"20"
"453",7,8,50,14833712,14836994,3282,3.3,"0"
"465",7,6,24,14845824,14850559,4735,4.7,"0"
"485",7,1,75,14870813,14874329,3516,3.5,"20"
"493",7,4,54,14907242,14912296,5054,5.1,"0"
"504",7,3,77,14914513,14916747,2234,2.2,"20"
"515",7,6,48,14918813,14925310,6497,6.5,"0"
"523",7,2,28,14933643,14936529,2886,2.9,"0"
"543",7,4,14,14942690,14947072,4382,4.4,"0"
"563",7,7,57,14956579,14963247,6668,6.7,"20"
"576",7,2,20,14971332,14978201,6869,6.9,"0"
"595",7,8,66,14986484,14989404,2920,2.9,"0"
"604",7,2,52,14995442,14998352,2910,2.9,"0"
"614",7,4,70,15004259,15007342,3083,3.1,"0"
"625",7,3,53,15011682,15018556,6874,6.9,"20"
"632",7,5,47,15024922,15027847,2925,2.9,"20"
"645",7,4,6,15032526,15038523,5997,6,"0"
"666",7,3,29,15045646,15050026,4380,4.4,"20"
"685",7,1,67,15056528,15060446,3918,3.9,"20"
"693",7,1,11,15069784,15072440,2656,2.7,"20"
"718",7,8,26,15079235,15083316,4081,4.1,"0"
"734",7,3,37,15089526,15092543,3017,3,"20"
"746",7,8,58,15096095,15100085,3990,4,"0"
"755",7,6,16,15102861,15105283,2422,2.4,"0"
"775",7,7,73,15115418,15121503,6085,6.1,"20"
"783",7,3,21,15124632,15129164,4532,4.5,"20"
"803",7,5,79,15134189,15137434,3245,3.2,"20"
"815",7,7,1,15141285,15143500,2215,2.2,"20"
"834",7,5,55,15149860,15152064,2204,2.2,"20"
"845",7,1,43,15158113,15162122,4009,4,"20"
"854",7,5,15,15167560,15170670,3110,3.1,"20"
"875",7,4,22,15179369,15182021,2652,2.7,"0"
"894",7,3,45,15187246,15189937,2691,2.7,"20"
"905",7,3,61,15204078,15209864,5786,5.8,"20"
"917",7,2,36,15213076,15216270,3194,3.2,"0"
"924",7,7,25,15220164,15223420,3256,3.3,"20"
"944",7,6,72,15233999,15239870,5871,5.9,"0"
"956",7,1,3,15249384,15253812,4428,4.4,"20"
"976",7,6,80,15259393,15261805,2412,2.4,"0"
"982",7,7,65,15272041,15277538,5497,5.5,"20"
"996",7,4,30,15291360,15294446,3086,3.1,"0"
"1019",7,8,2,15313342,15316832,3490,3.5,"0"
"1036",7,8,42,15324339,15330069,5730,5.7,"0"
"1042",7,3,69,15332517,15335905,3388,3.4,"20"
"1056",7,5,7,15337929,15341128,3199,3.2,"20"
"1074",7,3,5,15347642,15352273,4631,4.6,"20"
"1094",7,5,63,15357465,15362902,5437,5.4,"20"
"1105",7,2,4,15365859,15371028,5169,5.2,"0"
"1125",7,6,32,15377875,15381013,3138,3.1,"0"
"1143",7,2,60,15387899,15391414,3515,3.5,"0"
"1153",7,4,46,15394877,15397727,2850,2.8,"0"
"1165",7,7,49,15402752,15405360,2608,2.6,"20"
"1174",7,6,64,15410500,15412652,2152,2.2,"0"
"1185",7,2,76,15417873,15420954,3081,3.1,"0"
"719",8,6,15,16142198,16146877,4679,4.7,"0"
"918",8,4,21,16152575,16158604,6029,6,"0"
"1115",8,1,66,16164114,16169649,5535,5.5,"20"
"126",8,2,43,16173087,16178646,5559,5.6,"0"
"136",8,8,73,16180808,16186348,5540,5.5,"0"
"147",8,1,18,16188841,16193768,4927,4.9,"20"
"164",8,1,50,16199080,16204404,5324,5.3,"20"
"175",8,6,23,16206620,16210580,3960,4,"0"
"194",8,1,2,16218322,16223717,5395,5.4,"20"
"214",8,7,24,16231653,16236478,4825,4.8,"20"
"235",8,2,75,16242983,16247743,4760,4.8,"0"
"244",8,2,3,16251087,16255532,4445,4.4,"0"
"264",8,8,65,16262176,16267092,4916,4.9,"0"
"277",8,6,47,16269696,16273672,3976,4,"0"
"283",8,5,46,16276528,16281611,5083,5.1,"20"
"296",8,4,53,16285416,16294159,8743,8.7,"0"
"304",8,2,19,16297397,16301240,3843,3.8,"0"
"325",8,4,29,16314846,16320281,5435,5.4,"0"
"344",8,8,1,16326209,16329967,3758,3.8,"0"
"366",8,8,25,16336096,16341826,5730,5.7,"0"
"386",8,4,5,16347484,16351245,3761,3.8,"0"
"405",8,4,61,16357737,16364379,6642,6.6,"0"
"414",8,3,52,16367009,16373916,6907,6.9,"20"
"425",8,5,6,16376989,16384442,7453,7.5,"20"
"445",8,7,72,16390205,16396144,5939,5.9,"20"
"454",8,6,71,16399289,16403421,4132,4.1,"0"
"466",8,1,58,16407430,16412693,5263,5.3,"20"
"473",8,1,10,16415074,16421760,6686,6.7,"20"
"494",8,2,59,16429979,16433837,3858,3.9,"0"
"505",8,8,57,16436181,16441318,5137,5.1,"0"
"516",8,7,32,16444380,16449820,5440,5.4,"20"
"536",8,2,11,16454541,16459498,4957,5,"0"
"555",8,7,8,16466879,16472234,5355,5.4,"20"
"577",8,4,37,16478061,16483013,4952,5,"0"
"583",8,8,17,16486784,16494766,7982,8,"0"
"605",8,3,68,16501694,16507432,5738,5.7,"20"
"615",8,2,35,16509563,16514418,4855,4.9,"0"
"626",8,6,31,16516429,16521379,4950,5,"0"
"646",8,5,14,16528600,16533336,4736,4.7,"20"
"667",8,7,56,16539089,16544192,5103,5.1,"20"
"672",8,2,67,16547477,16554235,6758,6.8,"0"
"686",8,1,34,16556715,16563492,6777,6.8,"20"
"694",8,5,30,16565883,16570014,4131,4.1,"20"
"7110",8,8,41,16576214,16580319,4105,4.1,"0"
"725",8,7,48,16582595,16591564,8969,9,"20"
"735",8,3,4,16593811,16598891,5080,5.1,"20"
"756",8,7,16,16606612,16611110,4498,4.5,"20"
"776",8,3,20,16617268,16622216,4948,4.9,"20"
"796",8,1,74,16629900,16634369,4469,4.5,"20"
"804",8,5,62,16636623,16644565,7942,7.9,"20"
"816",8,5,78,16647130,16652255,5125,5.1,"20"
"824",8,2,27,16654647,16659461,4814,4.8,"0"
"846",8,1,26,16665454,16670345,4891,4.9,"20"
"865",8,7,64,16679046,16683095,4049,4,"20"
"876",8,3,60,16685216,16689014,3798,3.8,"20"
"885",8,1,42,16691540,16696711,5171,5.2,"20"
"895",8,4,69,16699164,16704006,4842,4.8,"0"
"906",8,5,70,16707245,16712745,5500,5.5,"20"
"919",8,3,76,16714840,16723841,9001,9,"20"
"925",8,6,55,16725995,16731663,5668,5.7,"0"
"936",8,8,49,16733960,16737721,3761,3.8,"0"
"945",8,7,80,16740183,16744624,4441,4.4,"20"
"957",8,4,45,16748478,16753272,4794,4.8,"0"
"965",8,5,22,16755894,16761531,5637,5.6,"20"
"983",8,4,13,16767343,16773153,5810,5.8,"0"
"1005",8,3,44,16780363,16784241,3878,3.9,"20"
"10110",8,4,77,16787003,16792170,5167,5.2,"0"
"1023",8,6,79,16794449,16799008,4559,4.6,"0"
"1037",8,5,54,16802950,16808685,5735,5.7,"20"
"1043",8,8,33,16816881,16820820,3939,3.9,"0"
"1057",8,2,51,16823398,16829796,6398,6.4,"0"
"1064",8,3,12,16832067,16836716,4649,4.6,"20"
"1084",8,3,28,16842687,16847190,4503,4.5,"20"
"1106",8,6,63,16853866,16858354,4488,4.5,"0"
"1116",8,7,40,16860443,16866215,5772,5.8,"20"
"1126",8,8,9,16869537,16874537,5000,5,"0"
"1144",8,3,36,16882311,16887913,5602,5.6,"20"
"1154",8,6,7,16891293,16896452,5159,5.2,"0"
"1175",8,5,38,16905456,16911992,6536,6.5,"20"
"1186",8,6,39,16915700,16920022,4322,4.3,"0"
"720",9,6,54,18849075,18851918,2843,2.8,"0"
"817",9,4,36,18855006,18857193,2187,2.2,"0"
"920",9,4,12,18861405,18863071,1666,1.7,"0"
"1117",9,5,37,18870872,18872569,1697,1.7,"20"
"127",9,8,24,18877102,18879520,2418,2.4,"0"
"148",9,6,46,18890584,18892290,1706,1.7,"0"
"154",9,2,42,18896496,18898822,2326,2.3,"0"
"165",9,4,20,18903646,18905065,1419,1.4,"0"
"185",9,4,60,18910549,18912353,1804,1.8,"0"
"195",9,7,71,18917281,18919866,2585,2.6,"20"
"205",9,4,68,18922920,18924852,1932,1.9,"0"
"215",9,4,4,18928595,18931414,2819,2.8,"0"
"236",9,3,3,18939644,18941878,2234,2.2,"20"
"256",9,6,6,18948666,18950519,1853,1.9,"0"
"278",9,5,61,18958216,18961725,3509,3.5,"20"
"284",9,6,14,18966313,18968206,1893,1.9,"0"
"305",9,1,49,18979714,18981965,2251,2.3,"20"
"316",9,1,17,18984247,18986901,2654,2.7,"20"
"334",9,6,62,18993373,18995586,2213,2.2,"0"
"345",9,2,18,18999293,19000833,1540,1.5,"0"
"367",9,1,57,19006694,19008686,1992,2,"20"
"374",9,5,29,19012578,19014470,1892,1.9,"20"
"395",9,8,48,19019671,19021713,2042,2,"0"
"406",9,5,69,19024552,19026813,2261,2.3,"20"
"415",9,3,51,19030635,19033592,2957,3,"20"
"426",9,6,70,19038045,19040843,2798,2.8,"0"
"435",9,2,26,19043743,19045303,1560,1.6,"0"
"455",9,8,16,19053633,19055388,1755,1.8,"0"
"474",9,5,5,19064464,19066188,1724,1.7,"20"
"495",9,2,74,19075179,19077025,1846,1.8,"0"
"506",9,5,13,19080192,19082207,2015,2,"20"
"524",9,1,73,19087776,19090503,2727,2.7,"20"
"537",9,7,47,19093661,19095175,1514,1.5,"20"
"544",9,8,32,19100933,19103131,2198,2.2,"0"
"564",9,8,64,19113088,19115912,2824,2.8,"0"
"578",9,3,35,19120280,19121725,1445,1.4,"20"
"584",9,7,79,19126458,19127987,1529,1.5,"20"
"596",9,5,53,19130185,19132246,2061,2.1,"20"
"606",9,8,40,19136143,19137874,1731,1.7,"0"
"616",9,7,39,19143434,19145647,2213,2.2,"20"
"627",9,2,10,19147828,19150557,2729,2.7,"0"
"647",9,3,11,19157602,19159303,1701,1.7,"20"
"668",9,1,25,19164598,19166834,2236,2.2,"20"
"687",9,3,67,19172579,19174970,2391,2.4,"20"
"695",9,8,80,19178429,19181942,3513,3.5,"0"
"706",9,3,43,19184890,19188520,3630,3.6,"20"
"7111",9,7,55,19205033,19207520,2487,2.5,"20"
"726",9,8,72,19217887,19221433,3546,3.5,"0"
"736",9,4,44,19231540,19233963,2423,2.4,"0"
"747",9,6,22,19249428,19253195,3767,3.8,"0"
"763",9,7,7,19261080,19266379,5299,5.3,"20"
"784",9,1,65,19272942,19275459,2517,2.5,"20"
"797",9,5,21,19277528,19279303,1775,1.8,"20"
"818",9,3,59,19286606,19288916,2310,2.3,"20"
"825",9,4,28,19291879,19293457,1578,1.6,"0"
"847",9,1,41,19300180,19303004,2824,2.8,"20"
"855",9,6,78,19305878,19309227,3349,3.3,"0"
"866",9,2,66,19313614,19315445,1831,1.8,"0"
"877",9,1,9,19317303,19320048,2745,2.7,"20"
"896",9,6,38,19329255,19331443,2188,2.2,"0"
"907",9,3,27,19334113,19335908,1795,1.8,"20"
"926",9,4,52,19342134,19344156,2022,2,"0"
"937",9,2,2,19347293,19349176,1883,1.9,"0"
"958",9,2,34,19353777,19355927,2150,2.1,"0"
"966",9,7,23,19358597,19361126,2529,2.5,"20"
"984",9,4,76,19368400,19371477,3077,3.1,"0"
"997",9,1,1,19376412,19378105,1693,1.7,"20"
"10111",9,7,31,19383954,19387192,3238,3.2,"20"
"1038",9,5,45,19394765,19396202,1437,1.4,"20"
"1044",9,3,19,19398310,19399982,1672,1.7,"20"
"1065",9,1,33,19405987,19407327,1340,1.3,"20"
"1075",9,7,15,19409457,19411075,1618,1.6,"20"
"1095",9,8,56,19420505,19422773,2268,2.3,"0"
"1107",9,2,58,19425163,19427991,2828,2.8,"0"
"1118",9,6,30,19430120,19431726,1606,1.6,"0"
"1135",9,3,75,19437181,19439449,2268,2.3,"20"
"1145",9,8,8,19441490,19444314,2824,2.8,"0"
"1166",9,2,50,19450311,19452214,1903,1.9,"0"
"1176",9,7,63,19455886,19458454,2568,2.6,"20"
"1187",9,5,77,19462086,19463982,1896,1.9,"20"
"727",10,3,42,19904528,19911828,7300,7.3,"20"
"819",10,4,27,19915896,19918845,2949,2.9,"0"
"1020",10,5,60,19924711,19928342,3631,3.6,"20"
"1119",10,8,55,19930223,19935344,5121,5.1,"0"
"128",10,7,14,19937155,19942629,5474,5.5,"20"
"149",10,8,39,19949153,19953806,4653,4.7,"0"
"155",10,4,59,19957183,19961514,4331,4.3,"0"
"166",10,7,38,19965174,19972532,7358,7.4,"20"
"176",10,4,19,19974402,19977840,3438,3.4,"0"
"196",10,1,8,19982875,19990077,7202,7.2,"20"
"216",10,8,15,19995455,19997943,2488,2.5,"0"
"237",10,2,1,20003562,20008754,5192,5.2,"0"
"257",10,5,4,20013867,20018313,4446,4.4,"20"
"279",10,2,41,20024387,20029992,5605,5.6,"0"
"285",10,3,58,20033007,20037768,4761,4.8,"20"
"297",10,2,25,20040375,20044519,4144,4.1,"0"
"317",10,6,61,20049516,20056010,6494,6.5,"0"
"326",10,5,52,20058535,20064195,5660,5.7,"20"
"335",10,3,34,20067563,20074219,6656,6.7,"20"
"346",10,7,6,20076446,20084187,7741,7.7,"20"
"368",10,1,40,20089834,20093321,3487,3.5,"20"
"375",10,7,62,20095276,20101381,6105,6.1,"20"
"387",10,8,7,20104157,20108455,4298,4.3,"0"
"407",10,5,76,20116208,20121233,5025,5,"20"
"416",10,5,44,20122886,20126782,3896,3.9,"20"
"427",10,7,78,20128702,20135429,6727,6.7,"20"
"436",10,3,50,20137207,20140638,3431,3.4,"20"
"446",10,6,77,20142672,20147459,4787,4.8,"0"
"456",10,1,16,20149895,20153789,3894,3.9,"20"
"475",10,7,54,20158987,20163459,4472,4.5,"20"
"486",10,2,57,20165721,20170558,4837,4.8,"0"
"496",10,4,67,20172519,20176272,3753,3.8,"0"
"507",10,3,18,20178260,20184491,6231,6.2,"20"
"525",10,2,33,20190307,20193346,3039,3,"0"
"538",10,3,74,20195457,20199396,3939,3.9,"20"
"545",10,4,51,20201136,20204911,3775,3.8,"0"
"556",10,5,68,20206718,20213121,6403,6.4,"20"
"565",10,8,79,20214910,20218372,3462,3.5,"0"
"579",10,1,56,20221252,20225332,4080,4.1,"20"
"585",10,4,3,20227659,20232308,4649,4.6,"0"
"607",10,3,2,20237164,20240089,2925,2.9,"20"
"628",10,5,20,20246125,20249398,3273,3.3,"20"
"648",10,6,21,20254827,20258493,3666,3.7,"0"
"669",10,6,53,20264223,20271935,7712,7.7,"0"
"673",10,6,29,20274816,20278195,3379,3.4,"0"
"696",10,1,48,20282823,20286196,3373,3.4,"20"
"707",10,5,36,20288852,20299520,10668,10.7,"20"
"7112",10,3,26,20301244,20305061,3817,3.8,"20"
"737",10,8,47,20310201,20314788,4587,4.6,"0"
"748",10,7,46,20316706,20323405,6699,6.7,"20"
"757",10,4,75,20325298,20329409,4111,4.1,"0"
"764",10,2,65,20332979,20336193,3214,3.2,"0"
"777",10,6,37,20337906,20341146,3240,3.2,"0"
"785",10,8,63,20343464,20347766,4302,4.3,"0"
"798",10,8,71,20350785,20354132,3347,3.3,"0"
"805",10,4,43,20357954,20361202,3248,3.2,"0"
"8110",10,7,30,20362977,20366798,3821,3.8,"20"
"835",10,8,31,20372199,20376591,4392,4.4,"0"
"856",10,2,9,20384037,20387982,3945,3.9,"0"
"878",10,3,10,20395659,20401378,5719,5.7,"20"
"897",10,2,73,20406749,20410126,3377,3.4,"0"
"908",10,4,11,20413887,20417144,3257,3.3,"0"
"927",10,1,80,20422940,20425829,2889,2.9,"20"
"938",10,2,49,20429027,20433606,4579,4.6,"0"
"946",10,3,66,20435575,20442750,7175,7.2,"20"
"959",10,4,35,20444881,20448043,3162,3.2,"0"
"967",10,6,13,20452713,20457449,4736,4.7,"0"
"985",10,1,24,20461664,20466353,4689,4.7,"20"
"1006",10,8,23,20471859,20475007,3148,3.1,"0"
"1024",10,1,32,20480311,20483536,3225,3.2,"20"
"1045",10,2,17,20490084,20494628,4544,4.5,"0"
"1066",10,7,22,20500277,20506611,6334,6.3,"20"
"1085",10,7,70,20513903,20517604,3701,3.7,"20"
"1096",10,1,64,20521249,20524692,3443,3.4,"20"
"1108",10,5,12,20528029,20531323,3294,3.3,"20"
"1127",10,6,5,20537787,20541715,3928,3.9,"0"
"1146",10,6,69,20547018,20550466,3448,3.4,"0"
"1155",10,6,45,20553252,20556332,3080,3.1,"0"
"1167",10,1,72,20558497,20563837,5340,5.3,"20"
"1177",10,5,28,20568157,20572859,4702,4.7,"20"
"728",11,5,51,21193168,21198900,5732,5.7,"20"
"820",11,1,39,21200795,21205860,5065,5.1,"20"
"928",11,1,79,21207562,21211624,4062,4.1,"20"
"1025",11,1,31,21213494,21219490,5996,6,"20"
"129",11,8,38,21225194,21229508,4314,4.3,"0"
"137",11,1,55,21232041,21235824,3783,3.8,"20"
"1410",11,5,59,21239175,21243814,4639,4.6,"20"
"156",11,6,76,21246815,21250971,4156,4.2,"0"
"167",11,5,67,21252979,21259161,6182,6.2,"20"
"177",11,5,75,21261018,21264704,3686,3.7,"20"
"186",11,8,62,21267147,21270426,3279,3.3,"0"
"197",11,3,1,21273770,21277553,3783,3.8,"20"
"217",11,6,28,21283267,21287256,3989,4,"0"
"238",11,5,11,21292348,21295118,2770,2.8,"20"
"258",11,5,19,21300763,21303910,3147,3.1,"20"
"2710",11,7,21,21312422,21316438,4016,4,"20"
"298",11,2,16,21322510,21325498,2988,3,"0"
"318",11,3,17,21331577,21335367,3790,3.8,"20"
"336",11,6,20,21341620,21345492,3872,3.9,"0"
"355",11,2,64,21350476,21353355,2879,2.9,"0"
"369",11,7,13,21356370,21361992,5622,5.6,"20"
"388",11,6,68,21367864,21371072,3208,3.2,"0"
"396",11,3,25,21373595,21376950,3355,3.4,"20"
"417",11,4,26,21382473,21385504,3031,3,"0"
"437",11,8,22,21391179,21396121,4942,4.9,"0"
"457",11,8,14,21401737,21408546,6809,6.8,"0"
"476",11,8,6,21415794,21421074,5280,5.3,"0"
"497",11,2,24,21427150,21430792,3642,3.6,"0"
"517",11,4,50,21437899,21441741,3842,3.8,"0"
"526",11,4,66,21447222,21451444,4222,4.2,"0"
"539",11,3,33,21453391,21456286,2895,2.9,"20"
"546",11,5,27,21458373,21461053,2680,2.7,"20"
"566",11,3,9,21466331,21469501,3170,3.2,"20"
"586",11,6,12,21475080,21477855,2775,2.8,"0"
"608",11,7,37,21482724,21486035,3311,3.3,"20"
"617",11,3,57,21487958,21490830,2872,2.9,"20"
"629",11,3,73,21492488,21499229,6741,6.7,"20"
"633",11,7,53,21501129,21505243,4114,4.1,"20"
"649",11,5,43,21506954,21509749,2795,2.8,"20"
"653",11,7,5,21511784,21515996,4212,4.2,"20"
"674",11,8,78,21521205,21525273,4068,4.1,"0"
"688",11,8,30,21527201,21531942,4741,4.7,"0"
"708",11,2,48,21538380,21542276,3896,3.9,"0"
"7113",11,4,34,21543976,21548695,4719,4.7,"0"
"729",11,2,40,21550792,21553189,2397,2.4,"0"
"738",11,7,77,21555683,21559045,3362,3.4,"20"
"749",11,7,69,21561847,21564745,2898,2.9,"20"
"758",11,2,32,21566838,21570193,3355,3.4,"0"
"778",11,6,44,21577283,21580785,3502,3.5,"0"
"786",11,8,70,21582787,21588353,5566,5.6,"0"
"799",11,6,60,21590609,21593600,2991,3,"0"
"806",11,4,2,21595430,21598764,3334,3.3,"0"
"826",11,7,29,21605481,21609717,4236,4.2,"20"
"848",11,4,18,21615868,21618404,2536,2.5,"0"
"867",11,5,35,21624692,21628365,3673,3.7,"20"
"879",11,8,54,21631085,21635035,3950,4,"0"
"886",11,2,8,21637994,21642016,4022,4,"0"
"909",11,4,42,21648192,21651866,3674,3.7,"0"
"9110",11,1,63,21653842,21657810,3968,4,"20"
"929",11,2,80,21659699,21661980,2281,2.3,"0"
"939",11,1,47,21663795,21666783,2988,3,"20"
"947",11,3,49,21671071,21674052,2981,3,"20"
"9510",11,1,7,21675776,21680721,4945,4.9,"20"
"977",11,8,46,21686740,21689874,3134,3.1,"0"
"986",11,4,58,21691676,21695675,3999,4,"0"
"998",11,4,10,21697453,21701619,4166,4.2,"0"
"10112",11,7,61,21706082,21710900,4818,4.8,"20"
"1026",11,5,3,21712917,21718103,5186,5.2,"20"
"1046",11,1,15,21723249,21725854,2605,2.6,"20"
"1067",11,4,74,21730530,21733383,2853,2.9,"0"
"1076",11,3,65,21735470,21739087,3617,3.6,"20"
"1086",11,7,45,21740929,21744342,3413,3.4,"20"
"1097",11,1,71,21746744,21751053,4309,4.3,"20"
"1109",11,2,72,21753041,21757878,4837,4.8,"0"
"11110",11,3,41,21759747,21762776,3029,3,"20"
"1128",11,2,56,21766584,21769372,2788,2.8,"0"
"1136",11,6,36,21771675,21776099,4424,4.4,"0"
"1147",11,6,52,21780299,21786298,5999,6,"0"
"1156",11,1,23,21791243,21796592,5349,5.3,"20"
"1178",11,6,4,21802734,21805690,2956,3,"0"
"730",12,7,44,23435867,23439910,4043,4,"20"
"827",12,7,28,23444655,23450520,5865,5.9,"20"
"1027",12,8,37,23535264,23540612,5348,5.3,"0"
"1120",12,1,54,23545265,23553070,7805,7.8,"20"
"1210",12,7,12,23559654,23565219,5565,5.6,"20"
"1411",12,5,66,23575883,23582347,6464,6.5,"20"
"157",12,1,38,23609086,23614104,5018,5,"20"
"168",12,8,53,23615954,23622043,6089,6.1,"0"
"178",12,4,73,23623901,23630550,6649,6.6,"0"
"187",12,8,29,23636679,23644164,7485,7.5,"0"
"206",12,5,74,23649590,23656072,6482,6.5,"20"
"218",12,6,51,23658477,23665206,6729,6.7,"0"
"224",12,8,69,23667081,23672893,5812,5.8,"0"
"239",12,3,40,23674846,23682235,7389,7.4,"20"
"245",12,8,21,23684339,23690663,6324,6.3,"0"
"265",12,2,7,23696753,23704601,7848,7.8,"0"
"286",12,2,39,23710536,23716574,6038,6,"0"
"299",12,7,68,23718855,23724863,6008,6,"20"
"306",12,5,58,23726742,23732440,5698,5.7,"20"
"319",12,6,75,23736568,23740987,4419,4.4,"0"
"327",12,2,71,23742920,23748189,5269,5.3,"0"
"337",12,8,61,23750111,23756650,6539,6.5,"0"
"347",12,8,45,23760894,23766289,5395,5.4,"0"
"356",12,6,11,23768196,23772946,4750,4.8,"0"
"376",12,1,46,23779951,23785318,5367,5.4,"20"
"389",12,1,14,23787410,23794086,6676,6.7,"20"
"408",12,4,33,23803910,23808400,4490,4.5,"0"
"418",12,3,80,23812803,23818220,5417,5.4,"20"
"428",12,1,30,23822540,23827349,4809,4.8,"20"
"447",12,6,35,23833449,23839283,5834,5.8,"0"
"458",12,5,18,23841411,23846190,4779,4.8,"20"
"477",12,7,60,23853096,23860148,7052,7.1,"20"
"487",12,3,16,23863549,23869778,6229,6.2,"20"
"508",12,6,27,23876081,23881313,5232,5.2,"0"
"527",12,7,52,23887928,23894862,6934,6.9,"20"
"5310",12,2,31,23898703,23905337,6634,6.6,"0"
"557",12,3,72,23911640,23918159,6519,6.5,"20"
"567",12,2,63,23923966,23931106,7140,7.1,"0"
"5710",12,3,8,23932888,23938953,6065,6.1,"20"
"597",12,2,47,23944420,23948549,4129,4.1,"0"
"609",12,4,25,23950921,23955814,4893,4.9,"0"
"6210",12,6,3,23961400,23966614,5214,5.2,"0"
"6410",12,5,2,23974199,23980277,6078,6.1,"20"
"6610",12,7,4,23988708,23995482,6774,6.8,"20"
"689",12,3,48,23999985,24005075,5090,5.1,"20"
"697",12,1,22,24006912,24014105,7193,7.2,"20"
"7114",12,4,65,24022054,24029347,7293,7.3,"0"
"7210",12,2,79,24031259,24036677,5418,5.4,"0"
"739",12,4,17,24040526,24049471,8945,8.9,"0"
"759",12,5,50,24054200,24058739,4539,4.5,"20"
"765",12,1,62,24060498,24068098,7600,7.6,"20"
"779",12,6,19,24070504,24076432,5928,5.9,"0"
"7910",12,5,10,24085603,24094930,9327,9.3,"20"
"8111",12,4,1,24101202,24106751,5549,5.5,"0"
"836",12,3,32,24112001,24119243,7242,7.2,"20"
"857",12,2,23,24125233,24131619,6386,6.4,"0"
"8710",12,3,64,24136365,24143811,7446,7.4,"20"
"887",12,6,59,24145799,24151387,5588,5.6,"0"
"898",12,6,67,24153329,24158839,5510,5.5,"0"
"9010",12,2,55,24161857,24167755,5898,5.9,"0"
"9111",12,4,41,24169586,24175283,5697,5.7,"0"
"9210",12,1,70,24177110,24185593,8483,8.5,"20"
"9310",12,5,34,24187405,24194329,6924,6.9,"20"
"948",12,5,42,24196178,24201195,5017,5,"20"
"9511",12,7,36,24203706,24209623,5917,5.9,"20"
"968",12,6,43,24213053,24218802,5749,5.7,"0"
"978",12,7,20,24220551,24224811,4260,4.3,"20"
"999",12,8,5,24232481,24238122,5641,5.6,"0"
"10113",12,1,78,24246697,24251433,4736,4.7,"20"
"1028",12,4,49,24253557,24260443,6886,6.9,"0"
"1039",12,8,13,24262218,24269705,7487,7.5,"0"
"1058",12,3,56,24274294,24278525,4231,4.2,"20"
"1068",12,4,57,24280471,24285237,4766,4.8,"0"
"1077",12,8,77,24287083,24293080,5997,6,"0"
"1087",12,4,9,24294974,24301007,6033,6,"0"
"11010",12,3,24,24305764,24312679,6915,6.9,"20"
"1129",12,7,76,24317463,24323010,5547,5.5,"20"
"1137",12,1,6,24324915,24330347,5432,5.4,"20"
"1157",12,5,26,24336718,24343470,6752,6.8,"20"
"1179",12,2,15,24349321,24354805,5484,5.5,"0"
"740",13,2,6,25256878,25267774,10896,10.9,"0"
"930",13,5,17,25278162,25292124,13962,14,"20"
"1130",13,6,58,25297882,25307014,9132,9.1,"0"
"1211",13,8,52,25309050,25322649,13599,13.6,"0"
"138",13,1,21,25324556,25334967,10411,10.4,"20"
"158",13,8,28,25341804,25353292,11488,11.5,"0"
"179",13,1,77,25359876,25370576,10700,10.7,"20"
"188",13,3,79,25373583,25389064,15481,15.5,"20"
"198",13,2,78,25391117,25397645,6528,6.5,"0"
"207",13,3,39,25399655,25408836,9181,9.2,"20"
"219",13,5,1,25410635,25418735,8100,8.1,"20"
"2310",13,8,68,25425269,25434781,9512,9.5,"0"
"246",13,6,10,25437679,25447973,10294,10.3,"0"
"266",13,5,33,25456603,25468523,11920,11.9,"20"
"2711",13,7,35,25472621,25479811,7190,7.2,"20"
"287",13,1,61,25492525,25501605,9080,9.1,"20"
"2910",13,3,15,25505386,25519314,13928,13.9,"20"
"3110",13,3,47,25532115,25537322,5207,5.2,"20"
"328",13,2,38,25548187,25559231,11044,11,"0"
"338",13,8,20,25571724,25577402,5678,5.7,"0"
"357",13,3,63,25591633,25618292,26659,26.7,"20"
"3610",13,8,44,25632752,25638627,5875,5.9,"0"
"377",13,8,4,25640710,25652254,11544,11.5,"0"
"397",13,4,24,25659393,25667117,7724,7.7,"0"
"419",13,6,42,25673383,25679404,6021,6,"0"
"429",13,5,9,25681751,25686717,4966,5,"20"
"448",13,1,45,25693160,25701188,8028,8,"20"
"459",13,3,7,25703688,25712271,8583,8.6,"20"
"478",13,3,55,25723734,25737893,14159,14.2,"20"
"488",13,7,67,25739730,25744788,5058,5.1,"20"
"498",13,1,29,25748778,25762871,14093,14.1,"20"
"518",13,4,72,25768741,25784535,15794,15.8,"0"
"528",13,1,53,25786371,25795058,8687,8.7,"20"
"5311",13,2,70,25796974,25802931,5957,6,"0"
"547",13,4,32,25810158,25822367,12209,12.2,"0"
"568",13,6,50,25829325,25842458,13133,13.1,"0"
"5711",13,7,27,25847191,25856838,9647,9.6,"20"
"598",13,4,40,25862307,25878312,16005,16,"0"
"6010",13,7,11,25883373,25897069,13696,13.7,"20"
"6211",13,7,75,25907359,25916128,8769,8.8,"20"
"634",13,4,56,25918178,25922521,4343,4.3,"0"
"6411",13,6,74,25925082,25930253,5171,5.2,"0"
"654",13,5,49,25933440,25940751,7311,7.3,"20"
"6611",13,2,62,25942522,25950733,8211,8.2,"0"
"675",13,4,64,25952579,25962310,9731,9.7,"0"
"6810",13,2,22,25964651,25971864,7213,7.2,"0"
"709",13,6,26,25977683,25981974,4291,4.3,"0"
"7211",13,6,66,25990423,25999076,8653,8.7,"0"
"7310",13,4,8,26000823,26014029,13206,13.2,"0"
"7510",13,5,73,26070251,26075618,5367,5.4,"20"
"766",13,4,80,26077339,26080645,3306,3.3,"0"
"7710",13,1,5,26082637,26086010,3373,3.4,"20"
"7911",13,3,31,26093812,26111242,17430,17.4,"20"
"8112",13,5,65,26125567,26131368,5801,5.8,"20"
"828",13,1,13,26133135,26139725,6590,6.6,"20"
"849",13,1,37,26145120,26164116,18996,19,"20"
"858",13,8,60,26167801,26171023,3222,3.2,"0"
"868",13,4,16,26172975,26194027,21052,21.1,"0"
"888",13,2,54,26200870,26219572,18702,18.7,"0"
"899",13,1,69,26221384,26225328,3944,3.9,"20"
"9011",13,7,51,26228256,26233146,4890,4.9,"20"
"9112",13,7,19,26239199,26245089,5890,5.9,"20"
"9311",13,8,36,26254823,26260015,5192,5.2,"0"
"949",13,5,41,26262472,26268660,6188,6.2,"20"
"9512",13,7,3,26270492,26280440,9948,9.9,"20"
"979",13,5,57,26287332,26303117,15785,15.8,"20"
"987",13,7,43,26304971,26310524,5553,5.6,"20"
"9910",13,3,71,26314265,26317301,3036,3,"20"
"1007",13,6,2,26347244,26352565,5321,5.3,"0"
"1029",13,4,48,26363203,26368404,5201,5.2,"0"
"10310",13,2,30,26377720,26393174,15454,15.5,"0"
"1059",13,6,18,26398593,26403492,4899,4.9,"0"
"1078",13,5,25,26414863,26425410,10547,10.5,"20"
"1098",13,8,76,26430327,26435482,5155,5.2,"0"
"11011",13,8,12,26437407,26440781,3374,3.4,"0"
"11210",13,2,46,26446094,26453407,7313,7.3,"0"
"1138",13,7,59,26458483,26462965,4482,4.5,"20"
"1148",13,3,23,26464898,26472164,7266,7.3,"20"
"1168",13,2,14,26477381,26487860,10479,10.5,"0"
"1188",13,6,34,26493933,26503669,9736,9.7,"0"
"750",14,8,27,27040731,27046467,5736,5.7,"0"
"940",14,5,24,27053607,27059610,6003,6,"20"
"1139",14,6,9,27077277,27084877,7600,7.6,"0"
"139",14,6,65,27093631,27100717,7086,7.1,"0"
"1412",14,6,41,27104747,27108162,3415,3.4,"0"
"159",14,5,8,27111033,27114827,3794,3.8,"20"
"1710",14,8,51,27119761,27124756,4995,5,"0"
"189",14,2,13,27128003,27131675,3672,3.7,"0"
"208",14,1,44,27137854,27142945,5091,5.1,"20"
"2110",14,5,40,27144867,27147441,2574,2.6,"20"
"225",14,8,35,27150104,27152660,2556,2.6,"0"
"2311",14,3,30,27157098,27159645,2547,2.5,"20"
"259",14,5,32,27164143,27167725,3582,3.6,"20"
"2712",14,2,21,27175901,27178802,2901,2.9,"0"
"2911",14,2,5,27183589,27186423,2834,2.8,"0"
"3111",14,3,70,27194031,27197105,3074,3.1,"20"
"329",14,6,73,27204822,27207391,2569,2.6,"0"
"339",14,1,60,27211932,27215667,3735,3.7,"20"
"348",14,2,29,27219989,27224126,4137,4.1,"0"
"3611",14,6,49,27232998,27235827,2829,2.8,"0"
"378",14,4,15,27240384,27242370,1986,2,"0"
"398",14,5,80,27258701,27261989,3288,3.3,"20"
"409",14,2,45,27263861,27266101,2240,2.2,"0"
"4110",14,1,36,27267891,27270385,2494,2.5,"20"
"4210",14,3,78,27272235,27274645,2410,2.4,"20"
"438",14,7,26,27276844,27279376,2532,2.5,"20"
"4510",14,7,2,27286288,27288505,2217,2.2,"20"
"479",14,1,4,27296661,27299060,2399,2.4,"20"
"499",14,2,37,27306194,27309551,3357,3.4,"0"
"509",14,4,71,27315148,27319639,4491,4.5,"0"
"519",14,4,47,27321495,27326173,4678,4.7,"0"
"529",14,3,6,27328409,27333151,4742,4.7,"20"
"548",14,1,76,27341556,27345526,3970,4,"20"
"558",14,6,17,27347397,27351380,3983,4,"0"
"5712",14,8,59,27357191,27360095,2904,2.9,"0"
"587",14,5,72,27366122,27368716,2594,2.6,"20"
"599",14,7,18,27373393,27376026,2633,2.6,"20"
"618",14,4,39,27384144,27387222,3078,3.1,"0"
"6212",14,5,64,27393119,27395835,2716,2.7,"20"
"635",14,5,56,27400877,27403623,2746,2.7,"20"
"6412",14,3,38,27405467,27409526,4059,4.1,"20"
"655",14,7,10,27411137,27413273,2136,2.1,"20"
"676",14,1,68,27425107,27428186,3079,3.1,"20"
"6811",14,2,69,27431357,27434127,2770,2.8,"0"
"698",14,2,77,27437863,27440469,2606,2.6,"0"
"7010",14,3,54,27449305,27451935,2630,2.6,"20"
"7115",14,8,19,27453840,27456752,2912,2.9,"0"
"7311",14,2,61,27464617,27467845,3228,3.2,"0"
"7410",14,5,48,27469733,27473895,4162,4.2,"20"
"7511",14,7,58,27476644,27479426,2782,2.8,"20"
"767",14,1,12,27484109,27486492,2383,2.4,"20"
"787",14,1,20,27491543,27496733,5190,5.2,"20"
"807",14,7,66,27502556,27506321,3765,3.8,"20"
"8113",14,1,52,27511166,27514230,3064,3.1,"20"
"829",14,7,74,27519336,27524514,5178,5.2,"20"
"837",14,6,25,27526343,27529582,3239,3.2,"0"
"859",14,3,62,27535315,27539251,3936,3.9,"20"
"869",14,8,67,27541098,27543581,2483,2.5,"0"
"8711",14,6,33,27547826,27550219,2393,2.4,"0"
"889",14,6,1,27553153,27556126,2973,3,"0"
"9012",14,6,57,27561164,27565215,4051,4.1,"0"
"9113",14,8,43,27567227,27570250,3023,3,"0"
"9211",14,3,22,27572427,27576239,3812,3.8,"20"
"9410",14,2,53,27581053,27583441,2388,2.4,"0"
"9513",14,4,23,27585068,27586794,1726,1.7,"0"
"9710",14,8,11,27593812,27597206,3394,3.4,"0"
"9911",14,8,3,27602203,27604765,2562,2.6,"0"
"10114",14,7,34,27608825,27611571,2746,2.7,"20"
"10210",14,5,16,27613233,27616309,3076,3.1,"20"
"1047",14,4,31,27624825,27628551,3726,3.7,"0"
"1069",14,8,75,27633638,27636873,3235,3.2,"0"
"1079",14,3,46,27642009,27644403,2394,2.4,"20"
"1088",14,4,55,27646941,27649670,2729,2.7,"0"
"1099",14,7,42,27651958,27655255,3297,3.3,"20"
"11012",14,7,50,27656920,27659316,2396,2.4,"20"
"11111",14,4,79,27662917,27665691,2774,2.8,"0"
"11211",14,4,63,27667331,27669996,2665,2.7,"0"
"11310",14,4,7,27673838,27676555,2717,2.7,"0"
"1158",14,1,28,27682766,27686176,3410,3.4,"20"
"11710",14,3,14,27692430,27696576,4146,4.1,"20"
"1030",15,1,51,1462083,1465027,2944,2.9,"20"
"1140",15,1,67,1468992,1473274,4282,4.3,"20"
"1212",15,6,72,1480642,1486558,5916,5.9,"0"
"1310",15,1,35,1489904,1492386,2482,2.5,"20"
"1413",15,1,27,1495429,1498901,3472,3.5,"20"
"169",15,7,17,1508534,1511832,3298,3.3,"20"
"1810",15,2,44,1523883,1527675,3792,3.8,"0"
"199",15,3,21,1530233,1535340,5107,5.1,"20"
"2111",15,8,10,1542514,1547181,4667,4.7,"0"
"2312",15,3,37,1560490,1564320,3830,3.8,"20"
"247",15,6,16,1567525,1571698,4173,4.2,"0"
"267",15,8,18,1584922,1588123,3201,3.2,"0"
"288",15,7,57,1594560,1598383,3823,3.8,"20"
"2912",15,3,69,1600898,1603764,2866,2.9,"20"
"307",15,2,20,1606235,1610483,4248,4.2,"0"
"3210",15,6,80,1643352,1647599,4247,4.2,"0"
"3310",15,7,65,1650091,1654155,4064,4.1,"20"
"349",15,1,3,1658136,1661897,3761,3.8,"20"
"3612",15,5,7,1704492,1708036,3544,3.5,"20"
"3810",15,6,56,1719575,1722961,3386,3.4,"0"
"399",15,6,32,1729135,1731319,2184,2.2,"0"
"4111",15,8,42,1742698,1746977,4279,4.3,"0"
"4211",15,1,75,1749022,1752424,3402,3.4,"20"
"439",15,8,34,1755007,1758864,3857,3.9,"0"
"449",15,7,25,1771574,1773919,2345,2.3,"20"
"467",15,8,74,1783921,1788294,4373,4.4,"0"
"4710",15,4,38,1790988,1794164,3176,3.2,"0"
"489",15,6,48,1803096,1806887,3791,3.8,"0"
"4910",15,5,79,1812229,1815258,3029,3,"20"
"5010",15,2,52,1817951,1820750,2799,2.8,"0"
"5110",15,8,50,1825187,1828059,2872,2.9,"0"
"5210",15,1,43,1831592,1834490,2898,2.9,"20"
"5312",15,2,68,1841016,1844861,3845,3.8,"0"
"549",15,8,58,1847288,1850107,2819,2.8,"0"
"559",15,2,36,1856048,1859925,3877,3.9,"0"
"569",15,5,71,1867803,1869848,2045,2,"20"
"5713",15,1,59,1898355,1901903,3548,3.5,"20"
"588",15,1,11,1903961,1906039,2078,2.1,"20"
"6011",15,6,40,1916199,1919500,3301,3.3,"0"
"619",15,6,8,1923360,1925817,2457,2.5,"0"
"636",15,7,9,1932972,1936700,3728,3.7,"20"
"656",15,3,77,1950456,1952989,2533,2.5,"20"
"6612",15,7,41,1955767,1958294,2527,2.5,"20"
"677",15,2,28,1960451,1963167,2716,2.7,"0"
"699",15,6,64,1969399,1971427,2028,2,"0"
"7011",15,4,22,1973346,1976346,3000,3,"0"
"7212",15,8,26,1982364,1985671,3307,3.3,"0"
"7411",15,8,66,1992693,1996144,3451,3.5,"0"
"7512",15,5,47,1999595,2003014,3419,3.4,"20"
"768",15,7,1,2007654,2010232,2578,2.6,"20"
"788",15,4,54,2016273,2018886,2613,2.6,"0"
"7912",15,2,60,2020927,2023386,2459,2.5,"0"
"808",15,3,13,2025807,2028880,3073,3.1,"20"
"8210",15,5,31,2038917,2043173,4256,4.3,"20"
"8410",15,4,70,2053838,2059055,5217,5.2,"0"
"8510",15,5,23,2061346,2063869,2523,2.5,"20"
"8712",15,4,62,2070886,2075547,4661,4.7,"0"
"8810",15,7,33,2078569,2080848,2279,2.3,"20"
"8910",15,3,61,2108969,2111602,2633,2.6,"20"
"9013",15,5,39,2114879,2118071,3192,3.2,"20"
"9114",15,3,53,2121151,2123690,2539,2.5,"20"
"9212",15,4,30,2126846,2128564,1718,1.7,"0"
"9411",15,5,55,2138297,2140603,2306,2.3,"20"
"9514",15,2,76,2147632,2149617,1985,2,"0"
"969",15,3,5,2152167,2155033,2866,2.9,"20"
"988",15,5,63,2162224,2165387,3163,3.2,"20"
"9912",15,8,2,2168641,2171380,2739,2.7,"0"
"10115",15,4,78,2185543,2187691,2148,2.1,"0"
"10211",15,2,12,2190038,2192592,2554,2.6,"0"
"1048",15,5,15,2200995,2203419,2424,2.4,"20"
"10610",15,3,45,2209769,2212594,2825,2.8,"20"
"10710",15,7,49,2221066,2223677,2611,2.6,"20"
"1089",15,4,14,2232828,2235591,2763,2.8,"0"
"11013",15,7,73,2245528,2248271,2743,2.7,"20"
"11112",15,4,6,2250481,2253342,2861,2.9,"0"
"11311",15,6,24,2276260,2279031,2771,2.8,"0"
"1159",15,2,4,2321365,2323878,2513,2.5,"0"
"11711",15,1,19,2329999,2332999,3000,3,"20"
"1191",15,3,29,2340050,2342861,2811,2.8,"20"
"1213",15,4,46,2350822,2353593,2771,2.8,"0"
"1040",16,6,71,3299357,3305084,5727,5.7,"0"
"1149",16,7,72,3310996,3317682,6686,6.7,"20"
"1214",16,4,29,3327379,3332007,4628,4.6,"0"
"1414",16,7,48,3349613,3355134,5521,5.5,"20"
"1510",16,7,40,3359412,3367325,7913,7.9,"20"
"1610",16,7,56,3369300,3374834,5534,5.5,"20"
"1711",16,6,7,3379949,3384083,4134,4.1,"0"
"1910",16,3,36,3390924,3394964,4040,4,"20"
"209",16,2,75,3400271,3404371,4100,4.1,"0"
"2112",16,8,73,3408613,3414041,5428,5.4,"0"
"226",16,1,34,3422335,3427462,5127,5.1,"20"
"2313",16,8,49,3432184,3436562,4378,4.4,"0"
"248",16,2,27,3452390,3456805,4415,4.4,"0"
"268",16,5,14,3501118,3505270,4152,4.2,"20"
"289",16,4,69,3517573,3521884,4311,4.3,"0"
"2913",16,7,64,3523885,3527958,4073,4.1,"20"
"308",16,1,42,3529916,3533656,3740,3.7,"20"
"3112",16,1,2,3535697,3539358,3661,3.7,"20"
"3311",16,6,47,3545734,3550246,4512,4.5,"0"
"3410",16,4,13,3552263,3557452,5189,5.2,"0"
"3613",16,6,39,3563337,3568068,4731,4.7,"0"
"379",16,1,18,3571196,3575004,3808,3.8,"20"
"3910",16,6,15,3581714,3584735,3021,3,"0"
"4112",16,2,51,3589847,3595445,5598,5.6,"0"
"4212",16,1,50,3597435,3602549,5114,5.1,"20"
"4310",16,3,60,3604466,3607677,3211,3.2,"20"
"4410",16,8,33,3611179,3613903,2724,2.7,"0"
"4511",16,5,78,3617603,3621129,3526,3.5,"20"
"468",16,5,38,3622951,3628348,5397,5.4,"20"
"4711",16,5,30,3632301,3635452,3151,3.2,"20"
"4911",16,3,68,3642987,3646434,3447,3.4,"20"
"5011",16,1,66,3651246,3655321,4075,4.1,"20"
"5111",16,5,70,3657806,3661637,3831,3.8,"20"
"5211",16,2,11,3664002,3667245,3243,3.2,"0"
"5410",16,4,77,3672878,3677697,4819,4.8,"0"
"5510",16,3,28,3681472,3685690,4218,4.2,"20"
"5714",16,8,57,3691403,3696148,4745,4.7,"0"
"589",16,3,44,3698093,3701787,3694,3.7,"20"
"5910",16,6,63,3704125,3708879,4754,4.8,"0"
"6012",16,7,24,3711845,3717708,5863,5.9,"20"
"6213",16,3,20,3726127,3729012,2885,2.9,"20"
"6413",16,3,76,3736408,3740354,3946,3.9,"20"
"657",16,5,54,3742909,3749319,6410,6.4,"20"
"6613",16,1,58,3751205,3754956,3751,3.8,"20"
"678",16,2,67,3756664,3762379,5715,5.7,"0"
"6812",16,7,8,3765663,3769551,3888,3.9,"20"
"7012",16,4,5,3775811,3779353,3542,3.5,"0"
"7213",16,5,22,3785542,3789453,3911,3.9,"20"
"7412",16,8,25,3799350,3804106,4756,4.8,"0"
"769",16,8,17,3811470,3814800,3330,3.3,"0"
"789",16,3,52,3821369,3824963,3594,3.6,"20"
"7913",16,2,59,3828610,3834017,5407,5.4,"0"
"809",16,6,31,3836815,3841312,4497,4.5,"0"
"8211",16,8,1,3847279,3853046,5767,5.8,"0"
"8411",16,1,74,3887665,3891088,3423,3.4,"20"
"8511",16,7,16,3892990,3896384,3394,3.4,"20"
"8713",16,4,53,3904121,3908854,4733,4.7,"0"
"8811",16,4,21,3910856,3914465,3609,3.6,"0"
"9014",16,1,10,3929776,3935699,5923,5.9,"20"
"9213",16,4,61,3943355,3947955,4600,4.6,"0"
"9312",16,5,62,3951130,3955904,4774,4.8,"20"
"9412",16,2,43,3958945,3962483,3538,3.5,"0"
"9515",16,5,46,3964466,3967779,3313,3.3,"20"
"9610",16,6,79,3972124,3976152,4028,4,"0"
"9711",16,8,41,3980667,3984294,3627,3.6,"0"
"989",16,4,37,3987084,3993616,6532,6.5,"0"
"9913",16,6,23,3999690,4002485,2795,2.8,"0"
"10116",16,8,65,4008580,4013252,4672,4.7,"0"
"10212",16,3,4,4016618,4020181,3563,3.6,"20"
"1049",16,4,45,4025732,4029154,3422,3.4,"0"
"10510",16,2,3,4031066,4035027,3961,4,"0"
"10711",16,7,32,4042201,4046231,4030,4,"20"
"10910",16,8,9,4058234,4063581,5347,5.3,"0"
"11113",16,3,12,4076046,4079884,3838,3.8,"20"
"11312",16,7,80,4089524,4092722,3198,3.2,"20"
"11410",16,5,6,4097724,4102327,4603,4.6,"20"
"1169",16,6,55,4113811,4118112,4301,4.3,"0"
"11712",16,1,26,4120564,4125548,4984,5,"20"
"1192",16,2,19,4138034,4142288,4254,4.3,"0"
"1215",16,2,35,4148316,4151725,3409,3.4,"0"
"1050",17,8,32,7083919,7089580,5661,5.7,"0"
"1216",17,1,73,7095327,7099135,3808,3.8,"20"
"1311",17,6,54,7101065,7105029,3964,4,"0"
"1415",17,8,24,7107049,7110808,3759,3.8,"0"
"1611",17,4,28,7118794,7123700,4906,4.9,"0"
"1811",17,4,44,7128963,7132053,3090,3.1,"0"
"1911",17,5,29,7134833,7138421,3588,3.6,"20"
"2113",17,7,31,7143877,7150642,6765,6.8,"20"
"2314",17,7,71,7156760,7160111,3351,3.4,"20"
"249",17,8,72,7162126,7165799,3673,3.7,"0"
"2510",17,2,26,7167859,7171423,3564,3.6,"0"
"2713",17,6,14,7179398,7183098,3700,3.7,"0"
"2914",17,1,65,7190604,7196976,6372,6.4,"20"
"309",17,6,22,7199302,7203899,4597,4.6,"0"
"3211",17,5,61,7211002,7217566,6564,6.6,"20"
"3312",17,5,45,7219914,7223259,3345,3.3,"20"
"3411",17,8,64,7225267,7228182,2915,2.9,"0"
"358",17,3,11,7231697,7236572,4875,4.9,"20"
"3710",17,3,67,7242727,7246914,4187,4.2,"20"
"3811",17,6,70,7249055,7252821,3766,3.8,"0"
"3911",17,4,68,7254998,7257899,2901,2.9,"0"
"4010",17,8,56,7260263,7264302,4039,4,"0"
"4113",17,3,35,7266961,7271398,4437,4.4,"20"
"4213",17,1,41,7273454,7276111,2657,2.7,"20"
"4311",17,3,19,7278038,7280685,2647,2.6,"20"
"4512",17,1,17,7287308,7290556,3248,3.2,"20"
"4712",17,4,76,7295581,7299717,4136,4.1,"0"
"4810",17,2,74,7301483,7305894,4411,4.4,"0"
"4912",17,5,21,7309229,7313462,4233,4.2,"20"
"5112",17,1,9,7318704,7323279,4575,4.6,"20"
"5313",17,5,53,7328232,7333268,5036,5,"20"
"5411",17,4,52,7336364,7339633,3269,3.3,"0"
"5511",17,4,12,7341786,7346045,4259,4.3,"0"
"5715",17,8,16,7351832,7355743,3911,3.9,"0"
"5911",17,3,43,7363443,7366327,2884,2.9,"20"
"6013",17,3,3,7368249,7371852,3603,3.6,"20"
"6214",17,7,7,7377320,7380636,3316,3.3,"20"
"6414",17,8,8,7391098,7395372,4274,4.3,"0"
"6614",17,3,75,7401527,7405260,3733,3.7,"20"
"679",17,8,80,7407760,7411990,4230,4.2,"0"
"6813",17,6,30,7413923,7416572,2649,2.6,"0"
"7013",17,5,69,7421285,7424610,3325,3.3,"20"
"7116",17,1,49,7426510,7430358,3848,3.8,"20"
"7214",17,4,36,7432252,7435400,3148,3.1,"0"
"7312",17,6,46,7437195,7442145,4950,5,"0"
"7413",17,5,77,7444014,7446913,2899,2.9,"20"
"7513",17,2,34,7449427,7453242,3815,3.8,"0"
"7610",17,7,55,7455202,7458537,3335,3.3,"20"
"7711",17,1,57,7461537,7465281,3744,3.7,"20"
"7810",17,5,5,7467382,7470864,3482,3.5,"20"
"8010",17,2,18,7477297,7480960,3663,3.7,"0"
"8212",17,2,42,7486656,7489895,3239,3.2,"0"
"838",17,7,23,7491912,7494593,2681,2.7,"20"
"8512",17,2,2,7499824,7502640,2816,2.8,"0"
"8714",17,4,60,7508538,7511313,2775,2.8,"0"
"8812",17,2,10,7513225,7518851,5626,5.6,"0"
"9015",17,5,37,7524216,7528947,4731,4.7,"20"
"9115",17,7,15,7530825,7534521,3696,3.7,"20"
"9313",17,7,39,7540060,7546819,6759,6.8,"20"
"9413",17,8,48,7548755,7551975,3220,3.2,"0"
"9516",17,7,47,7555220,7559394,4174,4.2,"20"
"9611",17,4,4,7561318,7564162,2844,2.8,"0"
"9810",17,6,62,7568287,7573330,5043,5,"0"
"9914",17,2,50,7575547,7578541,2994,3,"0"
"1008",17,7,63,7580628,7584764,4136,4.1,"20"
"10117",17,8,40,7587005,7589566,2561,2.6,"0"
"10213",17,1,25,7591819,7594635,2816,2.8,"20"
"10410",17,2,58,7599303,7606431,7128,7.1,"0"
"10511",17,3,51,7608449,7612526,4077,4.1,"20"
"10611",17,6,6,7614204,7618138,3934,3.9,"0"
"10810",17,1,1,7623006,7626012,3006,3,"20"
"11014",17,3,27,7632100,7635136,3036,3,"20"
"11212",17,2,66,7640352,7644354,4002,4,"0"
"11313",17,6,38,7647101,7652148,5047,5,"0"
"11411",17,7,79,7654185,7657054,2869,2.9,"20"
"11510",17,6,78,7659316,7662638,3322,3.3,"0"
"11610",17,5,13,7664327,7668576,4249,4.2,"20"
"1189",17,1,33,7673626,7676234,2608,2.6,"20"
"1193",17,3,59,7677949,7681346,3397,3.4,"20"
"120",17,4,20,7683122,7686306,3184,3.2,"0"
"1060",18,5,52,9121738,9124747,3009,3,"20"
"1150",18,4,43,9126972,9129715,2743,2.7,"0"
"1217",18,3,66,9133452,9136179,2727,2.7,"20"
"1312",18,2,49,9138435,9141081,2646,2.6,"0"
"1416",18,3,50,9145523,9147718,2195,2.2,"20"
"1511",18,4,67,9152080,9155559,3479,3.5,"0"
"1612",18,5,60,9159257,9161314,2057,2.1,"20"
"1712",18,7,30,9165312,9167901,2589,2.6,"20"
"1912",18,4,3,9175731,9178068,2337,2.3,"0"
"2114",18,6,13,9182763,9185119,2356,2.4,"0"
"2315",18,5,4,9191291,9195139,3848,3.8,"20"
"2511",18,4,35,9202652,9204778,2126,2.1,"0"
"269",18,3,58,9211285,9214909,3624,3.6,"20"
"2714",18,3,34,9221273,9224518,3245,3.2,"20"
"2810",18,2,1,9228587,9231011,2424,2.4,"0"
"3010",18,1,40,9236626,9239009,2383,2.4,"20"
"3113",18,8,47,9242892,9246932,4040,4,"0"
"3212",18,3,2,9251352,9253696,2344,2.3,"20"
"3412",18,5,28,9260146,9266043,5897,5.9,"20"
"3614",18,4,11,9278397,9281114,2717,2.7,"0"
"3812",18,3,26,9288537,9290915,2378,2.4,"20"
"4011",18,6,53,9301941,9305499,3558,3.6,"0"
"4114",18,6,61,9307700,9311406,3706,3.7,"0"
"4214",18,6,5,9315458,9318387,2929,2.9,"0"
"4411",18,2,17,9327119,9330225,3106,3.1,"0"
"469",18,7,6,9336901,9342252,5351,5.4,"20"
"4811",18,2,57,9348763,9354160,5397,5.4,"0"
"4913",18,8,79,9357109,9368887,11778,11.8,"0"
"5012",18,7,54,9374866,9377759,2893,2.9,"20"
"5113",18,3,10,9381185,9384911,3726,3.7,"20"
"5314",18,4,51,9392528,9396031,3503,3.5,"0"
"5412",18,6,21,9399750,9403147,3397,3.4,"0"
"5610",18,2,25,9408495,9412634,4139,4.1,"0"
"5810",18,7,14,9419950,9426156,6206,6.2,"20"
"6014",18,1,56,9433335,9436450,3115,3.1,"20"
"6110",18,7,78,9438757,9441531,2774,2.8,"20"
"6215",18,4,19,9444967,9447812,2845,2.8,"0"
"6415",18,7,22,9454386,9456589,2203,2.2,"20"
"6615",18,7,70,9462233,9464262,2029,2,"20"
"6710",18,1,64,9466262,9468320,2058,2.1,"20"
"6814",18,7,46,9472745,9475813,3068,3.1,"20"
"6910",18,6,45,9479235,9481552,2317,2.3,"0"
"7014",18,3,42,9485359,9488309,2950,3,"20"
"7117",18,3,74,9490548,9493418,2870,2.9,"20"
"7215",18,5,36,9497038,9499931,2893,2.9,"20"
"7313",18,5,44,9502633,9506498,3865,3.9,"20"
"7414",18,6,69,9512216,9515454,3238,3.2,"0"
"7514",18,8,71,9517579,9520689,3110,3.1,"0"
"7611",18,5,68,9526563,9529219,2656,2.7,"20"
"7712",18,5,12,9533290,9537052,3762,3.8,"20"
"7914",18,2,41,9543680,9546091,2411,2.4,"0"
"8011",18,1,72,9549171,9554760,5589,5.6,"20"
"8114",18,4,75,9556891,9559475,2584,2.6,"0"
"8213",18,8,15,9566561,9570165,3604,3.6,"0"
"8412",18,7,38,9577175,9579823,2648,2.6,"20"
"8513",18,5,76,9583057,9587553,4496,4.5,"20"
"8610",18,1,32,9590254,9592369,2115,2.1,"20"
"8813",18,1,16,9597566,9599916,2350,2.4,"20"
"9016",18,8,23,9604515,9606819,2304,2.3,"0"
"9214",18,3,18,9611346,9613147,1801,1.8,"20"
"9414",18,2,65,9619971,9622354,2383,2.4,"0"
"9517",18,8,63,9624357,9628487,4130,4.1,"0"
"9612",18,6,37,9632806,9635643,2837,2.8,"0"
"9712",18,4,27,9639954,9647052,7098,7.1,"0"
"9915",18,1,8,9656127,9659148,3021,3,"20"
"10118",18,2,73,9664276,9666571,2295,2.3,"0"
"10214",18,2,33,9672192,9674565,2373,2.4,"0"
"10311",18,7,62,9676284,9680718,4434,4.4,"20"
"10411",18,6,77,9684148,9687374,3226,3.2,"0"
"10512",18,2,9,9689614,9692331,2717,2.7,"0"
"10712",18,6,29,9698485,9700811,2326,2.3,"0"
"10911",18,8,39,9707907,9711723,3816,3.8,"0"
"11015",18,1,24,9717354,9720782,3428,3.4,"20"
"11213",18,8,55,9725523,9728706,3183,3.2,"0"
"11314",18,8,7,9732497,9735099,2602,2.6,"0"
"11511",18,1,48,9741418,9744335,2917,2.9,"20"
"11611",18,8,31,9746672,9750250,3578,3.6,"0"
"11810",18,4,59,9756833,9762236,5403,5.4,"0"
"1194",18,5,20,9766249,9768234,1985,2,"20"
"1218",18,1,80,9776105,9780215,4110,4.1,"20"
"1070",19,3,17,10585184,10590644,5460,5.5,"20"
"1219",19,5,43,10597957,10603302,5345,5.3,"20"
"1313",19,1,39,10605304,10609335,4031,4,"20"
"1417",19,4,58,10613062,10617361,4299,4.3,"0"
"1512",19,7,53,10621005,10624432,3427,3.4,"20"
"1613",19,3,9,10628251,10632200,3949,3.9,"20"
"1812",19,4,10,10641464,10645675,4211,4.2,"0"
"2010",19,6,4,10652955,10657372,4417,4.4,"0"
"227",19,5,27,10663665,10666403,2738,2.7,"20"
"2410",19,6,76,10674891,10678438,3547,3.5,"0"
"2512",19,7,77,10682224,10687154,4930,4.9,"20"
"2610",19,2,8,10689859,10692876,3017,3,"0"
"2811",19,8,6,10699552,10703960,4408,4.4,"0"
"3011",19,2,24,10710580,10713073,2493,2.5,"0"
"3213",19,8,22,10720206,10724668,4462,4.5,"0"
"3413",19,2,32,10733454,10737684,4230,4.2,"0"
"3615",19,3,73,10747090,10751219,4129,4.1,"20"
"3711",19,3,1,10756708,10760348,3640,3.6,"20"
"3912",19,5,19,10765700,10769099,3399,3.4,"20"
"4115",19,4,66,10774369,10778527,4158,4.2,"0"
"4215",19,5,35,10780688,10784369,3681,3.7,"20"
"4312",19,3,41,10787787,10790886,3099,3.1,"20"
"4412",19,7,29,10794510,10797843,3333,3.3,"20"
"4610",19,6,12,10805709,10809159,3450,3.5,"0"
"4812",19,2,40,10819785,10822588,2803,2.8,"0"
"4914",19,7,45,10827498,10830924,3426,3.4,"20"
"5013",19,8,46,10836161,10839260,3099,3.1,"0"
"5114",19,2,56,10842426,10844823,2397,2.4,"0"
"5212",19,8,78,10847097,10850373,3276,3.3,"0"
"5315",19,8,54,10856280,10859546,3266,3.3,"0"
"5413",19,2,64,10862836,10866827,3991,4,"0"
"5512",19,1,31,10868805,10871860,3055,3.1,"20"
"5716",19,3,33,10879071,10881931,2860,2.9,"20"
"5811",19,1,63,10883902,10886818,2916,2.9,"20"
"5912",19,6,44,10890265,10893090,2825,2.8,"0"
"6015",19,5,51,10896650,10899053,2403,2.4,"20"
"6111",19,2,16,10901194,10904001,2807,2.8,"0"
"637",19,1,55,10910740,10913602,2862,2.9,"20"
"6416",19,7,61,10915477,10918701,3224,3.2,"20"
"658",19,3,65,10920559,10924227,3668,3.7,"20"
"6616",19,6,36,10928332,10932389,4057,4.1,"0"
"6711",19,2,72,10937026,10940205,3179,3.2,"0"
"6815",19,1,7,10942201,10945128,2927,2.9,"20"
"7015",19,8,70,10952533,10955790,3257,3.3,"0"
"7118",19,7,5,10958513,10961134,2621,2.6,"20"
"7314",19,2,80,10966556,10969160,2604,2.6,"0"
"7415",19,7,37,10971161,10974347,3186,3.2,"20"
"7515",19,1,71,10976277,10978904,2627,2.6,"20"
"7612",19,6,60,10984088,10986906,2818,2.8,"0"
"7713",19,7,21,10989653,10992665,3012,3,"20"
"7915",19,8,38,10998532,11001515,2983,3,"0"
"8012",19,7,69,11003640,11006295,2655,2.7,"20"
"8115",19,4,2,11009820,11012186,2366,2.4,"0"
"839",19,4,50,11019559,11022375,2816,2.8,"0"
"8413",19,1,47,11024982,11026856,1874,1.9,"20"
"8514",19,3,57,11030407,11032669,2262,2.3,"20"
"8611",19,4,18,11034411,11036837,2426,2.4,"0"
"8814",19,3,49,11046447,11049266,2819,2.8,"20"
"8911",19,4,74,11053613,11056837,3224,3.2,"0"
"9017",19,6,68,11061188,11063657,2469,2.5,"0"
"9116",19,5,3,11065400,11068039,2639,2.6,"20"
"9314",19,5,75,11075673,11078242,2569,2.6,"20"
"9415",19,7,13,11083195,11085859,2664,2.7,"20"
"9613",19,5,67,11090972,11093734,2762,2.8,"20"
"9713",19,5,59,11099885,11102111,2226,2.2,"20"
"9811",19,6,52,11104097,11106177,2080,2.1,"0"
"9916",19,4,42,11112631,11115487,2856,2.9,"0"
"1009",19,1,15,11120239,11122148,1909,1.9,"20"
"10215",19,2,48,11127437,11129650,2213,2.2,"0"
"10312",19,1,23,11134892,11137279,2387,2.4,"20"
"10513",19,4,34,11142114,11145059,2945,2.9,"0"
"10612",19,3,25,11147012,11149497,2485,2.5,"20"
"10811",19,5,11,11159106,11162041,2935,2.9,"20"
"11016",19,1,79,11169578,11173141,3563,3.6,"20"
"11114",19,8,30,11178527,11181109,2582,2.6,"0"
"11315",19,6,20,11186253,11188361,2108,2.1,"0"
"11512",19,6,28,11193934,11196690,2756,2.8,"0"
"11713",19,4,26,11203725,11206709,2984,3,"0"
"1195",19,8,62,11214882,11219080,4198,4.2,"0"
"1201",19,8,14,11222618,11225531,2913,2.9,"0"
"1080",20,8,37,15989914,15995229,5315,5.3,"0"
"1160",20,1,38,15999409,16005369,5960,6,"20"
"1220",20,5,50,16010270,16014436,4166,4.2,"20"
"1314",20,6,59,16017501,16023055,5554,5.6,"0"
"1418",20,7,44,16025596,16029749,4153,4.2,"20"
"1513",20,8,61,16041533,16047808,6275,6.3,"0"
"1614",20,2,55,16049624,16055800,6176,6.2,"0"
"1713",20,5,18,16059783,16063998,4215,4.2,"20"
"1913",20,6,43,16070500,16073994,3494,3.5,"0"
"2011",20,7,52,16080890,16086409,5519,5.5,"20"
"2115",20,3,40,16090137,16096000,5863,5.9,"20"
"228",20,4,41,16103140,16107612,4472,4.5,"0"
"2316",20,1,14,16112377,16119498,7121,7.1,"20"
"2513",20,2,31,16128896,16133799,4903,4.9,"0"
"2715",20,5,26,16138632,16143483,4851,4.9,"20"
"2915",20,4,33,16155264,16161481,6217,6.2,"0"
"3012",20,3,24,16165083,16171273,6190,6.2,"20"
"3214",20,6,51,16177985,16181061,3076,3.1,"0"
"3313",20,7,68,16184253,16187365,3112,3.1,"20"
"3414",20,3,16,16193844,16197615,3771,3.8,"20"
"3616",20,6,19,16203290,16206936,3646,3.6,"0"
"3813",20,8,5,16217617,16220974,3357,3.4,"0"
"4012",20,5,74,16226896,16230828,3932,3.9,"20"
"4116",20,1,62,16232699,16239684,6985,7,"20"
"4216",20,2,47,16247351,16249817,2466,2.5,"0"
"4313",20,5,10,16252194,16257227,5033,5,"20"
"4513",20,4,9,16262837,16267043,4206,4.2,"0"
"4713",20,2,63,16273677,16279761,6084,6.1,"0"
"4813",20,4,17,16284803,16288983,4180,4.2,"0"
"5014",20,8,13,16294572,16298639,4067,4.1,"0"
"5213",20,1,70,16305333,16310510,5177,5.2,"20"
"5316",20,6,27,16314231,16319019,4788,4.8,"0"
"5513",20,2,39,16327261,16331549,4288,4.3,"0"
"5611",20,6,35,16334941,16340804,5863,5.9,"0"
"5717",20,4,49,16348224,16351227,3003,3,"0"
"5812",20,2,15,16368728,16372545,3817,3.8,"0"
"6016",20,1,54,16378234,16383957,5723,5.7,"20"
"6112",20,4,73,16385862,16390535,4673,4.7,"0"
"6216",20,7,60,16395118,16399417,4299,4.3,"20"
"638",20,3,32,16401594,16406503,4909,4.9,"20"
"659",20,7,28,16411892,16417850,5958,6,"20"
"6712",20,8,21,16423930,16428223,4293,4.3,"0"
"6911",20,7,12,16434989,16438412,3423,3.4,"20"
"7119",20,6,75,16443285,16448375,5090,5.1,"0"
"7216",20,1,78,16451871,16456484,4613,4.6,"20"
"7315",20,7,4,16461942,16467268,5326,5.3,"20"
"7516",20,7,76,16475853,16485425,9572,9.6,"20"
"7613",20,4,25,16488394,16492105,3711,3.7,"0"
"7811",20,2,79,16500089,16504579,4490,4.5,"0"
"7916",20,1,46,16506685,16510640,3955,4,"20"
"8013",20,2,7,16515967,16521370,5403,5.4,"0"
"8214",20,6,3,16531816,16537950,6134,6.1,"0"
"8414",20,6,67,16546266,16551547,5281,5.3,"0"
"8515",20,3,80,16553677,16558772,5095,5.1,"20"
"8612",20,5,58,16565492,16571426,5934,5.9,"20"
"8715",20,8,77,16581845,16586371,4526,4.5,"0"
"8815",20,8,29,16590729,16597207,6478,6.5,"0"
"9018",20,1,6,16605926,16614747,8821,8.8,"20"
"9215",20,5,2,16648171,16651554,3383,3.4,"20"
"9416",20,5,66,16658406,16662645,4239,4.2,"20"
"9518",20,5,34,16665158,16669367,4209,4.2,"20"
"9614",20,4,57,16671380,16675774,4394,4.4,"0"
"9714",20,4,1,16678176,16683754,5578,5.6,"0"
"9917",20,3,72,16690668,16697055,6387,6.4,"20"
"10010",20,8,45,16700755,16704298,3543,3.5,"0"
"10119",20,3,64,16706572,16711229,4657,4.7,"20"
"10216",20,3,8,16713658,16720931,7273,7.3,"20"
"10412",20,4,65,16728650,16733649,4999,5,"0"
"10514",20,1,22,16743393,16750028,6635,6.6,"20"
"10713",20,7,36,16757779,16762292,4513,4.5,"20"
"10812",20,3,56,16766608,16770433,3825,3.8,"20"
"10912",20,6,11,16772522,16777695,5173,5.2,"0"
"11115",20,7,20,16783947,16788590,4643,4.6,"20"
"11316",20,3,48,16793671,16799574,5903,5.9,"20"
"11412",20,2,71,16806374,16812593,6219,6.2,"0"
"11513",20,5,42,16814959,16821361,6402,6.4,"20"
"11612",20,1,30,16825868,16831504,5636,5.6,"20"
"11811",20,8,69,16835948,16840927,4979,5,"0"
"1196",20,8,53,16844277,16849219,4942,4.9,"0"
"1202",20,2,23,16851278,16854142,2864,2.9,"0"
"1090",21,4,72,17853218,17856016,2798,2.8,"0"
"1170",21,3,47,17859032,17861230,2198,2.2,"20"
"1221",21,7,43,17864401,17867992,3591,3.6,"20"
"1315",21,3,7,17870877,17874305,3428,3.4,"20"
"1514",21,7,35,17882726,17885287,2561,2.6,"20"
"1615",21,8,28,17887937,17890447,2510,2.5,"0"
"1813",21,8,44,17894887,17897899,3012,3,"0"
"1914",21,8,60,17899946,17901609,1663,1.7,"0"
"2012",21,1,29,17904026,17906454,2428,2.4,"20"
"229",21,6,66,17910584,17912352,1768,1.8,"0"
"2317",21,5,57,17914466,17916737,2271,2.3,"20"
"2411",21,1,45,17918719,17920929,2210,2.2,"20"
"2514",21,2,54,17923459,17925456,1997,2,"0"
"2611",21,3,15,17927387,17929120,1733,1.7,"20"
"2812",21,8,4,17934162,17935945,1783,1.8,"0"
"3013",21,7,3,17939858,17942110,2252,2.3,"20"
"3215",21,1,21,17946464,17948295,1831,1.8,"20"
"3415",21,7,11,17952834,17954481,1647,1.6,"20"
"3617",21,2,22,17958709,17961534,2825,2.8,"0"
"3814",21,1,77,17966020,17967842,1822,1.8,"20"
"3913",21,7,67,17971979,17974037,2058,2.1,"20"
"4013",21,4,24,17977015,17979325,2310,2.3,"0"
"4217",21,1,5,17985118,17986903,1785,1.8,"20"
"4413",21,2,78,17992394,17994654,2260,2.3,"0"
"4514",21,8,52,17996800,17998770,1970,2,"0"
"4611",21,4,80,18002179,18003823,1644,1.6,"0"
"4714",21,1,69,18005669,18007500,1831,1.8,"20"
"4814",21,6,2,18009619,18011517,1898,1.9,"0"
"5015",21,8,68,18017730,18019383,1653,1.7,"0"
"5115",21,6,26,18021630,18023147,1517,1.5,"0"
"5317",21,5,41,18027200,18028697,1497,1.5,"20"
"5414",21,5,73,18030991,18032788,1797,1.8,"20"
"5514",21,1,61,18034825,18037071,2246,2.2,"20"
"5612",21,3,71,18039040,18040798,1758,1.8,"20"
"5718",21,3,39,18043316,18044875,1559,1.6,"20"
"5813",21,4,40,18046974,18048647,1673,1.7,"0"
"5913",21,5,33,18050506,18052020,1514,1.5,"20"
"6017",21,6,18,18054015,18055594,1579,1.6,"0"
"6217",21,6,10,18059617,18061222,1605,1.6,"0"
"6417",21,6,50,18066449,18067788,1339,1.3,"0"
"6510",21,8,20,18069997,18071519,1522,1.5,"0"
"6713",21,3,79,18076179,18077712,1533,1.5,"20"
"6816",21,7,19,18080265,18081598,1333,1.3,"20"
"7016",21,6,42,18086093,18087661,1568,1.6,"0"
"7120",21,4,16,18091351,18092865,1514,1.5,"0"
"7316",21,2,38,18099237,18100855,1618,1.6,"0"
"7416",21,4,32,18102832,18104675,1843,1.8,"0"
"7614",21,5,9,18108574,18110254,1680,1.7,"20"
"7812",21,3,63,18115052,18116755,1703,1.7,"20"
"7917",21,6,34,18118800,18120517,1717,1.7,"0"
"8014",21,7,75,18123098,18124423,1325,1.3,"20"
"8116",21,6,74,18126246,18127543,1297,1.3,"0"
"8215",21,2,6,18131351,18134756,3405,3.4,"0"
"8415",21,8,76,18139256,18140860,1604,1.6,"0"
"8516",21,5,65,18144729,18146627,1898,1.9,"20"
"8613",21,1,13,18148780,18150423,1643,1.6,"20"
"8816",21,4,48,18154660,18156703,2043,2,"0"
"8912",21,7,51,18159183,18160646,1463,1.5,"20"
"9019",21,4,64,18163077,18164520,1443,1.4,"0"
"9117",21,7,27,18166584,18168205,1621,1.6,"20"
"9315",21,7,59,18172185,18174275,2090,2.1,"20"
"9417",21,5,49,18177104,18178894,1790,1.8,"20"
"9519",21,8,36,18180706,18182875,2169,2.2,"0"
"9615",21,1,37,18184933,18187232,2299,2.3,"20"
"9715",21,4,56,18189248,18190306,1058,1.1,"0"
"9812",21,5,17,18192245,18194097,1852,1.9,"20"
"10011",21,3,23,18198527,18199639,1112,1.1,"20"
"10217",21,1,53,18204326,18206800,2474,2.5,"20"
"10313",21,2,62,18209778,18211157,1379,1.4,"0"
"10413",21,3,55,18213440,18215798,2358,2.4,"20"
"10515",21,6,58,18217859,18219495,1636,1.6,"0"
"10613",21,8,12,18221513,18222684,1171,1.2,"0"
"10813",21,2,70,18228235,18229944,1709,1.7,"0"
"10913",21,4,8,18232627,18233887,1260,1.3,"0"
"11116",21,5,1,18237906,18239248,1342,1.3,"20"
"11317",21,2,30,18243461,18245422,1961,2,"0"
"11514",21,2,14,18250240,18251976,1736,1.7,"0"
"11714",21,2,46,18258010,18259215,1205,1.2,"0"
"11812",21,5,25,18261159,18262571,1412,1.4,"20"
"1203",21,3,31,18266511,18268208,1697,1.7,"20"
"10100",22,6,17,21307740,21313748,6008,6,"0"
"1222",22,2,5,21321620,21327616,5996,6,"0"
"1419",22,3,30,21333679,21337143,3464,3.5,"20"
"1616",22,6,73,21342043,21345692,3649,3.6,"0"
"1714",22,4,79,21349057,21352608,3551,3.6,"0"
"1814",22,7,10,21355973,21359568,3595,3.6,"20"
"2013",22,2,77,21367194,21370205,3011,3,"0"
"2116",22,1,12,21372510,21375338,2828,2.8,"20"
"2318",22,7,26,21383648,21387522,3874,3.9,"20"
"2515",22,6,41,21393504,21397074,3570,3.6,"0"
"2612",22,1,52,21399258,21402394,3136,3.1,"20"
"2716",22,4,31,21404783,21408359,3576,3.6,"0"
"2916",22,8,67,21414396,21420143,5747,5.7,"0"
"3014",22,7,34,21425126,21431584,6458,6.5,"20"
"3114",22,8,51,21433733,21440130,6397,6.4,"0"
"3216",22,6,25,21443130,21446692,3562,3.6,"0"
"3416",22,6,49,21452664,21455698,3034,3,"0"
"359",22,5,64,21459748,21462687,2939,2.9,"20"
"3618",22,8,59,21468043,21472140,4097,4.1,"0"
"3712",22,5,72,21474180,21479788,5608,5.6,"20"
"3815",22,4,47,21482461,21487417,4956,5,"0"
"3914",22,1,60,21489900,21493433,3533,3.5,"20"
"4014",22,1,20,21496812,21501812,5000,5,"20"
"4218",22,5,8,21510943,21514922,3979,4,"20"
"4414",22,2,37,21522491,21525190,2699,2.7,"0"
"4515",22,1,28,21530639,21536027,5388,5.4,"20"
"4715",22,1,36,21544003,21550669,6666,6.7,"20"
"4815",22,5,48,21554800,21558637,3837,3.8,"20"
"4915",22,4,15,21561040,21563523,2483,2.5,"0"
"5116",22,3,46,21569281,21572480,3199,3.2,"20"
"5214",22,5,32,21574638,21578792,4154,4.2,"20"
"5415",22,7,18,21584059,21587040,2981,3,"20"
"5613",22,7,50,21596023,21599210,3187,3.2,"20"
"5719",22,4,71,21601531,21604687,3156,3.2,"0"
"5814",22,6,9,21606937,21609904,2967,3,"0"
"6018",22,2,21,21618720,21624156,5436,5.4,"0"
"6218",22,7,66,21631464,21638855,7391,7.4,"20"
"639",22,1,68,21641284,21643748,2464,2.5,"20"
"6418",22,5,56,21652308,21655943,3635,3.6,"20"
"6511",22,6,33,21658254,21661121,2867,2.9,"0"
"6617",22,7,42,21664225,21668135,3910,3.9,"20"
"6714",22,3,38,21715331,21720745,5414,5.4,"20"
"6817",22,7,74,21722942,21726745,3803,3.8,"20"
"6912",22,1,4,21728861,21732000,3139,3.1,"20"
"7121",22,4,55,21740281,21743962,3681,3.7,"0"
"7217",22,2,45,21748822,21751172,2350,2.4,"0"
"7317",22,5,40,21755180,21757640,2460,2.5,"20"
"7417",22,7,2,21760258,21763256,2998,3,"20"
"7615",22,1,44,21770363,21773639,3276,3.3,"20"
"7714",22,8,27,21775719,21779504,3785,3.8,"0"
"7918",22,3,14,21785399,21789884,4485,4.5,"20"
"8117",22,3,6,21798483,21806172,7689,7.7,"20"
"8310",22,8,11,21811857,21814535,2678,2.7,"0"
"8517",22,5,24,21820914,21825032,4118,4.1,"20"
"8716",22,1,76,21832466,21836669,4203,4.2,"20"
"8817",22,2,29,21840128,21844158,4030,4,"0"
"9020",22,6,65,21852372,21855647,3275,3.3,"0"
"9118",22,3,78,21860972,21864650,3678,3.7,"20"
"9216",22,8,43,21867003,21870203,3200,3.2,"0"
"9316",22,3,54,21875877,21878815,2938,2.9,"20"
"9418",22,6,1,21882361,21885180,2819,2.8,"0"
"9616",22,2,61,21891664,21896047,4383,4.4,"0"
"9716",22,2,69,21899801,21903527,3726,3.7,"0"
"9813",22,2,53,21911853,21915378,3525,3.5,"0"
"9918",22,8,19,21922614,21925413,2799,2.8,"0"
"10120",22,6,57,21935025,21939779,4754,4.8,"0"
"10218",22,4,63,21942975,21946198,3223,3.2,"0"
"10314",22,4,23,21951507,21953666,2159,2.2,"0"
"10516",22,3,70,21959669,21963971,4302,4.3,"20"
"10614",22,7,58,21969151,21972121,2970,3,"20"
"10714",22,8,3,21974889,21978826,3937,3.9,"0"
"10914",22,3,22,21984231,21992595,8364,8.4,"20"
"11117",22,8,35,21999382,22004063,4681,4.7,"0"
"11214",22,3,62,22007585,22011773,4188,4.2,"20"
"11318",22,2,13,22014312,22016741,2429,2.4,"0"
"11515",22,4,39,22021969,22025414,3445,3.4,"0"
"11613",22,4,7,22028219,22031386,3167,3.2,"0"
"11813",22,8,75,22041326,22045102,3776,3.8,"0"
"1197",22,5,16,22048476,22051319,2843,2.8,"20"
"12110",22,5,80,22057468,22060845,3377,3.4,"20"
"10101",23,1,59,23168506,23172131,3625,3.6,"20"
"1180",23,1,3,23174424,23178267,3843,3.8,"20"
"1316",23,2,44,23183260,23187259,3999,4,"0"
"1420",23,7,25,23189758,23192933,3175,3.2,"20"
"1617",23,1,67,23197595,23204435,6840,6.8,"20"
"1715",23,2,4,23207665,23210617,2952,3,"0"
"1915",23,7,49,23215242,23219245,4003,4,"20"
"2014",23,7,73,23221392,23226111,4719,4.7,"20"
"2117",23,3,37,23228190,23231050,2860,2.9,"20"
"2210",23,5,7,23233131,23236260,3129,3.1,"20"
"2412",23,8,42,23242428,23246696,4268,4.3,"0"
"2516",23,4,38,23248920,23251788,2868,2.9,"0"
"2613",23,2,76,23254307,23257837,3530,3.5,"0"
"2717",23,2,52,23259847,23265445,5598,5.6,"0"
"2813",23,4,70,23268507,23271663,3156,3.2,"0"
"2917",23,8,26,23273579,23276624,3045,3,"0"
"3115",23,1,51,23281689,23287826,6137,6.1,"20"
"3217",23,7,33,23290508,23293523,3015,3,"20"
"3314",23,8,18,23295572,23297968,2396,2.4,"0"
"3510",23,5,15,23303443,23306001,2558,2.6,"20"
"3713",23,6,24,23310995,23315909,4914,4.9,"0"
"3915",23,3,13,23321333,23325829,4496,4.5,"20"
"4117",23,3,69,23330604,23334179,3575,3.6,"20"
"4219",23,2,28,23336036,23339571,3535,3.5,"0"
"4415",23,1,35,23344574,23347836,3262,3.3,"20"
"4516",23,3,21,23350163,23353124,2961,3,"20"
"4716",23,8,2,23358481,23361576,3095,3.1,"0"
"4916",23,1,27,23366352,23369179,2827,2.8,"20"
"5117",23,5,31,23373370,23376993,3623,3.6,"20"
"5318",23,1,19,23382557,23385646,3089,3.1,"20"
"5515",23,5,55,23391924,23396193,4269,4.3,"20"
"5614",23,6,72,23398380,23403281,4901,4.9,"0"
"5720",23,8,10,23405280,23408228,2948,2.9,"0"
"5914",23,1,75,23413431,23416974,3543,3.5,"20"
"6019",23,8,74,23419395,23422504,3109,3.1,"0"
"6113",23,1,43,23425530,23428973,3443,3.4,"20"
"6219",23,7,17,23430896,23434007,3111,3.1,"20"
"6419",23,6,48,23438476,23441586,3110,3.1,"0"
"6512",23,3,45,23443462,23445885,2423,2.4,"20"
"6618",23,7,1,23447943,23451980,4037,4,"20"
"6818",23,5,39,23456340,23460150,3810,3.8,"20"
"6913",23,7,41,23462053,23466122,4069,4.1,"20"
"7017",23,6,80,23467923,23470829,2906,2.9,"0"
"7122",23,4,78,23473918,23476953,3035,3,"0"
"7218",23,3,5,23478971,23482743,3772,3.8,"20"
"7418",23,6,40,23488075,23491889,3814,3.8,"0"
"7517",23,5,71,23493685,23496755,3070,3.1,"20"
"7616",23,4,30,23499301,23501826,2525,2.5,"0"
"7813",23,4,46,23507578,23510458,2880,2.9,"0"
"7919",23,3,29,23512251,23515164,2913,2.9,"20"
"8118",23,5,23,23519831,23522538,2707,2.7,"20"
"8311",23,1,11,23527738,23531257,3519,3.5,"20"
"8518",23,4,22,23536574,23539998,3424,3.4,"0"
"8717",23,5,47,23544655,23548363,3708,3.7,"20"
"8818",23,6,56,23550508,23555282,4774,4.8,"0"
"8913",23,7,57,23557203,23559434,2231,2.2,"20"
"9021",23,4,14,23561416,23564697,3281,3.3,"0"
"9217",23,3,77,23569918,23572842,2924,2.9,"20"
"9317",23,2,36,23574905,23577855,2950,3,"0"
"9419",23,2,12,23579724,23583574,3850,3.8,"0"
"9617",23,6,64,23588558,23591694,3136,3.1,"0"
"9717",23,6,16,23594084,23596875,2791,2.8,"0"
"9919",23,6,32,23601955,23604745,2790,2.8,"0"
"10121",23,3,61,23609447,23614447,5000,5,"20"
"10219",23,6,8,23616335,23619141,2806,2.8,"0"
"10414",23,8,50,23623757,23626724,2967,3,"0"
"10517",23,8,66,23628574,23631282,2708,2.7,"0"
"10615",23,5,63,23633009,23637176,4167,4.2,"20"
"10715",23,4,62,23638935,23642165,3230,3.2,"0"
"10814",23,4,54,23643901,23647797,3896,3.9,"0"
"10915",23,7,65,23649686,23653372,3686,3.7,"20"
"11017",23,2,20,23655914,23658744,2830,2.8,"0"
"11215",23,4,6,23663581,23666599,3018,3,"0"
"11413",23,7,9,23670910,23674888,3978,4,"20"
"11614",23,8,58,23679730,23682937,3207,3.2,"0"
"11715",23,2,68,23684825,23687698,2873,2.9,"0"
"11814",23,3,53,23689539,23693361,3822,3.8,"20"
"1198",23,5,79,23695337,23700846,5509,5.5,"20"
"1204",23,2,60,23704146,23706642,2496,2.5,"0"
"12111",23,8,34,23708847,23711799,2952,3,"0"
"10102",24,7,56,1345847,1350732,4885,4.9,"20"
"1190",24,8,65,1354757,1362753,7996,8,"0"
"1223",24,5,38,1365668,1372291,6623,6.6,"20"
"1317",24,4,45,1374450,1377713,3263,3.3,"0"
"1421",24,4,13,1381926,1386580,4654,4.7,"0"
"1618",24,2,67,1391774,1396277,4503,4.5,"0"
"1716",24,1,2,1398533,1404291,5758,5.8,"20"
"1916",24,6,39,1411725,1416833,5108,5.1,"0"
"2015",24,1,50,1420646,1427832,7186,7.2,"20"
"2118",24,2,11,1430796,1434667,3871,3.9,"0"
"2319",24,2,27,1441474,1446599,5125,5.1,"0"
"2517",24,3,4,1453021,1457831,4810,4.8,"20"
"2718",24,6,71,1463574,1467229,3655,3.7,"0"
"2814",24,5,46,1469805,1474729,4924,4.9,"20"
"2918",24,7,32,1476771,1483484,6713,6.7,"20"
"3116",24,4,53,1488342,1494695,6353,6.4,"0"
"3218",24,6,47,1497971,1501191,3220,3.2,"0"
"3315",24,8,25,1503413,1507414,4001,4,"0"
"3511",24,2,75,1512504,1517005,4501,4.5,"0"
"3619",24,1,10,1519789,1528109,8320,8.3,"20"
"3816",24,8,1,1536500,1540685,4185,4.2,"0"
"4015",24,1,42,1549312,1555387,6075,6.1,"20"
"4118",24,1,26,1558865,1565101,6236,6.2,"20"
"4314",24,2,43,1573233,1576512,3279,3.3,"0"
"4416",24,5,22,1578845,1584800,5955,6,"20"
"4612",24,5,62,1590973,1596356,5383,5.4,"20"
"4717",24,3,20,1599811,1603799,3988,4,"20"
"4917",24,7,80,1610516,1614558,4042,4,"20"
"5016",24,3,76,1616822,1623751,6929,6.9,"20"
"5118",24,5,14,1625885,1630425,4540,4.5,"20"
"5319",24,4,61,1636529,1641095,4566,4.6,"0"
"5416",24,7,24,1643150,1647432,4282,4.3,"20"
"5615",24,7,72,1655776,1659987,4211,4.2,"20"
"5721",24,5,6,1662032,1669984,7952,8,"20"
"5915",24,1,74,1675928,1681622,5694,5.7,"20"
"6020",24,8,49,1683988,1687716,3728,3.7,"0"
"6114",24,5,54,1689836,1696837,7001,7,"20"
"6220",24,3,36,1698911,1704994,6083,6.1,"20"
"6310",24,7,16,1707271,1712740,5469,5.5,"20"
"6513",24,5,78,1718975,1725033,6058,6.1,"20"
"6619",24,2,19,1727183,1733158,5975,6,"0"
"6819",24,2,51,1740285,1744101,3816,3.8,"0"
"6914",24,6,31,1746231,1753883,7652,7.7,"0"
"7123",24,7,8,1759645,1763474,3829,3.8,"20"
"7318",24,1,18,1771928,1776922,4994,5,"20"
"7518",24,1,66,1783416,1787518,4102,4.1,"20"
"7617",24,6,63,1789529,1794344,4815,4.8,"0"
"7715",24,6,79,1796333,1802956,6623,6.6,"0"
"7814",24,7,48,1806007,1811626,5619,5.6,"20"
"7920",24,8,9,1814627,1820371,5744,5.7,"0"
"8119",24,3,52,1827359,1832215,4856,4.9,"20"
"8216",24,2,35,1835996,1841768,5772,5.8,"0"
"8312",24,7,64,1843801,1847377,3576,3.6,"20"
"8416",24,1,58,1851344,1856271,4927,4.9,"20"
"8519",24,4,37,1858465,1861834,3369,3.4,"0"
"8614",24,8,41,1863928,1867867,3939,3.9,"0"
"8718",24,5,70,1870358,1879357,8999,9,"20"
"8819",24,3,44,1883079,1890502,7423,7.4,"20"
"8914",24,4,21,1892628,1896216,3588,3.6,"0"
"9119",24,5,30,1901424,1905079,3655,3.7,"20"
"9318",24,8,33,1910357,1913700,3343,3.3,"0"
"9420",24,4,29,1918522,1923836,5314,5.3,"0"
"9618",24,8,73,1929449,1934858,5409,5.4,"0"
"9718",24,3,28,1937108,1943184,6076,6.1,"20"
"9920",24,4,5,1948627,1952222,3595,3.6,"0"
"10122",24,7,40,1958988,1963851,4863,4.9,"20"
"10220",24,6,15,1966108,1969836,3728,3.7,"0"
"10415",24,3,12,1975467,1981555,6088,6.1,"20"
"10616",24,4,69,1987193,1992198,5005,5,"0"
"10716",24,6,55,1994687,1998060,3373,3.4,"0"
"10815",24,2,3,2000095,2003629,3534,3.5,"0"
"11018",24,6,7,2008716,2012664,3948,3.9,"0"
"11216",24,8,57,2019467,2023293,3826,3.8,"0"
"11319",24,2,59,2025531,2029048,3517,3.5,"0"
"11414",24,4,77,2031294,2035890,4596,4.6,"0"
"11516",24,3,68,2038806,2043047,4241,4.2,"20"
"11615",24,6,23,2045209,2050114,4905,4.9,"0"
"11815",24,8,17,2056098,2061931,5833,5.8,"0"
"1205",24,3,60,2067760,2072093,4333,4.3,"20"
"12112",24,1,34,2074651,2080242,5591,5.6,"20"
"10103",25,5,61,3369904,3374093,4189,4.2,"20"
"1199",25,3,19,3377024,3380037,3013,3,"20"
"1318",25,4,28,3386623,3389495,2872,2.9,"0"
"1515",25,6,38,3396387,3399757,3370,3.4,"0"
"1619",25,4,68,3402360,3404976,2616,2.6,"0"
"1717",25,5,29,3407289,3411239,3950,4,"20"
"1917",25,4,44,3417525,3420142,2617,2.6,"0"
"2016",25,5,21,3422294,3425577,3283,3.3,"20"
"2211",25,2,26,3430503,3432889,2386,2.4,"0"
"2413",25,6,30,3437563,3440231,2668,2.7,"0"
"2614",25,6,78,3445510,3448991,3481,3.5,"0"
"2719",25,2,18,3451367,3454094,2727,2.7,"0"
"2919",25,1,73,3461207,3464732,3525,3.5,"20"
"3015",25,3,51,3469220,3473171,3951,4,"20"
"3117",25,6,14,3475339,3479260,3921,3.9,"0"
"3316",25,7,23,3485601,3487589,1988,2,"20"
"3512",25,7,47,3492654,3495322,2668,2.7,"20"
"3620",25,2,42,3499226,3501922,2696,2.7,"0"
"3714",25,8,64,3504139,3507239,3100,3.1,"0"
"3817",25,5,13,3511441,3514778,3337,3.3,"20"
"4016",25,2,58,3519348,3521996,2648,2.6,"0"
"4119",25,1,33,3524140,3526902,2762,2.8,"20"
"4220",25,2,74,3528884,3531993,3109,3.1,"0"
"4315",25,5,53,3535674,3538581,2907,2.9,"20"
"4417",25,2,34,3541010,3544225,3215,3.2,"0"
"4517",25,5,37,3546522,3549193,2671,2.7,"20"
"4613",25,4,36,3551451,3554374,2923,2.9,"0"
"4718",25,7,15,3559062,3561495,2433,2.4,"20"
"4918",25,8,72,3566170,3569987,3817,3.8,"0"
"5017",25,8,40,3572373,3575014,2641,2.6,"0"
"5119",25,1,57,3577065,3580014,2949,2.9,"20"
"5215",25,3,11,3582108,3584551,2443,2.4,"20"
"5417",25,5,5,3590585,3593656,3071,3.1,"20"
"5616",25,3,75,3600324,3603981,3657,3.7,"20"
"5722",25,3,67,3606016,3609482,3466,3.5,"20"
"5815",25,3,27,3611455,3614409,2954,3,"20"
"6021",25,8,16,3619088,3621501,2413,2.4,"0"
"6221",25,3,35,3628237,3631753,3516,3.5,"20"
"6311",25,4,60,3635555,3637750,2195,2.2,"0"
"6420",25,7,55,3639914,3643440,3526,3.5,"20"
"6514",25,8,8,3645847,3648411,2564,2.6,"0"
"6715",25,4,52,3653506,3656237,2731,2.7,"0"
"6820",25,6,22,3658239,3661685,3446,3.4,"0"
"7018",25,6,46,3667465,3670710,3245,3.2,"0"
"7124",25,1,9,3673794,3677645,3851,3.9,"20"
"7319",25,6,62,3682711,3686521,3810,3.8,"0"
"7419",25,4,76,3689023,3692214,3191,3.2,"0"
"7519",25,7,63,3695526,3698399,2873,2.9,"20"
"7618",25,3,59,3701724,3706224,4500,4.5,"20"
"7716",25,7,79,3708854,3712651,3797,3.8,"20"
"7815",25,8,24,3714637,3718582,3945,3.9,"0"
"8015",25,2,50,3723520,3726555,3035,3,"0"
"8120",25,5,77,3730265,3732405,2140,2.1,"20"
"8217",25,6,70,3734644,3737161,2517,2.5,"0"
"8313",25,8,32,3742607,3745091,2484,2.5,"0"
"8520",25,4,4,3750035,3752399,2364,2.4,"0"
"8719",25,7,7,3756660,3759680,3020,3,"20"
"8915",25,8,48,3764889,3768505,3616,3.6,"0"
"9022",25,8,56,3772219,3773974,1755,1.8,"0"
"9120",25,5,45,3777646,3779593,1947,1.9,"20"
"9218",25,2,2,3781604,3783853,2249,2.2,"0"
"9421",25,1,25,3789436,3792149,2713,2.7,"20"
"9619",25,1,41,3798168,3800623,2455,2.5,"20"
"9719",25,7,39,3802719,3805258,2539,2.5,"20"
"9814",25,1,1,3809326,3812100,2774,2.8,"20"
"10012",25,6,54,3816626,3819162,2536,2.5,"0"
"10123",25,1,17,3821373,3825078,3705,3.7,"20"
"10315",25,7,71,3830328,3832660,2332,2.3,"20"
"10416",25,3,43,3835294,3840613,5319,5.3,"20"
"10518",25,2,66,3843845,3846515,2670,2.7,"0"
"10617",25,3,3,3853658,3857181,3523,3.5,"20"
"10816",25,8,80,3863821,3866454,2633,2.6,"0"
"10916",25,6,6,3869547,3873028,3481,3.5,"0"
"11118",25,1,49,3880299,3883194,2895,2.9,"20"
"11217",25,4,12,3885276,3889040,3764,3.8,"0"
"11415",25,1,65,3894001,3897188,3187,3.2,"20"
"11517",25,7,31,3899179,3902233,3054,3.1,"20"
"11716",25,5,69,3906549,3910027,3478,3.5,"20"
"11816",25,2,10,3912023,3914715,2692,2.7,"0"
"1206",25,4,20,3919489,3921635,2146,2.1,"0"
"10104",26,1,72,8856126,8862374,6248,6.2,"20"
"11100",26,2,25,8869095,8875615,6520,6.5,"0"
"1319",26,6,29,8881645,8886263,4618,4.6,"0"
"1516",26,3,50,8901401,8909082,7681,7.7,"20"
"1620",26,7,78,8912052,8919174,7122,7.1,"20"
"1718",26,4,59,8925368,8930196,4828,4.8,"0"
"1815",26,8,39,8938452,8944633,6181,6.2,"0"
"1918",26,1,40,8947119,8951449,4330,4.3,"20"
"2017",26,3,10,8954407,8959564,5157,5.2,"20"
"2212",26,1,8,8968145,8975986,7841,7.8,"20"
"2414",26,3,2,9013220,9017414,4194,4.2,"20"
"2615",26,4,11,9024765,9028759,3994,4,"0"
"2815",26,2,17,9035032,9040179,5147,5.1,"0"
"3016",26,5,36,9045358,9051530,6172,6.2,"20"
"3118",26,6,5,9054625,9059003,4378,4.4,"0"
"3317",26,3,26,9070518,9075719,5201,5.2,"20"
"3513",26,8,79,9080981,9087581,6600,6.6,"0"
"3621",26,8,7,9089637,9093234,3597,3.6,"0"
"3818",26,8,63,9101116,9105207,4091,4.1,"0"
"3916",26,2,1,9107725,9112561,4836,4.8,"0"
"4120",26,6,13,9119016,9124825,5809,5.8,"0"
"4316",26,7,62,9129769,9133947,4178,4.2,"20"
"4418",26,4,27,9137137,9140255,3118,3.1,"0"
"4614",26,3,34,9146903,9150365,3462,3.5,"20"
"4719",26,3,42,9152972,9157758,4786,4.8,"20"
"4816",26,4,3,9159952,9165103,5151,5.2,"0"
"5018",26,7,6,9172255,9176282,4027,4,"20"
"5216",26,6,77,9181474,9187255,5781,5.8,"0"
"5320",26,7,22,9189258,9194469,5211,5.2,"20"
"5516",26,2,41,9200986,9206730,5744,5.7,"0"
"5617",26,2,73,9209063,9212580,3517,3.5,"0"
"5723",26,4,67,9214446,9218601,4155,4.2,"0"
"5816",26,8,55,9221069,9225122,4053,4.1,"0"
"5916",26,5,60,9227622,9231899,4277,4.3,"20"
"6022",26,1,48,9235031,9239879,4848,4.8,"20"
"6115",26,8,71,9265477,9269405,3928,3.9,"0"
"6222",26,5,12,9271361,9274964,3603,3.6,"20"
"6421",26,3,18,9283433,9288208,4775,4.8,"20"
"6620",26,7,70,9300938,9305605,4667,4.7,"20"
"6716",26,5,52,9307584,9311497,3913,3.9,"20"
"6821",26,7,30,9314469,9317226,2757,2.8,"20"
"7019",26,6,37,9322314,9325245,2931,2.9,"0"
"7125",26,1,16,9327528,9331008,3480,3.5,"20"
"7320",26,2,33,9336136,9342027,5891,5.9,"0"
"7420",26,8,15,9344727,9349725,4998,5,"0"
"7619",26,4,51,9357900,9362396,4496,4.5,"0"
"7717",26,1,64,9364669,9367971,3302,3.3,"20"
"7816",26,6,69,9370216,9374333,4117,4.1,"0"
"7921",26,4,19,9376690,9381667,4977,5,"0"
"8121",26,7,54,9387883,9392481,4598,4.6,"20"
"8218",26,5,20,9394782,9397564,2782,2.8,"20"
"8417",26,7,38,9404443,9408763,4320,4.3,"20"
"8521",26,6,53,9410785,9415849,5064,5.1,"0"
"8615",26,6,21,9431059,9437414,6355,6.4,"0"
"8820",26,4,35,9442582,9445530,2948,2.9,"0"
"8916",26,3,58,9447917,9450736,2819,2.8,"20"
"9023",26,7,14,9453329,9456259,2930,2.9,"20"
"9219",26,2,49,9460661,9463269,2608,2.6,"0"
"9319",26,6,61,9465327,9468495,3168,3.2,"0"
"9422",26,6,45,9472836,9475592,2756,2.8,"0"
"9520",26,8,23,9477797,9480781,2984,3,"0"
"9720",26,1,80,9486775,9490758,3983,4,"20"
"9815",26,5,76,9493630,9495752,2122,2.1,"20"
"9921",26,1,32,9498124,9501134,3010,3,"20"
"10124",26,4,75,9506213,9509484,3271,3.3,"0"
"10221",26,5,28,9511314,9515886,4572,4.6,"20"
"10417",26,8,31,9521241,9524602,3361,3.4,"0"
"10618",26,7,46,9529708,9534330,4622,4.6,"20"
"10717",26,5,68,9538867,9543873,5006,5,"20"
"10817",26,4,43,9545765,9548309,2544,2.5,"0"
"10917",26,5,4,9550103,9553785,3682,3.7,"20"
"11119",26,3,66,9558480,9565407,6927,6.9,"20"
"11218",26,3,74,9567748,9572400,4652,4.7,"20"
"11320",26,5,44,9574913,9578824,3911,3.9,"20"
"11416",26,2,57,9581151,9584781,3630,3.6,"0"
"11518",26,2,65,9587031,9591319,4288,4.3,"0"
"11616",26,1,24,9593562,9597132,3570,3.6,"20"
"11817",26,2,9,9603816,9608025,4209,4.2,"0"
"1207",26,8,47,9613736,9616560,2824,2.8,"0"
"12113",26,1,56,9620235,9625153,4918,4.9,"20"
"10105",27,7,29,10828136,10833036,4900,4.9,"20"
"1224",27,1,23,10838194,10842538,4344,4.3,"20"
"1422",27,1,71,10846744,10850609,3865,3.9,"20"
"1517",27,3,25,10852636,10856332,3696,3.7,"20"
"1719",27,2,8,10861681,10867096,5415,5.4,"0"
"1919",27,6,28,10871639,10875709,4070,4.1,"0"
"2119",27,3,1,10880818,10886034,5216,5.2,"20"
"2320",27,6,60,10891386,10896668,5282,5.3,"0"
"2415",27,1,15,10899370,10902861,3491,3.5,"20"
"2616",27,7,13,10907687,10913766,6079,6.1,"20"
"2816",27,4,26,10918372,10924312,5940,5.9,"0"
"3017",27,8,62,10969996,10974884,4888,4.9,"0"
"3119",27,1,55,10980701,10984361,3660,3.7,"20"
"3219",27,7,5,10986693,10990428,3735,3.7,"20"
"3417",27,1,79,10996495,11000377,3882,3.9,"20"
"3514",27,7,37,11002220,11006595,4375,4.4,"20"
"3622",27,6,20,11008623,11011625,3002,3,"0"
"3819",27,5,51,11017660,11021197,3537,3.5,"20"
"3917",27,2,40,11023167,11027068,3901,3.9,"0"
"4017",27,3,17,11028998,11034745,5747,5.7,"20"
"4221",27,5,59,11043276,11049941,6665,6.7,"20"
"4317",27,7,77,11051878,11055561,3683,3.7,"20"
"4419",27,7,21,11057299,11060772,3473,3.5,"20"
"4615",27,3,9,11065569,11070725,5156,5.2,"20"
"4817",27,8,46,11075826,11080665,4839,4.8,"0"
"4919",27,4,42,11083512,11087691,4179,4.2,"0"
"5019",27,3,57,11091326,11095591,4265,4.3,"20"
"5120",27,1,39,11098632,11101219,2587,2.6,"20"
"5217",27,2,32,11103840,11107400,3560,3.6,"0"
"5418",27,2,48,11112675,11118259,5584,5.6,"0"
"5517",27,3,41,11120300,11123211,2911,2.9,"20"
"5618",27,4,66,11127652,11131193,3541,3.5,"0"
"5724",27,3,49,11135347,11138988,3641,3.6,"20"
"5817",27,5,19,11140885,11143658,2773,2.8,"20"
"6023",27,8,14,11152971,11157066,4095,4.1,"0"
"6223",27,8,6,11177584,11183393,5809,5.8,"0"
"6422",27,1,7,11213037,11216446,3409,3.4,"20"
"6621",27,8,54,11223309,11227436,4127,4.1,"0"
"6717",27,8,30,11229282,11231446,2164,2.2,"0"
"6915",27,5,11,11236499,11239512,3013,3,"20"
"7126",27,4,18,11246390,11253996,7606,7.6,"0"
"7321",27,7,53,11259807,11264375,4568,4.6,"20"
"7421",27,2,80,11266170,11268245,2075,2.1,"0"
"7520",27,4,50,11270357,11272648,2291,2.3,"0"
"7620",27,7,61,11275074,11279993,4919,4.9,"20"
"7718",27,5,35,11282285,11286286,4001,4,"20"
"7817",27,2,24,11288276,11293702,5426,5.4,"0"
"8016",27,8,38,11301027,11307102,6075,6.1,"0"
"8122",27,1,63,11309320,11312408,3088,3.1,"20"
"8219",27,7,45,11315909,11319716,3807,3.8,"20"
"8314",27,6,36,11324716,11328407,3691,3.7,"0"
"8418",27,5,43,11332310,11335371,3061,3.1,"20"
"8522",27,4,34,11337148,11341774,4626,4.6,"0"
"8616",27,4,2,11343970,11346599,2629,2.6,"0"
"8821",27,6,12,11355131,11358007,2876,2.9,"0"
"9024",27,2,72,11364560,11368978,4418,4.4,"0"
"9121",27,6,44,11373005,11377308,4303,4.3,"0"
"9220",27,5,3,11379435,11383454,4019,4,"20"
"9423",27,2,16,11388226,11392813,4587,4.6,"0"
"9620",27,6,76,11397963,11404640,6677,6.7,"0"
"9721",27,4,10,11408452,11412027,3575,3.6,"0"
"9922",27,7,69,11417031,11420632,3601,3.6,"20"
"10013",27,1,31,11425253,11429727,4474,4.5,"20"
"10222",27,2,56,11441870,11445110,3240,3.2,"0"
"10316",27,5,27,11448392,11451053,2661,2.7,"20"
"10519",27,3,73,11455843,11458957,3114,3.1,"20"
"10619",27,4,58,11461454,11464954,3500,3.5,"0"
"10718",27,2,64,11468668,11471406,2738,2.7,"0"
"10818",27,8,70,11473921,11479536,5615,5.6,"0"
"10918",27,8,78,11520052,11522888,2836,2.8,"0"
"11019",27,6,68,11524883,11528160,3277,3.3,"0"
"11120",27,8,22,11530120,11532912,2792,2.8,"0"
"11321",27,5,67,11542157,11546797,4640,4.6,"20"
"11417",27,3,65,11548707,11552314,3607,3.6,"20"
"11519",27,6,4,11555194,11557947,2753,2.8,"0"
"11717",27,3,33,11563681,11566961,3280,3.3,"20"
"11818",27,6,52,11569151,11572832,3681,3.7,"0"
"11910",27,5,75,11575370,11578637,3267,3.3,"20"
"1208",27,4,74,11580342,11584709,4367,4.4,"0"
"12114",27,1,47,11586748,11589061,2313,2.3,"20"
"10106",28,3,24,12493731,12497783,4052,4.1,"20"
"1225",28,6,59,12504287,12508016,3729,3.7,"0"
"1320",28,2,63,12511442,12516735,5293,5.3,"0"
"1423",28,7,60,12519308,12523112,3804,3.8,"20"
"1518",28,7,52,12525514,12530811,5297,5.3,"20"
"1621",28,2,31,12533350,12537244,3894,3.9,"0"
"1816",28,6,35,12543790,12547929,4139,4.1,"0"
"1920",28,4,25,12550197,12553812,3615,3.6,"0"
"2120",28,6,11,12558457,12561137,2680,2.7,"0"
"2321",28,5,58,12567683,12574326,6643,6.6,"20"
"2416",28,6,43,12576767,12579933,3166,3.2,"0"
"2518",28,3,48,12582568,12586017,3449,3.4,"20"
"2617",28,4,33,12589764,12593781,4017,4,"0"
"2720",28,6,75,12596108,12599425,3317,3.3,"0"
"2817",28,8,69,12601756,12605509,3753,3.8,"0"
"2920",28,8,53,12607575,12614897,7322,7.3,"0"
"3018",28,2,47,12617052,12619883,2831,2.8,"0"
"3120",28,1,38,12622639,12626082,3443,3.4,"20"
"3220",28,1,6,12628763,12635688,6925,6.9,"20"
"3418",28,1,70,12642920,12647445,4525,4.5,"20"
"3515",28,8,45,12650750,12653146,2396,2.4,"0"
"3623",28,1,78,12656205,12661593,5388,5.4,"20"
"3715",28,4,17,12664713,12667416,2703,2.7,"0"
"3918",28,8,61,12672406,12678005,5599,5.6,"0"
"4018",28,7,76,12680000,12684687,4687,4.7,"20"
"4121",28,7,44,12688813,12691434,2621,2.6,"20"
"4222",28,2,7,12695219,12699509,4290,4.3,"0"
"4420",28,4,73,12706574,12710040,3466,3.5,"0"
"4518",28,3,8,12712399,12718547,6148,6.1,"20"
"4720",28,8,21,12726340,12729123,2783,2.8,"0"
"4920",28,5,26,12734033,12737108,3075,3.1,"20"
"5121",28,2,71,12741917,12745111,3194,3.2,"0"
"5218",28,7,20,12747394,12750251,2857,2.9,"20"
"5419",28,5,2,12758158,12761587,3429,3.4,"20"
"5619",28,4,9,12767104,12769707,2603,2.6,"0"
"5818",28,4,65,12775358,12780037,4679,4.7,"0"
"5917",28,7,4,12783677,12786400,2723,2.7,"20"
"6116",28,8,37,12791375,12793914,2539,2.5,"0"
"6224",28,3,64,12796538,12798977,2439,2.4,"20"
"6312",28,1,46,12801207,12804465,3258,3.3,"20"
"6423",28,6,19,12807048,12809447,2399,2.4,"0"
"6622",28,5,10,12813925,12820203,6278,6.3,"20"
"6822",28,7,28,12830181,12834782,4601,4.6,"20"
"7020",28,6,67,12841088,12845078,3990,4,"0"
"7127",28,6,51,12848546,12851236,2690,2.7,"0"
"7219",28,1,14,12854420,12857110,2690,2.7,"20"
"7422",28,5,34,12869490,12873656,4166,4.2,"20"
"7521",28,5,66,12876102,12878691,2589,2.6,"20"
"7621",28,4,57,12880977,12883712,2735,2.7,"0"
"7719",28,3,80,12885510,12887767,2257,2.3,"20"
"7818",28,2,39,12889766,12892362,2596,2.6,"0"
"7922",28,7,36,12894244,12897320,3076,3.1,"20"
"8017",28,3,16,12900581,12902942,2361,2.4,"20"
"8220",28,1,54,12908022,12913568,5546,5.5,"20"
"8315",28,3,56,12916385,12919792,3407,3.4,"20"
"8419",28,1,62,12922740,12926211,3471,3.5,"20"
"8523",28,4,1,12928597,12930815,2218,2.2,"0"
"8720",28,5,74,12935658,12938605,2947,2.9,"20"
"8822",28,8,29,12940938,12944482,3544,3.5,"0"
"9025",28,8,13,12949143,12953452,4309,4.3,"0"
"9221",28,4,41,12958675,12961074,2399,2.4,"0"
"9320",28,4,49,12963499,12965884,2385,2.4,"0"
"9424",28,8,77,12968630,12972338,3708,3.7,"0"
"9521",28,5,18,12976450,12978607,2157,2.2,"20"
"9722",28,8,5,12983629,12986277,2648,2.6,"0"
"9923",28,7,12,12991157,12993397,2240,2.2,"20"
"10125",28,2,55,12998105,13001252,3147,3.1,"0"
"10223",28,1,30,13003390,13006811,3421,3.4,"20"
"10418",28,2,79,13012102,13014768,2666,2.7,"0"
"10520",28,3,72,13017676,13020278,2602,2.6,"20"
"10620",28,6,3,13024413,13027324,2911,2.9,"0"
"10819",28,5,42,13031816,13035023,3207,3.2,"20"
"10919",28,2,15,13037802,13039627,1825,1.8,"0"
"11121",28,7,68,13044637,13046870,2233,2.2,"20"
"11219",28,5,50,13048856,13051580,2724,2.7,"20"
"11322",28,2,23,13054444,13056413,1969,2,"0"
"11520",28,3,32,13061270,13064083,2813,2.8,"20"
"11718",28,1,22,13077238,13082114,4876,4.9,"20"
"11911",28,6,27,13087152,13090126,2974,3,"0"
"12115",28,3,40,13098462,13101991,3529,3.5,"20"
"10107",29,4,24,15649668,15654664,4996,5,"0"
"1226",29,2,62,15661050,15668231,7181,7.2,"0"
"1321",29,6,26,15671164,15676209,5045,5,"0"
"1519",29,5,65,15682341,15686915,4574,4.6,"20"
"1622",29,1,5,15691213,15696626,5413,5.4,"20"
"1817",29,5,17,15703302,15710464,7162,7.2,"20"
"2018",29,5,25,15718349,15724967,6618,6.6,"20"
"2213",29,6,2,15733391,15739607,6216,6.2,"0"
"2417",29,3,71,15748524,15753154,4630,4.6,"20"
"2519",29,7,35,15759363,15766226,6863,6.9,"20"
"2618",29,5,57,15771594,15777696,6102,6.1,"20"
"2721",29,3,23,15782944,15787117,4173,4.2,"20"
"2921",29,4,8,15793248,15799249,6001,6,"0"
"3121",29,1,29,15809406,15820434,11028,11,"20"
"3318",29,6,66,15830046,15835859,5813,5.8,"0"
"3419",29,8,36,15844258,15848832,4574,4.6,"0"
"3516",29,7,67,15851494,15857198,5704,5.7,"20"
"3624",29,2,6,15859242,15864336,5094,5.1,"0"
"3820",29,8,68,15871276,15875732,4456,4.5,"0"
"3919",29,6,18,15877843,15884791,6948,6.9,"0"
"4122",29,8,12,15892982,15896514,3532,3.5,"0"
"4318",29,4,56,15904814,15907918,3104,3.1,"0"
"4421",29,6,34,15910117,15916897,6780,6.8,"0"
"4519",29,3,55,15921728,15926102,4374,4.4,"20"
"4616",29,2,70,15928358,15935101,6743,6.7,"0"
"4721",29,7,75,15940399,15946104,5705,5.7,"20"
"4818",29,3,63,15952761,15957389,4628,4.6,"20"
"4921",29,1,69,15959716,15967600,7884,7.9,"20"
"5020",29,5,49,15971664,15975076,3412,3.4,"20"
"5122",29,7,51,15978186,15983218,5032,5,"20"
"5219",29,6,74,15986864,15991934,5070,5.1,"0"
"5321",29,8,76,15994994,15999707,4713,4.7,"0"
"5420",29,8,4,16002265,16006957,4692,4.7,"0"
"5620",29,1,61,16016165,16020748,4583,4.6,"20"
"5725",29,7,19,16029286,16033517,4231,4.2,"20"
"5918",29,7,43,16038866,16042207,3341,3.3,"20"
"6024",29,5,1,16044583,16048934,4351,4.4,"20"
"6225",29,7,59,16058365,16063095,4730,4.7,"20"
"6313",29,4,32,16066623,16069345,2722,2.7,"0"
"6515",29,1,13,16078858,16084024,5166,5.2,"20"
"6718",29,3,39,16091760,16095261,3501,3.5,"20"
"6823",29,8,20,16099732,16102345,2613,2.6,"0"
"7021",29,8,44,16107219,16111946,4727,4.7,"0"
"7128",29,5,9,16115436,16120094,4658,4.7,"20"
"7322",29,6,42,16128685,16133368,4683,4.7,"0"
"7423",29,3,15,16142661,16146863,4202,4.2,"20"
"7622",29,4,16,16152104,16155960,3856,3.9,"0"
"7819",29,7,27,16161270,16164766,3496,3.5,"20"
"8018",29,1,53,16169835,16175550,5715,5.7,"20"
"8123",29,2,30,16177819,16181057,3238,3.2,"0"
"8316",29,6,10,16187093,16191568,4475,4.5,"0"
"8524",29,7,11,16196844,16200049,3205,3.2,"20"
"8721",29,4,40,16207164,16209998,2834,2.8,"0"
"8823",29,2,46,16213513,16216693,3180,3.2,"0"
"8917",29,3,79,16221678,16226225,4547,4.5,"20"
"9026",29,2,54,16229644,16233484,3840,3.8,"0"
"9122",29,5,33,16235432,16238088,2656,2.7,"20"
"9222",29,4,64,16239903,16242179,2276,2.3,"0"
"9321",29,1,21,16244693,16249115,4422,4.4,"20"
"9522",29,8,52,16256104,16261750,5646,5.6,"0"
"9621",29,5,73,16263957,16267787,3830,3.8,"20"
"9723",29,1,77,16270153,16274326,4173,4.2,"20"
"9816",29,3,7,16276355,16279875,3520,3.5,"20"
"10014",29,2,38,16286589,16290372,3783,3.8,"0"
"10126",29,2,22,16292456,16297028,4572,4.6,"0"
"10317",29,4,72,16303107,16308692,5585,5.6,"0"
"10419",29,5,41,16311259,16314733,3474,3.5,"20"
"10521",29,2,14,16317777,16321157,3380,3.4,"0"
"10719",29,3,47,16326262,16329557,3295,3.3,"20"
"10820",29,1,45,16331459,16333908,2449,2.4,"20"
"10920",29,3,31,16337052,16340021,2969,3,"20"
"11122",29,6,58,16346380,16349556,3176,3.2,"0"
"11220",29,7,3,16351886,16354274,2388,2.4,"20"
"11418",29,2,78,16360477,16363629,3152,3.2,"0"
"11521",29,4,48,16366335,16369441,3106,3.1,"0"
"11617",29,1,37,16372271,16374787,2516,2.5,"20"
"11719",29,8,28,16378819,16382814,3995,4,"0"
"11912",29,8,60,16389066,16392620,3554,3.6,"0"
"1209",29,6,50,16395454,16399421,3967,4,"0"
"12116",29,4,80,16401983,16404893,2910,2.9,"0"
"10108",30,7,34,16852720,16859101,6381,6.4,"20"
"11101",30,1,36,16862952,16869047,6095,6.1,"20"
"1227",30,8,43,16871444,16880347,8903,8.9,"0"
"1322",30,7,58,16886285,16892129,5844,5.8,"20"
"1424",30,1,76,16896670,16902567,5897,5.9,"20"
"1520",30,1,44,16907222,16911130,3908,3.9,"20"
"1623",30,2,5,16914059,16919805,5746,5.7,"0"
"1818",30,6,65,16927584,16936129,8545,8.5,"0"
"1921",30,3,78,16939421,16945500,6079,6.1,"20"
"2019",30,6,49,16948378,16953149,4771,4.8,"0"
"2121",30,8,11,16957493,16961344,3851,3.9,"0"
"2322",30,1,60,16967194,16972293,5099,5.1,"20"
"2418",30,8,35,16975197,16978606,3409,3.4,"0"
"2520",30,2,29,16982900,16990407,7507,7.5,"0"
"2722",30,2,77,17000667,17008954,8287,8.3,"0"
"2818",30,6,25,17014710,17018751,4041,4,"0"
"3019",30,5,40,17025036,17028901,3865,3.9,"20"
"3122",30,7,26,17032217,17035952,3735,3.7,"20"
"3319",30,7,42,17044645,17050070,5425,5.4,"20"
"3420",30,3,38,17052227,17057306,5079,5.1,"20"
"3517",30,5,64,17061627,17065451,3824,3.8,"20"
"3625",30,6,17,17070766,17076135,5369,5.4,"0"
"3821",30,3,22,17083372,17088269,4897,4.9,"20"
"4019",30,3,6,17099505,17111496,11991,12,"20"
"4223",30,4,47,17118036,17122889,4853,4.9,"0"
"4319",30,8,27,17129108,17134608,5500,5.5,"0"
"4520",30,5,8,17140784,17144890,4106,4.1,"20"
"4722",30,4,31,17151198,17157564,6366,6.4,"0"
"4922",30,8,59,17165866,17171560,5694,5.7,"0"
"5021",30,5,48,17174949,17178981,4032,4,"20"
"5123",30,8,3,17181853,17186048,4195,4.2,"0"
"5322",30,7,18,17191777,17197977,6200,6.2,"20"
"5518",30,4,55,17204046,17208049,4003,4,"0"
"5621",30,1,52,17211936,17215546,3610,3.6,"20"
"5726",30,7,2,17219630,17223254,3624,3.6,"20"
"5919",30,5,16,17230629,17233993,3364,3.4,"20"
"6117",30,3,54,17243271,17249769,6498,6.5,"20"
"6226",30,7,50,17251955,17256700,4745,4.7,"20"
"6314",30,7,10,17259585,17262977,3392,3.4,"20"
"6516",30,4,39,17269317,17274824,5507,5.5,"0"
"6623",30,4,7,17278802,17283596,4794,4.8,"0"
"6824",30,2,45,17291847,17295087,3240,3.2,"0"
"6916",30,3,70,17297317,17302572,5255,5.3,"20"
"7022",30,6,33,17305844,17308861,3017,3,"0"
"7129",30,4,23,17312636,17316338,3702,3.7,"0"
"7323",30,4,71,17322066,17325340,3274,3.3,"0"
"7424",30,5,72,17329418,17336600,7182,7.2,"20"
"7522",30,2,13,17338983,17342706,3723,3.7,"0"
"7720",30,4,15,17354686,17359198,4512,4.5,"0"
"7923",30,6,73,17365906,17373012,7106,7.1,"0"
"8019",30,8,67,17376323,17381424,5101,5.1,"0"
"8124",30,6,41,17385290,17388287,2997,3,"0"
"8221",30,5,80,17395254,17398985,3731,3.7,"20"
"8317",30,3,14,17402480,17406668,4188,4.2,"20"
"8525",30,3,46,17413057,17416954,3897,3.9,"20"
"8617",30,5,56,17425220,17428173,2953,3,"20"
"8722",30,8,19,17430688,17433519,2831,2.8,"0"
"8918",30,7,66,17441098,17445904,4806,4.8,"20"
"9027",30,6,1,17448930,17453511,4581,4.6,"0"
"9223",30,1,20,17460694,17463260,2566,2.6,"20"
"9425",30,8,75,17470280,17478083,7803,7.8,"0"
"9523",30,5,24,17481025,17484930,3905,3.9,"20"
"9724",30,7,74,17493398,17496932,3534,3.5,"20"
"9817",30,2,21,17500477,17504574,4097,4.1,"0"
"10015",30,1,4,17510496,17513842,3346,3.3,"20"
"10224",30,2,53,17518605,17523013,4408,4.4,"0"
"10318",30,1,28,17526770,17530314,3544,3.5,"20"
"10522",30,3,62,17536266,17541022,4756,4.8,"20"
"10621",30,2,69,17545365,17548397,3032,3,"0"
"10720",30,1,68,17553667,17558342,4675,4.7,"20"
"10821",30,3,30,17560865,17564806,3941,3.9,"20"
"11020",30,6,57,17570242,17574304,4062,4.1,"0"
"11123",30,2,37,17578862,17581856,2994,3,"0"
"11221",30,8,51,17587718,17592220,4502,4.5,"0"
"11323",30,1,12,17595515,17598662,3147,3.1,"20"
"11522",30,2,61,17605322,17610532,5210,5.2,"0"
"11618",30,5,32,17613426,17617848,4422,4.4,"20"
"11819",30,4,79,17623919,17629449,5530,5.5,"0"
"11913",30,6,9,17633630,17637550,3920,3.9,"0"
"12117",30,4,63,17646171,17650968,4797,4.8,"0"
"10109",31,4,14,17991974,17996757,4783,4.8,"0"
"1228",31,1,11,18002907,18007559,4652,4.7,"20"
"1425",31,7,57,18012707,18018041,5334,5.3,"20"
"1521",31,4,62,18019998,18025748,5750,5.8,"0"
"1624",31,5,7,18028343,18033954,5611,5.6,"20"
"1819",31,1,43,18040226,18046934,6708,6.7,"20"
"1922",31,3,13,18049380,18055427,6047,6,"20"
"2122",31,8,66,18061063,18065799,4736,4.7,"0"
"2214",31,3,21,18068666,18072635,3969,4,"20"
"2419",31,4,70,18078109,18083646,5537,5.5,"0"
"2521",31,3,77,18085869,18089137,3268,3.3,"20"
"2619",31,6,40,18091808,18095023,3215,3.2,"0"
"2723",31,7,41,18097394,18101771,4377,4.4,"20"
"2819",31,8,10,18103910,18107539,3629,3.6,"0"
"3020",31,5,79,18113046,18118029,4983,5,"20"
"3123",31,1,27,18122197,18128388,6191,6.2,"20"
"3320",31,8,26,18134481,18139070,4589,4.6,"0"
"3518",31,8,50,18145370,18150602,5232,5.2,"0"
"3626",31,8,58,18152754,18156857,4103,4.1,"0"
"3716",31,6,8,18159111,18162683,3572,3.6,"0"
"3920",31,3,61,18168446,18173460,5014,5,"20"
"4020",31,7,1,18176212,18178830,2618,2.6,"20"
"4224",31,4,22,18184418,18188258,3840,3.8,"0"
"4422",31,1,59,18195952,18200290,4338,4.3,"20"
"4521",31,1,51,18202428,18206393,3965,4,"20"
"4617",31,2,44,18208368,18214453,6085,6.1,"0"
"4723",31,6,64,18216491,18218876,2385,2.4,"0"
"4819",31,4,38,18220945,18226329,5384,5.4,"0"
"4923",31,2,68,18228460,18230616,2156,2.2,"0"
"5022",31,6,24,18232685,18235566,2881,2.9,"0"
"5220",31,7,9,18240854,18245542,4688,4.7,"20"
"5421",31,7,25,18250849,18255586,4737,4.7,"20"
"5622",31,2,36,18260458,18263993,3535,3.5,"0"
"5727",31,8,2,18267704,18271586,3882,3.9,"0"
"5920",31,3,37,18278705,18282737,4032,4,"20"
"6025",31,5,71,18284586,18286935,2349,2.3,"20"
"6118",31,1,75,18289432,18292722,3290,3.3,"20"
"6227",31,7,73,18294941,18299930,4989,5,"20"
"6315",31,3,69,18303058,18307114,4056,4.1,"20"
"6424",31,3,53,18308837,18313170,4333,4.3,"20"
"6517",31,2,12,18315320,18317912,2592,2.6,"0"
"6719",31,7,17,18322886,18325599,2713,2.7,"20"
"6917",31,5,31,18330657,18334539,3882,3.9,"20"
"7130",31,7,65,18339557,18342406,2849,2.8,"20"
"7220",31,5,55,18345111,18347891,2780,2.8,"20"
"7324",31,1,67,18349679,18352427,2748,2.7,"20"
"7425",31,7,33,18354450,18356644,2194,2.2,"20"
"7523",31,2,52,18358709,18362079,3370,3.4,"0"
"7623",31,1,35,18364501,18366859,2358,2.4,"20"
"7721",31,4,6,18368768,18373428,4660,4.7,"0"
"7924",31,6,72,18384549,18387859,3310,3.3,"0"
"8020",31,4,46,18389770,18392881,3111,3.1,"0"
"8125",31,6,48,18400026,18405409,5383,5.4,"0"
"8222",31,8,34,18407341,18413537,6196,6.2,"0"
"8318",31,4,54,18415356,18420219,4863,4.9,"0"
"8420",31,1,3,18422432,18426374,3942,3.9,"20"
"8618",31,2,28,18431203,18434324,3121,3.1,"0"
"8824",31,7,49,18439357,18441748,2391,2.4,"20"
"8919",31,6,16,18443662,18446253,2591,2.6,"0"
"9123",31,8,74,18450887,18453411,2524,2.5,"0"
"9224",31,2,4,18455224,18457695,2471,2.5,"0"
"9426",31,3,29,18462077,18464807,2730,2.7,"20"
"9622",31,2,76,18469959,18472751,2792,2.8,"0"
"9725",31,5,15,18474746,18476580,1834,1.8,"20"
"9924",31,5,47,18481501,18483418,1917,1.9,"20"
"10016",31,8,18,18486905,18489292,2387,2.4,"0"
"10225",31,1,19,18495600,18497790,2190,2.2,"20"
"10420",31,6,56,18504471,18506879,2408,2.4,"0"
"10523",31,5,23,18508840,18512810,3970,4,"20"
"10721",31,6,32,18517854,18520403,2549,2.5,"0"
"10921",31,4,78,18525056,18528224,3168,3.2,"0"
"11021",31,3,5,18530601,18532930,2329,2.3,"20"
"11222",31,3,45,18538120,18540104,1984,2,"20"
"11324",31,2,60,18542040,18543900,1860,1.9,"0"
"11419",31,4,30,18546898,18549221,2323,2.3,"0"
"11619",31,8,42,18554227,18558227,4000,4,"0"
"11720",31,2,20,18560091,18562207,2116,2.1,"0"
"11914",31,6,80,18567014,18570381,3367,3.4,"0"
"12010",31,5,63,18572211,18575542,3331,3.3,"20"
"12118",31,5,39,18577901,18580453,2552,2.6,"20"
"10127",32,4,29,19533499,19539468,5969,6,"0"
"1229",32,8,17,19544408,19551581,7173,7.2,"0"
"1426",32,6,7,19557222,19563289,6067,6.1,"0"
"1625",32,5,6,19570146,19577459,7313,7.3,"20"
"1820",32,1,2,19585475,19589286,3811,3.8,"20"
"2020",32,7,56,19593924,19598731,4807,4.8,"20"
"2123",32,1,10,19602313,19606938,4625,4.6,"20"
"2323",32,3,68,19613201,19617945,4744,4.7,"20"
"2420",32,6,79,19621856,19626732,4876,4.9,"0"
"2522",32,4,5,19630541,19636010,5469,5.5,"0"
"2724",32,7,24,19642976,19647919,4943,4.9,"20"
"2922",32,2,59,19652846,19657106,4260,4.3,"0"
"3021",32,3,4,19662982,19667412,4430,4.4,"20"
"3221",32,5,62,19672338,19678311,5973,6,"20"
"3321",32,5,38,19680848,19684843,3995,4,"20"
"3421",32,7,32,19688857,19698210,9353,9.4,"20"
"3627",32,8,41,19704459,19707782,3323,3.3,"0"
"3717",32,2,43,19710021,19713754,3733,3.7,"0"
"3822",32,4,61,19715815,19720894,5079,5.1,"0"
"3921",32,3,12,19723151,19726557,3406,3.4,"20"
"4123",32,1,66,19731668,19738375,6707,6.7,"20"
"4225",32,7,16,19741676,19744594,2918,2.9,"20"
"4423",32,8,1,19749731,19752785,3054,3.1,"0"
"4618",32,5,54,19757664,19762880,5216,5.2,"20"
"4724",32,4,37,19764982,19769329,4347,4.3,"0"
"4820",32,2,35,19771622,19776393,4771,4.8,"0"
"4924",32,3,36,19778582,19781983,3401,3.4,"20"
"5023",32,8,25,19784130,19787339,3209,3.2,"0"
"5221",32,7,72,19791991,19796517,4526,4.5,"20"
"5323",32,5,22,19799088,19804486,5398,5.4,"20"
"5519",32,2,67,19809347,19813968,4621,4.6,"0"
"5623",32,7,40,19815816,19819166,3350,3.4,"20"
"5728",32,3,76,19820977,19824277,3300,3.3,"20"
"5819",32,2,75,19826121,19829795,3674,3.7,"0"
"5921",32,1,18,19831710,19835595,3885,3.9,"20"
"6119",32,4,21,19840268,19845467,5199,5.2,"0"
"6316",32,4,13,19850305,19857101,6796,6.8,"0"
"6518",32,2,3,19861678,19865758,4080,4.1,"0"
"6720",32,3,44,19874200,19877896,3696,3.7,"20"
"6825",32,8,73,19881564,19885427,3863,3.9,"0"
"6918",32,1,34,19888411,19891510,3099,3.1,"20"
"7023",32,2,51,19893677,19897306,3629,3.6,"0"
"7131",32,1,58,19899396,19904649,5253,5.3,"20"
"7221",32,4,53,19907271,19913544,6273,6.3,"0"
"7325",32,6,31,19915615,19920214,4599,4.6,"0"
"7524",32,3,28,19927788,19931495,3707,3.7,"20"
"7722",32,2,27,19936241,19940551,4310,4.3,"0"
"7925",32,8,33,19945805,19948333,2528,2.5,"0"
"8021",32,5,70,19950153,19955875,5722,5.7,"20"
"8126",32,8,9,19958040,19963180,5140,5.1,"0"
"8319",32,5,14,19968242,19973764,5522,5.5,"20"
"8526",32,7,80,19978687,19981720,3033,3,"20"
"8619",32,1,42,19983724,19988707,4983,5,"20"
"8723",32,3,20,19990716,19993999,3283,3.3,"20"
"8920",32,1,50,20001902,20006552,4650,4.7,"20"
"9028",32,6,47,20008598,20012558,3960,4,"0"
"9124",32,6,63,20014728,20019017,4289,4.3,"0"
"9225",32,5,46,20021432,20024955,3523,3.5,"20"
"9322",32,6,39,20027871,20030377,2506,2.5,"0"
"9427",32,5,30,20032337,20035088,2751,2.8,"20"
"9623",32,2,11,20040140,20043299,3159,3.2,"0"
"9818",32,8,57,20049489,20052732,3243,3.2,"0"
"9925",32,6,23,20054684,20057098,2414,2.4,"0"
"10128",32,2,19,20061638,20065526,3888,3.9,"0"
"10319",32,6,71,20073320,20076367,3047,3,"0"
"10421",32,7,64,20078240,20081549,3309,3.3,"20"
"10524",32,8,65,20083601,20087002,3401,3.4,"0"
"10622",32,1,26,20089430,20093165,3735,3.7,"20"
"10822",32,7,8,20098292,20102252,3960,4,"20"
"11022",32,3,52,20107349,20110225,2876,2.9,"20"
"11124",32,4,69,20112656,20116506,3850,3.8,"0"
"11223",32,7,48,20118832,20123126,4294,4.3,"20"
"11325",32,4,45,20126279,20129435,3156,3.2,"0"
"11420",32,6,15,20132370,20134937,2567,2.6,"0"
"11620",32,6,55,20140846,20144119,3273,3.3,"0"
"11721",32,3,60,20146126,20148550,2424,2.4,"20"
"11820",32,8,49,20150885,20153896,3011,3,"0"
"11915",32,4,77,20155842,20158836,2994,3,"0"
"12011",32,5,78,20160970,20163527,2557,2.6,"20"
"12119",32,1,74,20165439,20170168,4729,4.7,"20"
"10129",33,8,8,3101592,3109588,7996,8,"0"
"1230",33,8,40,3116698,3120106,3408,3.4,"0"
"1323",33,5,37,3123867,3130620,6753,6.8,"20"
"1427",33,3,59,3135036,3141146,6110,6.1,"20"
"1522",33,7,63,3143236,3150252,7016,7,"20"
"1626",33,1,65,3152486,3160062,7576,7.6,"20"
"1720",33,1,49,3162361,3166785,4424,4.4,"20"
"1821",33,7,31,3168806,3176213,7407,7.4,"20"
"2021",33,8,72,3182229,3189776,7547,7.5,"0"
"2124",33,3,27,3191857,3196250,4393,4.4,"20"
"2324",33,5,13,3201897,3206372,4475,4.5,"20"
"2523",33,6,46,3212596,3216443,3847,3.8,"0"
"2620",33,3,35,3219038,3223605,4567,4.6,"20"
"2725",33,4,76,3226178,3231346,5168,5.2,"0"
"2820",33,3,11,3234440,3238377,3937,3.9,"20"
"3022",33,3,67,3246800,3252428,5628,5.6,"20"
"3124",33,1,9,3254438,3258984,4546,4.5,"20"
"3322",33,5,21,3267825,3272656,4831,4.8,"20"
"3519",33,8,16,3278272,3282462,4190,4.2,"0"
"3718",33,2,74,3289558,3294190,4632,4.6,"0"
"3823",33,7,39,3296999,3301312,4313,4.3,"20"
"3922",33,2,18,3303249,3307838,4589,4.6,"0"
"4124",33,8,64,3314747,3318566,3819,3.8,"0"
"4226",33,1,73,3320844,3324204,3360,3.4,"20"
"4320",33,7,47,3326426,3330507,4081,4.1,"20"
"4424",33,2,42,3333924,3337239,3315,3.3,"0"
"4522",33,8,32,3340108,3343828,3720,3.7,"0"
"4725",33,6,70,3351912,3356961,5049,5,"0"
"4821",33,1,25,3361609,3364959,3350,3.4,"20"
"5024",33,5,69,3371948,3375986,4038,4,"20"
"5124",33,4,12,3378590,3381350,2760,2.8,"0"
"5324",33,6,54,3386858,3392896,6038,6,"0"
"5422",33,7,55,3394826,3398447,3621,3.6,"20"
"5520",33,2,58,3402247,3406696,4449,4.4,"0"
"5624",33,8,80,3409869,3412634,2765,2.8,"0"
"5729",33,8,24,3415332,3417617,2285,2.3,"0"
"5922",33,5,77,3422892,3426832,3940,3.9,"20"
"6026",33,3,51,3434903,3440473,5570,5.6,"20"
"6120",33,5,61,3442948,3448508,5560,5.6,"20"
"6228",33,4,44,3451244,3454318,3074,3.1,"0"
"6317",33,4,20,3456294,3461187,4893,4.9,"0"
"6519",33,7,7,3470330,3473192,2862,2.9,"20"
"6721",33,1,17,3481022,3484898,3876,3.9,"20"
"6919",33,2,34,3490664,3495582,4918,4.9,"0"
"7024",33,3,3,3497458,3502551,5093,5.1,"20"
"7222",33,6,62,3507217,3510758,3541,3.5,"0"
"7326",33,7,15,3513557,3516003,2446,2.4,"20"
"7525",33,6,30,3523733,3526362,2629,2.6,"0"
"7723",33,4,52,3530700,3533077,2377,2.4,"0"
"7820",33,8,56,3535618,3537700,2082,2.1,"0"
"7926",33,2,66,3540557,3543309,2752,2.8,"0"
"8022",33,6,38,3545894,3549960,4066,4.1,"0"
"8127",33,2,2,3551879,3554685,2806,2.8,"0"
"8320",33,6,22,3560705,3565449,4744,4.7,"0"
"8527",33,5,53,3571719,3576200,4481,4.5,"20"
"8620",33,7,23,3579308,3582273,2965,3,"20"
"8825",33,4,28,3587541,3592110,4569,4.6,"0"
"9029",33,7,71,3600467,3606485,6018,6,"20"
"9125",33,3,43,3608444,3610826,2382,2.4,"20"
"9226",33,5,45,3615048,3618340,3292,3.3,"20"
"9323",33,1,57,3623131,3626133,3002,3,"20"
"9428",33,2,26,3630953,3635460,4507,4.5,"0"
"9624",33,2,10,3641908,3645720,3812,3.8,"0"
"9819",33,4,68,3654022,3657939,3917,3.9,"0"
"9926",33,7,79,3670949,3674113,3164,3.2,"20"
"10017",33,2,50,3700231,3702537,2306,2.3,"0"
"10130",33,1,41,3707408,3710031,2623,2.6,"20"
"10226",33,4,4,3712371,3716214,3843,3.8,"0"
"10422",33,3,19,3723941,3726487,2546,2.5,"20"
"10623",33,8,48,3738214,3741042,2828,2.8,"0"
"10722",33,6,6,3744529,3747693,3164,3.2,"0"
"10922",33,4,60,3757227,3759647,2420,2.4,"0"
"11023",33,4,36,3763678,3769181,5503,5.5,"0"
"11125",33,5,29,3771316,3774807,3491,3.5,"20"
"11326",33,1,1,3788435,3792967,4532,4.5,"20"
"11523",33,6,14,3800531,3803783,3252,3.3,"0"
"11722",33,3,75,3814730,3817153,2423,2.4,"20"
"11821",33,6,78,3823020,3825446,2426,2.4,"0"
"11916",33,5,5,3831769,3836937,5168,5.2,"20"
"12120",33,1,33,3898545,3901410,2865,2.9,"20"
"10131",34,6,13,9945057,9949121,4064,4.1,"0"
"1231",34,2,49,9954358,9959319,4961,5,"0"
"1324",34,8,47,9964073,9967895,3822,3.8,"0"
"1428",34,4,35,9972073,9976700,4627,4.6,"0"
"1523",34,5,20,9978698,9985679,6981,7,"20"
"1721",34,8,55,9995013,10002077,7064,7.1,"0"
"1822",34,8,63,10005081,10010846,5765,5.8,"0"
"1923",34,2,65,10013066,10018987,5921,5.9,"0"
"2022",34,1,72,10023122,10028965,5843,5.8,"20"
"2125",34,5,44,10033163,10037922,4759,4.8,"20"
"2215",34,6,77,10042152,10047089,4937,4.9,"0"
"2325",34,5,76,10051671,10055982,4311,4.3,"20"
"2421",34,4,67,10061051,10068249,7198,7.2,"0"
"2524",34,1,40,10075447,10082665,7218,7.2,"20"
"2621",34,1,64,10088356,10092426,4070,4.1,"20"
"2726",34,3,34,10096196,10100239,4043,4,"20"
"2821",34,7,70,10103999,10108468,4469,4.5,"20"
"2923",34,4,51,10111452,10114774,3322,3.3,"0"
"3023",34,8,7,10116671,10123044,6373,6.4,"0"
"3222",34,6,37,10131509,10139782,8273,8.3,"0"
"3323",34,4,75,10144411,10148364,3953,4,"0"
"3422",34,8,71,10150567,10156821,6254,6.3,"0"
"3520",34,3,58,10161269,10166471,5202,5.2,"20"
"3628",34,4,11,10171234,10174327,3093,3.1,"0"
"3824",34,7,30,10182927,10187075,4148,4.1,"20"
"4021",34,6,21,10191955,10195470,3515,3.5,"0"
"4227",34,2,73,10205165,10209431,4266,4.3,"0"
"4321",34,5,28,10211374,10217316,5942,5.9,"20"
"4523",34,7,54,10229356,10236307,6951,7,"20"
"4619",34,5,68,10243072,10247466,4394,4.4,"20"
"4726",34,7,14,10249806,10256793,6987,7,"20"
"4925",34,6,69,10269202,10273564,4362,4.4,"0"
"5025",34,3,66,10278940,10283006,4066,4.1,"20"
"5125",34,5,36,10286237,10292089,5852,5.9,"20"
"5222",34,3,42,10297307,10302670,5363,5.4,"20"
"5325",34,2,41,10318289,10322866,4577,4.6,"0"
"5423",34,6,5,10338613,10346999,8386,8.4,"0"
"5625",34,3,10,10355379,10360656,5277,5.3,"20"
"5820",34,6,53,10366841,10372093,5252,5.3,"0"
"5923",34,2,33,10374784,10378609,3825,3.8,"0"
"6027",34,3,18,10381225,10385051,3826,3.8,"20"
"6229",34,3,50,10392759,10397074,4315,4.3,"20"
"6318",34,4,19,10400573,10404842,4269,4.3,"0"
"6520",34,4,43,10412522,10417826,5304,5.3,"0"
"6624",34,2,1,10421893,10424833,2940,2.9,"0"
"6826",34,2,57,10432326,10436548,4222,4.2,"0"
"6920",34,8,15,10438437,10442806,4369,4.4,"0"
"7132",34,1,24,10451468,10456676,5208,5.2,"20"
"7327",34,2,17,10463220,10467286,4066,4.1,"0"
"7526",34,7,6,10482686,10487045,4359,4.4,"20"
"7724",34,1,56,10496623,10501072,4449,4.4,"20"
"7821",34,1,80,10505168,10507813,2645,2.6,"20"
"7927",34,1,48,10512161,10516861,4700,4.7,"20"
"8023",34,8,39,10522850,10526974,4124,4.1,"0"
"8128",34,7,22,10530741,10534645,3904,3.9,"20"
"8321",34,4,3,10540037,10544882,4845,4.8,"0"
"8528",34,7,62,10549628,10557991,8363,8.4,"20"
"8621",34,4,27,10562160,10565253,3093,3.1,"0"
"8826",34,5,60,10572156,10575321,3165,3.2,"20"
"8921",34,2,25,10577500,10580496,2996,3,"0"
"9126",34,1,8,10585137,10592130,6993,7,"20"
"9324",34,1,32,10597332,10601322,3990,4,"20"
"9524",34,7,46,10607929,10612037,4108,4.1,"20"
"9625",34,5,52,10618427,10623996,5569,5.6,"20"
"9726",34,7,78,10627226,10630481,3255,3.3,"20"
"9820",34,4,59,10633881,10639046,5165,5.2,"0"
"9927",34,7,38,10641912,10647704,5792,5.8,"20"
"10018",34,6,45,10651180,10653950,2770,2.8,"0"
"10132",34,8,31,10656211,10660355,4144,4.1,"0"
"10320",34,6,29,10670210,10674738,4528,4.5,"0"
"10525",34,3,2,10683618,10687138,3520,3.5,"20"
"10723",34,6,61,10693680,10697501,3821,3.8,"0"
"10823",34,5,12,10701616,10704775,3159,3.2,"20"
"11024",34,8,79,10711768,10716179,4411,4.4,"0"
"11126",34,3,74,10722781,10726014,3233,3.2,"20"
"11224",34,8,23,10728691,10732433,3742,3.7,"0"
"11421",34,3,26,10737920,10742562,4642,4.6,"20"
"11621",34,2,9,10752259,10755961,3702,3.7,"0"
"11822",34,5,4,10762436,10765592,3156,3.2,"20"
"12012",34,1,16,10772414,10775858,3444,3.4,"20"
"10133",35,5,19,11931459,11939967,8508,8.5,"20"
"1232",35,5,67,11947636,11955150,7514,7.5,"20"
"1325",35,6,12,11956955,11963944,6989,7,"0"
"1524",35,5,59,11969096,11975488,6392,6.4,"20"
"1627",35,6,20,11977415,11981516,4101,4.1,"0"
"1823",35,3,57,11987802,11994818,7016,7,"20"
"1924",35,2,56,11996838,12001780,4942,4.9,"0"
"2023",35,8,22,12004692,12009116,4424,4.4,"0"
"2216",35,3,1,12014708,12021664,6956,7,"20"
"2422",35,4,66,12026547,12032229,5682,5.7,"0"
"2525",35,7,5,12034301,12042007,7706,7.7,"20"
"2727",35,5,3,12048846,12053277,4431,4.4,"20"
"2924",35,1,7,12058864,12067895,9031,9,"20"
"3125",35,7,37,12075868,12082893,7025,7,"20"
"3223",35,4,42,12085754,12092085,6331,6.3,"0"
"3324",35,5,11,12096819,12103379,6560,6.6,"20"
"3521",35,7,45,12109124,12113296,4172,4.2,"20"
"3629",35,8,30,12115792,12122374,6582,6.6,"0"
"3825",35,6,4,12130681,12138443,7762,7.8,"0"
"4022",35,2,64,12143047,12147668,4621,4.6,"0"
"4125",35,5,43,12150164,12159786,9622,9.6,"20"
"4228",35,3,9,12161718,12167555,5837,5.8,"20"
"4425",35,3,73,12173746,12180445,6699,6.7,"20"
"4524",35,8,46,12182767,12190505,7738,7.7,"0"
"4620",35,2,40,12193080,12198668,5588,5.6,"0"
"4727",35,8,54,12202149,12209016,6867,6.9,"0"
"4822",35,4,34,12212196,12218785,6589,6.6,"0"
"4926",35,7,21,12220684,12227838,7154,7.2,"20"
"5126",35,8,78,12233859,12238415,4556,4.6,"0"
"5223",35,6,60,12240770,12246685,5915,5.9,"0"
"5326",35,8,6,12251573,12258200,6627,6.6,"0"
"5521",35,2,32,12270546,12276784,6238,6.2,"0"
"5730",35,7,61,12282528,12287628,5100,5.1,"20"
"5821",35,3,65,12290419,12295812,5393,5.4,"20"
"5924",35,1,55,12297839,12304009,6170,6.2,"20"
"6028",35,5,27,12307554,12313725,6171,6.2,"20"
"6230",35,1,15,12318486,12324080,5594,5.6,"20"
"6425",35,2,48,12331466,12338609,7143,7.1,"0"
"6521",35,6,76,12340556,12345828,5272,5.3,"0"
"6625",35,4,18,12347720,12352612,4892,4.9,"0"
"6827",35,1,71,12358139,12361895,3756,3.8,"20"
"6921",35,7,29,12365470,12370993,5523,5.5,"20"
"7133",35,6,52,12375943,12383631,7688,7.7,"0"
"7223",35,2,8,12386552,12392167,5615,5.6,"0"
"7426",35,3,49,12397153,12402365,5212,5.2,"20"
"7527",35,4,50,12404148,12406891,2743,2.7,"0"
"7624",35,5,51,12410142,12416453,6311,6.3,"20"
"7725",35,5,75,12419154,12424371,5217,5.2,"20"
"7822",35,3,41,12428488,12432689,4201,4.2,"20"
"7928",35,6,68,12435402,12439532,4130,4.1,"0"
"8024",35,2,72,12444178,12450156,5978,6,"0"
"8129",35,2,24,12453484,12459065,5581,5.6,"0"
"8322",35,1,79,12465410,12469367,3957,4,"20"
"8421",35,6,44,12478713,12487169,8456,8.5,"0"
"8529",35,8,38,12489543,12498168,8625,8.6,"0"
"8622",35,4,2,12503425,12507778,4353,4.4,"0"
"8827",35,4,10,12513620,12516769,3149,3.1,"0"
"9030",35,1,23,12521756,12524588,2832,2.8,"20"
"9227",35,2,80,12530313,12532841,2528,2.5,"0"
"9325",35,8,62,12539145,12543964,4819,4.8,"0"
"9429",35,3,17,12546081,12551600,5519,5.5,"20"
"9626",35,3,25,12558304,12565779,7475,7.5,"20"
"9821",35,7,53,12574760,12581037,6277,6.3,"20"
"9928",35,1,47,12584000,12587488,3488,3.5,"20"
"10019",35,4,58,12589727,12594524,4797,4.8,"0"
"10134",35,7,69,12596770,12601208,4438,4.4,"20"
"10227",35,5,35,12603170,12607654,4484,4.5,"20"
"10321",35,8,70,12609776,12615096,5320,5.3,"0"
"10423",35,4,26,12617953,12623149,5196,5.2,"0"
"10624",35,1,31,12629827,12634321,4494,4.5,"20"
"10824",35,2,16,12640232,12644443,4211,4.2,"0"
"11025",35,6,36,12649095,12653992,4897,4.9,"0"
"11127",35,7,13,12655908,12664310,8402,8.4,"20"
"11327",35,1,63,12679781,12686902,7121,7.1,"20"
"11422",35,8,14,12689224,12694513,5289,5.3,"0"
"11622",35,1,39,12700481,12706122,5641,5.6,"20"
"11723",35,6,28,12708281,12711163,2882,2.9,"0"
"11917",35,7,77,12715589,12720059,4470,4.5,"20"
"12013",35,3,33,12722099,12729566,7467,7.5,"20"
"12121",35,4,74,12731536,12737067,5531,5.5,"0"
"10135",36,1,70,3322498,3325858,3360,3.4,"20"
"11102",36,7,76,3329591,3333201,3610,3.6,"20"
"1233",36,7,44,3340832,3344436,3604,3.6,"20"
"1326",36,3,56,3346556,3349968,3412,3.4,"20"
"1429",36,1,14,3357117,3360471,3354,3.4,"20"
"1628",36,5,26,3366770,3369879,3109,3.1,"20"
"1824",36,5,18,3375491,3378972,3481,3.5,"20"
"2024",36,7,4,3384633,3387433,2800,2.8,"20"
"2217",36,1,38,3398360,3402017,3657,3.7,"20"
"2326",36,1,6,3403978,3407037,3059,3.1,"20"
"2526",36,3,24,3415305,3418818,3513,3.5,"20"
"2728",36,8,29,3425146,3428360,3214,3.2,"0"
"2925",36,3,32,3434555,3438060,3505,3.5,"20"
"3126",36,6,19,3442794,3445830,3036,3,"0"
"3325",36,4,33,3455048,3457438,2390,2.4,"0"
"3423",36,4,49,3461958,3464511,2553,2.6,"0"
"3522",36,3,40,3466634,3469240,2606,2.6,"20"
"3630",36,4,17,3471420,3474959,3539,3.5,"0"
"3826",36,4,1,3481136,3484249,3113,3.1,"0"
"4023",36,5,50,3490208,3492567,2359,2.4,"20"
"4126",36,7,52,3495577,3499013,3436,3.4,"20"
"4229",36,6,11,3501613,3504850,3237,3.2,"0"
"4426",36,6,27,3512975,3517516,4541,4.5,"0"
"4621",36,6,67,3523440,3526629,3189,3.2,"0"
"4728",36,8,53,3530216,3533353,3137,3.1,"0"
"4823",36,5,74,3535563,3539733,4170,4.2,"20"
"4927",36,2,7,3542446,3545821,3375,3.4,"0"
"5127",36,8,21,3551449,3555119,3670,3.7,"0"
"5327",36,1,22,3560506,3563613,3107,3.1,"20"
"5522",36,3,80,3568621,3571726,3105,3.1,"20"
"5626",36,2,31,3573802,3577713,3911,3.9,"0"
"5822",36,2,15,3588011,3590649,2638,2.6,"0"
"6029",36,2,39,3596062,3599389,3327,3.3,"0"
"6121",36,3,64,3601299,3604598,3299,3.3,"20"
"6231",36,8,45,3606583,3609416,2833,2.8,"0"
"6319",36,2,63,3611463,3615534,4071,4.1,"0"
"6426",36,8,69,3617829,3621151,3322,3.3,"0"
"6522",36,1,78,3623106,3626277,3171,3.2,"20"
"6626",36,6,3,3629931,3634127,4196,4.2,"0"
"6828",36,5,58,3640202,3644503,4301,4.3,"20"
"6922",36,6,59,3646446,3649179,2733,2.7,"0"
"7025",36,4,57,3651162,3654112,2950,3,"0"
"7134",36,4,9,3658895,3663344,4449,4.4,"0"
"7328",36,2,23,3668246,3670464,2218,2.2,"0"
"7528",36,2,71,3677503,3680785,3282,3.3,"0"
"7625",36,4,73,3682948,3686457,3509,3.5,"0"
"7726",36,7,36,3688503,3691977,3474,3.5,"20"
"7823",36,7,20,3693970,3697590,3620,3.6,"20"
"8025",36,4,65,3702891,3706711,3820,3.8,"0"
"8130",36,7,68,3709082,3713497,4415,4.4,"20"
"8223",36,7,12,3716691,3720942,4251,4.3,"20"
"8422",36,5,66,3726228,3729207,2979,3,"20"
"8530",36,4,41,3733142,3736279,3137,3.1,"0"
"8623",36,4,25,3738280,3740602,2322,2.3,"0"
"8828",36,8,13,3745553,3748489,2936,2.9,"0"
"9031",36,1,30,3753148,3755594,2446,2.4,"20"
"9228",36,7,60,3760328,3763142,2814,2.8,"20"
"9326",36,8,37,3767217,3770444,3227,3.2,"0"
"9430",36,1,62,3772485,3777406,4921,4.9,"20"
"9525",36,2,79,3779401,3782048,2647,2.6,"0"
"9627",36,6,75,3783906,3787325,3419,3.4,"0"
"9727",36,1,54,3789463,3793090,3627,3.6,"20"
"9822",36,2,47,3799121,3803155,4034,4,"0"
"9929",36,5,2,3805386,3808301,2915,2.9,"20"
"10136",36,8,61,3814293,3817860,3567,3.6,"0"
"10228",36,5,10,3820052,3823543,3491,3.5,"20"
"10424",36,6,43,3828626,3831013,2387,2.4,"0"
"10526",36,6,51,3832941,3835033,2092,2.1,"0"
"10625",36,7,28,3838921,3841408,2487,2.5,"20"
"10825",36,3,8,3847552,3850173,2621,2.6,"20"
"11026",36,8,5,3857519,3861343,3824,3.8,"0"
"11225",36,1,46,3869136,3872562,3426,3.4,"20"
"11328",36,3,72,3874494,3877541,3047,3,"20"
"11423",36,5,34,3880787,3885202,4415,4.4,"20"
"11524",36,8,77,3887289,3890210,2921,2.9,"0"
"11623",36,3,16,3895212,3898515,3303,3.3,"20"
"11823",36,3,48,3904953,3907931,2978,3,"20"
"11918",36,2,55,3909746,3912204,2458,2.5,"0"
"12014",36,5,42,3914205,3916992,2787,2.8,"20"
"12122",36,6,35,3919730,3923932,4202,4.2,"0"
"10137",37,4,48,433901,438270,4369,4.4,"0"
"11103",37,2,70,440637,444898,4261,4.3,"0"
"1234",37,5,9,447191,451865,4674,4.7,"20"
"1430",37,4,40,465608,469483,3875,3.9,"0"
"1525",37,8,60,471902,479742,7840,7.8,"0"
"1629",37,4,24,482078,486360,4282,4.3,"0"
"1825",37,8,20,492838,499951,7113,7.1,"0"
"2025",37,1,69,505884,513886,8002,8,"20"
"2126",37,3,15,517276,521753,4477,4.5,"20"
"2327",37,8,28,528590,533234,4644,4.6,"0"
"2527",37,2,78,538193,544202,6009,6,"0"
"2622",37,5,17,547123,553040,5917,5.9,"20"
"2822",37,2,22,562561,566586,4025,4,"0"
"3024",37,4,56,570925,574338,3413,3.4,"0"
"3127",37,2,30,576364,580099,3735,3.7,"0"
"3326",37,7,59,584354,589086,4732,4.7,"20"
"3424",37,4,32,591700,596316,4616,4.6,"0"
"3631",37,3,71,600634,603826,3192,3.2,"20"
"3719",37,6,34,607093,611395,4302,4.3,"0"
"3827",37,3,79,614239,618631,4392,4.4,"20"
"3923",37,7,19,620907,623805,2898,2.9,"20"
"4127",37,3,7,635249,638146,2897,2.9,"20"
"4322",37,6,66,644394,649397,5003,5,"0"
"4427",37,6,2,651591,657355,5764,5.8,"0"
"4622",37,2,54,662985,667090,4105,4.1,"0"
"4729",37,7,11,669084,671359,2275,2.3,"20"
"4928",37,6,50,679805,682713,2908,2.9,"0"
"5026",37,6,26,684654,687573,2919,2.9,"0"
"5224",37,7,75,692164,697046,4882,4.9,"20"
"5328",37,5,33,699236,702654,3418,3.4,"20"
"5424",37,7,43,705098,708686,3588,3.6,"20"
"5523",37,4,80,710727,714553,3826,3.8,"0"
"5627",37,2,62,716797,720822,4025,4,"0"
"5731",37,1,45,722896,726029,3133,3.1,"20"
"5823",37,5,49,728063,732619,4556,4.6,"20"
"5925",37,1,5,735391,740515,5124,5.1,"20"
"6122",37,2,46,745726,750148,4422,4.4,"0"
"6232",37,1,77,752043,757248,5205,5.2,"20"
"6320",37,7,51,760649,764681,4032,4,"20"
"6427",37,7,27,766716,770352,3636,3.6,"20"
"6627",37,7,67,778336,781292,2956,3,"20"
"6722",37,4,8,786519,790466,3947,3.9,"0"
"6923",37,5,25,796484,801602,5118,5.1,"20"
"7135",37,7,35,809879,813802,3923,3.9,"20"
"7224",37,3,47,815782,818673,2891,2.9,"20"
"7329",37,8,36,822432,826604,4172,4.2,"0"
"7427",37,3,63,828823,834234,5411,5.4,"20"
"7529",37,2,38,837420,840496,3076,3.1,"0"
"7626",37,4,72,842461,845298,2837,2.8,"0"
"7727",37,8,76,848386,851648,3262,3.3,"0"
"7824",37,1,53,854255,859212,4957,5,"20"
"7929",37,6,42,861589,864514,2925,2.9,"0"
"8026",37,6,18,866461,870570,4109,4.1,"0"
"8224",37,3,55,882073,886496,4423,4.4,"20"
"8323",37,7,3,888572,891003,2431,2.4,"20"
"8531",37,1,61,896861,903133,6272,6.3,"20"
"8624",37,1,13,905548,908811,3263,3.3,"20"
"8829",37,1,37,914261,918109,3848,3.8,"20"
"8922",37,3,23,920520,924980,4460,4.5,"20"
"9127",37,6,74,930017,933945,3928,3.9,"0"
"9229",37,3,31,936298,939935,3637,3.6,"20"
"9431",37,1,21,944876,947946,3070,3.1,"20"
"9628",37,6,58,952563,956161,3598,3.6,"0"
"9728",37,5,57,958007,961692,3685,3.7,"20"
"9823",37,8,44,963583,965867,2284,2.3,"0"
"9930",37,2,6,968804,971752,2948,2.9,"0"
"10138",37,8,4,976081,978804,2723,2.7,"0"
"10322",37,4,64,983706,987039,3333,3.3,"0"
"10425",37,5,41,988973,993514,4541,4.5,"20"
"10527",37,5,65,996565,1000835,4270,4.3,"20"
"10626",37,8,12,1005646,1008318,2672,2.7,"0"
"10826",37,1,29,1014171,1016889,2718,2.7,"20"
"11027",37,4,16,1022187,1024715,2528,2.5,"0"
"11226",37,5,1,1028599,1032215,3616,3.6,"20"
"11424",37,2,14,1038027,1042047,4020,4,"0"
"11624",37,5,73,1050440,1053635,3195,3.2,"20"
"11724",37,8,52,1056457,1058963,2506,2.5,"0"
"11824",37,6,10,1065874,1069435,3561,3.6,"0"
"12015",37,3,39,1076398,1079471,3073,3.1,"20"
"12123",37,8,68,1082339,1085121,2782,2.8,"0"
"10139",38,5,48,1483374,1488938,5564,5.6,"20"
"11104",38,3,46,1491981,1495495,3514,3.5,"20"
"1235",38,4,55,1497675,1502007,4332,4.3,"0"
"1327",38,5,24,1504298,1509848,5550,5.5,"20"
"1526",38,7,18,1515162,1518240,3078,3.1,"20"
"1722",38,4,47,1524205,1527493,3288,3.3,"0"
"1826",38,6,17,1529733,1534319,4586,4.6,"0"
"2026",38,6,25,1539467,1542960,3493,3.5,"0"
"2218",38,8,3,1548075,1550571,2496,2.5,"0"
"2423",38,7,26,1555875,1560323,4448,4.4,"20"
"2623",38,6,49,1567140,1570821,3681,3.7,"0"
"2729",38,7,74,1574358,1577988,3630,3.6,"20"
"2823",38,5,16,1580164,1583097,2933,2.9,"20"
"3025",38,4,71,1588850,1592447,3597,3.6,"0"
"3128",38,3,38,1594504,1598461,3957,4,"20"
"3224",38,2,29,1600837,1604302,3465,3.5,"0"
"3425",38,2,13,1609784,1612760,2976,3,"0"
"3632",38,8,11,1618776,1623503,4727,4.7,"0"
"3828",38,5,8,1630004,1634493,4489,4.5,"20"
"4024",38,3,6,1640413,1645741,5328,5.3,"20"
"4230",38,8,51,1651421,1654816,3395,3.4,"0"
"4323",38,2,5,1657109,1661439,4330,4.3,"0"
"4525",38,4,63,1667517,1673059,5542,5.5,"0"
"4623",38,3,62,1675463,1682123,6660,6.7,"20"
"4730",38,1,20,1684363,1686962,2599,2.6,"20"
"4929",38,2,53,1693035,1696967,3932,3.9,"0"
"5027",38,7,66,1699497,1703036,3539,3.5,"20"
"5128",38,3,22,1705361,1710698,5337,5.3,"20"
"5329",38,3,70,1715903,1719132,3229,3.2,"20"
"5425",38,6,33,1722292,1725662,3370,3.4,"0"
"5524",38,2,45,1727747,1730151,2404,2.4,"0"
"5628",38,5,56,1732891,1736637,3746,3.7,"20"
"5732",38,3,54,1740187,1744176,3989,4,"20"
"5824",38,7,10,1747552,1750797,3245,3.2,"20"
"6030",38,7,58,1757016,1760427,3411,3.4,"20"
"6123",38,8,27,1762501,1768097,5596,5.6,"0"
"6321",38,8,43,1773805,1778418,4613,4.6,"0"
"6428",38,2,61,1780714,1784905,4191,4.2,"0"
"6523",38,3,14,1787173,1790158,2985,3,"20"
"6723",38,8,35,1796991,1799701,2710,2.7,"0"
"6829",38,7,50,1804048,1808754,4706,4.7,"20"
"6924",38,1,60,1810732,1814933,4201,4.2,"20"
"7026",38,1,12,1818684,1821992,3308,3.3,"20"
"7225",38,7,2,1827603,1830991,3388,3.4,"20"
"7428",38,1,52,1837264,1841042,3778,3.8,"20"
"7530",38,1,44,1843581,1847610,4029,4,"20"
"7627",38,6,65,1850312,1857220,6908,6.9,"0"
"7728",38,1,76,1859956,1863842,3886,3.9,"20"
"7825",38,5,72,1867420,1871750,4330,4.3,"20"
"7930",38,4,7,1874094,1877577,3483,3.5,"0"
"8131",38,7,34,1884940,1889705,4765,4.8,"20"
"8225",38,4,15,1892908,1896176,3268,3.3,"0"
"8423",38,6,1,1902088,1904288,2200,2.2,"0"
"8625",38,6,57,1909999,1913111,3112,3.1,"0"
"8724",38,5,80,1915186,1918544,3358,3.4,"20"
"8830",38,1,28,1921417,1926001,4584,4.6,"20"
"9032",38,7,42,1932543,1943979,11436,11.4,"20"
"9128",38,5,40,1947031,1950144,3113,3.1,"20"
"9230",38,2,21,1952649,1956494,3845,3.8,"0"
"9432",38,1,4,1962524,1969366,6842,6.8,"20"
"9629",38,8,59,1975923,1979447,3524,3.5,"0"
"9729",38,8,75,1983781,1986310,2529,2.5,"0"
"9824",38,4,79,1988883,1995821,6938,6.9,"0"
"9931",38,5,64,1998519,2002123,3604,3.6,"20"
"10020",38,6,41,2003970,2008764,4794,4.8,"0"
"10140",38,4,31,2011214,2019320,8106,8.1,"0"
"10323",38,2,77,2024089,2026908,2819,2.8,"0"
"10426",38,4,23,2028881,2031395,2514,2.5,"0"
"10627",38,5,32,2036433,2043595,7162,7.2,"20"
"10827",38,3,78,2049684,2052657,2973,3,"20"
"10923",38,1,68,2055089,2061033,5944,5.9,"20"
"11028",38,4,39,2064030,2066462,2432,2.4,"0"
"11128",38,8,67,2069073,2074333,5260,5.3,"0"
"11227",38,2,69,2077449,2081415,3966,4,"0"
"11329",38,3,30,2084345,2086766,2421,2.4,"20"
"11525",38,2,37,2091874,2099375,7501,7.5,"0"
"11625",38,6,9,2103804,2107485,3681,3.7,"0"
"11825",38,8,19,2114812,2119125,4313,4.3,"0"
"12016",38,1,36,2126502,2129393,2891,2.9,"20"
"12124",38,6,73,2131658,2137565,5907,5.9,"0"
"10141",39,1,67,2498691,2502284,3593,3.6,"20"
"11105",39,1,19,2504397,2507762,3365,3.4,"20"
"1328",39,1,27,2513707,2516741,3034,3,"20"
"1527",39,6,24,2522068,2524722,2654,2.7,"0"
"1723",39,3,77,2531488,2534163,2675,2.7,"20"
"1827",39,6,32,2536507,2539114,2607,2.6,"0"
"2027",39,4,46,2545832,2548681,2849,2.8,"0"
"2127",39,5,47,2550890,2552988,2098,2.1,"20"
"2219",39,3,13,2555215,2557717,2502,2.5,"20"
"2424",39,1,35,2562950,2565305,2355,2.4,"20"
"2528",39,6,16,2567126,2569464,2338,2.3,"0"
"2730",39,6,40,2574147,2576972,2825,2.8,"0"
"2824",39,5,39,2578873,2581105,2232,2.2,"20"
"2926",39,5,63,2583210,2586158,2948,2.9,"20"
"3026",39,7,25,2588099,2590891,2792,2.8,"20"
"3225",39,6,8,2596115,2598692,2577,2.6,"0"
"3426",39,8,74,2604377,2607123,2746,2.7,"0"
"3523",39,7,49,2609875,2612634,2759,2.8,"20"
"3633",39,8,26,2614452,2616850,2398,2.4,"0"
"3829",39,5,23,2623425,2625419,1994,2,"20"
"4025",39,7,65,2630842,2633313,2471,2.5,"20"
"4128",39,8,42,2636833,2640033,3200,3.2,"0"
"4231",39,8,10,2641920,2644151,2231,2.2,"0"
"4428",39,8,50,2650350,2652474,2124,2.1,"0"
"4526",39,2,52,2654566,2657100,2534,2.5,"0"
"4624",39,8,58,2659303,2662075,2772,2.8,"0"
"4731",39,5,79,2663843,2666038,2195,2.2,"20"
"4824",39,2,76,2667982,2671147,3165,3.2,"0"
"4930",39,3,29,2674729,2677207,2478,2.5,"20"
"5129",39,3,21,2681882,2684244,2362,2.4,"20"
"5330",39,2,20,2689944,2692001,2057,2.1,"0"
"5525",39,8,2,2698498,2701220,2722,2.7,"0"
"5733",39,5,71,2706457,2708693,2236,2.2,"20"
"5825",39,3,37,2710341,2713876,3535,3.5,"20"
"5926",39,2,28,2717022,2720002,2980,3,"0"
"6124",39,5,55,2726157,2728637,2480,2.5,"20"
"6233",39,4,70,2730457,2732865,2408,2.4,"0"
"6322",39,7,57,2734924,2737327,2403,2.4,"20"
"6429",39,1,59,2740455,2743257,2802,2.8,"20"
"6524",39,6,56,2745537,2747707,2170,2.2,"0"
"6628",39,7,9,2749440,2751965,2525,2.5,"20"
"6830",39,6,72,2758395,2761222,2827,2.8,"0"
"6925",39,7,73,2762985,2765512,2527,2.5,"20"
"7027",39,6,80,2767250,2769188,1938,1.9,"0"
"7136",39,7,1,2771460,2773604,2144,2.1,"20"
"7330",39,4,30,2778745,2781280,2535,2.5,"0"
"7531",39,3,61,2785737,2789111,3374,3.4,"20"
"7628",39,8,66,2790893,2793339,2446,2.4,"0"
"7729",39,1,43,2795105,2797093,1988,2,"20"
"7826",39,3,53,2800723,2803697,2974,3,"20"
"7931",39,4,62,2806078,2809451,3373,3.4,"0"
"8027",39,7,33,2811123,2812741,1618,1.6,"20"
"8132",39,4,38,2815951,2818727,2776,2.8,"0"
"8226",39,4,22,2820681,2823043,2362,2.4,"0"
"8424",39,5,15,2829536,2831369,1833,1.8,"20"
"8626",39,1,75,2836621,2839175,2554,2.6,"20"
"8725",39,1,11,2840942,2843469,2527,2.5,"20"
"8923",39,1,51,2848913,2851345,2432,2.4,"20"
"9033",39,6,48,2853217,2856119,2902,2.9,"0"
"9129",39,1,3,2859150,2861306,2156,2.2,"20"
"9327",39,8,18,2866390,2868952,2562,2.6,"0"
"9526",39,3,45,2874128,2876709,2581,2.6,"20"
"9630",39,2,44,2878675,2880724,2049,2,"0"
"9730",39,5,7,2883671,2886096,2425,2.4,"20"
"9932",39,4,78,2893425,2897242,3817,3.8,"0"
"10021",39,2,60,2899024,2901188,2164,2.2,"0"
"10142",39,2,36,2902918,2905613,2695,2.7,"0"
"10229",39,6,64,2907914,2910398,2484,2.5,"0"
"10324",39,8,34,2912241,2915198,2957,3,"0"
"10427",39,3,69,2918477,2921319,2842,2.8,"20"
"10528",39,2,68,2924511,2926921,2410,2.4,"0"
"10628",39,4,14,2930129,2932851,2722,2.7,"0"
"10828",39,4,54,2938187,2940863,2676,2.7,"0"
"10924",39,2,12,2942838,2945729,2891,2.9,"0"
"11129",39,2,4,2950515,2952862,2347,2.3,"0"
"11330",39,3,5,2958606,2961418,2812,2.8,"20"
"11526",39,4,6,2966391,2969156,2765,2.8,"0"
"11725",39,7,17,2975462,2977963,2501,2.5,"20"
"11919",39,7,41,2984377,2987155,2778,2.8,"20"
"12017",39,5,31,2989432,2992065,2633,2.6,"20"
"10143",40,1,10,3578534,3582609,4075,4.1,"20"
"1236",40,1,66,3591407,3595750,4343,4.3,"20"
"1329",40,2,51,3598325,3601984,3659,3.7,"0"
"1431",40,5,46,3605510,3609665,4155,4.2,"20"
"1528",40,3,60,3611811,3616258,4447,4.4,"20"
"1630",40,2,27,3620240,3623679,3439,3.4,"0"
"1828",40,5,14,3629880,3634680,4800,4.8,"20"
"2028",40,6,39,3642974,3647309,4335,4.3,"0"
"2128",40,7,48,3649399,3653239,3840,3.8,"20"
"2220",40,5,54,3659547,3663190,3643,3.6,"20"
"2328",40,7,64,3666437,3669583,3146,3.1,"20"
"2425",40,6,55,3671823,3675074,3251,3.3,"0"
"2529",40,2,19,3676988,3680052,3064,3.1,"0"
"2731",40,5,62,3713524,3717475,3951,4,"20"
"2825",40,6,63,3721686,3725587,3901,3.9,"0"
"2927",40,3,44,3728482,3732430,3948,3.9,"20"
"3027",40,4,21,3735986,3739453,3467,3.5,"0"
"3226",40,4,29,3750163,3754085,3922,3.9,"0"
"3427",40,3,76,3760775,3765575,4800,4.8,"20"
"3524",40,2,35,3770225,3773429,3204,3.2,"0"
"3634",40,2,59,3775524,3778690,3166,3.2,"0"
"3720",40,4,61,3780818,3784816,3998,4,"0"
"3830",40,8,33,3789931,3792970,3039,3,"0"
"3924",40,7,80,3796650,3800195,3545,3.5,"20"
"4026",40,7,40,3802919,3806340,3421,3.4,"20"
"4129",40,1,42,3809544,3813695,4151,4.2,"20"
"4232",40,3,20,3815994,3818985,2991,3,"20"
"4429",40,2,43,3824999,3829270,4271,4.3,"0"
"4527",40,5,78,3832913,3836256,3343,3.3,"20"
"4625",40,8,9,3841224,3844599,3375,3.4,"0"
"4825",40,1,18,3850175,3853088,2913,2.9,"20"
"5028",40,5,30,3861616,3865394,3778,3.8,"20"
"5225",40,5,70,3871331,3874830,3499,3.5,"20"
"5331",40,4,53,3877444,3881826,4382,4.4,"0"
"5426",40,5,6,3886144,3889685,3541,3.5,"20"
"5629",40,4,5,3896770,3900514,3744,3.7,"0"
"5826",40,7,72,3916231,3920784,4553,4.6,"20"
"5927",40,3,36,3932241,3936896,4655,4.7,"20"
"6031",40,1,2,3954105,3956930,2825,2.8,"20"
"6234",40,6,31,3964377,3968156,3779,3.8,"0"
"6430",40,6,47,3975259,3979035,3776,3.8,"0"
"6525",40,6,71,3981269,3984321,3052,3.1,"0"
"6629",40,5,22,3986313,3989238,2925,2.9,"20"
"6831",40,3,52,3995804,3998928,3124,3.1,"20"
"6926",40,3,28,4001534,4004871,3337,3.3,"20"
"7137",40,8,73,4011068,4014426,3358,3.4,"0"
"7226",40,2,11,4016763,4019975,3212,3.2,"0"
"7429",40,4,45,4026202,4029874,3672,3.7,"0"
"7532",40,4,77,4032503,4036012,3509,3.5,"0"
"7629",40,8,65,4038229,4042622,4393,4.4,"0"
"7730",40,3,68,4044603,4047448,2845,2.8,"20"
"7827",40,1,50,4049543,4052460,2917,2.9,"20"
"7932",40,8,49,4055031,4058061,3030,3,"0"
"8028",40,1,74,4059974,4063663,3689,3.7,"20"
"8133",40,3,12,4066753,4069699,2946,2.9,"20"
"8324",40,8,57,4076264,4079304,3040,3,"0"
"8425",40,7,8,4081470,4084450,2980,3,"20"
"8627",40,7,56,4091573,4095083,3510,3.5,"20"
"8726",40,5,38,4098648,4102295,3647,3.6,"20"
"8831",40,7,24,4104543,4107421,2878,2.9,"20"
"9034",40,7,16,4112990,4116320,3330,3.3,"20"
"9231",40,3,4,4122453,4126249,3796,3.8,"20"
"9433",40,4,37,4133226,4136772,3546,3.5,"0"
"9527",40,1,34,4138762,4142156,3394,3.4,"20"
"9631",40,2,75,4144465,4147831,3366,3.4,"0"
"9731",40,8,1,4154537,4157235,2698,2.7,"0"
"9933",40,7,32,4163555,4167085,3530,3.5,"20"
"10144",40,2,3,4172601,4175408,2807,2.8,"0"
"10325",40,4,13,4181794,4185250,3456,3.5,"0"
"10529",40,2,67,4190829,4195128,4299,4.3,"0"
"10629",40,6,7,4197736,4202070,4334,4.3,"0"
"10829",40,8,17,4209469,4214097,4628,4.6,"0"
"11029",40,4,69,4219881,4223091,3210,3.2,"0"
"11130",40,8,41,4225185,4228311,3126,3.1,"0"
"11228",40,8,25,4231789,4234687,2898,2.9,"0"
"11425",40,6,15,4240456,4243894,3438,3.4,"0"
"11626",40,6,23,4249875,4252416,2541,2.5,"0"
"11826",40,6,79,4259285,4262472,3187,3.2,"0"
"11920",40,1,26,4264995,4267954,2959,3,"20"
"12125",40,1,58,4274514,4277650,3136,3.1,"20"
"10145",41,8,8,4681507,4684211,2704,2.7,"0"
"1237",41,4,12,4689406,4691606,2200,2.2,"0"
"1432",41,4,28,4696364,4699024,2660,2.7,"0"
"1631",41,5,69,4705201,4707845,2644,2.6,"20"
"1724",41,5,61,4711005,4714010,3005,3,"20"
"1829",41,3,3,4716365,4719221,2856,2.9,"20"
"2029",41,8,80,4723989,4726723,2734,2.7,"0"
"2129",41,5,21,4729518,4732509,2991,3,"20"
"2329",41,6,30,4738366,4740777,2411,2.4,"0"
"2530",41,7,79,4745660,4748366,2706,2.7,"20"
"2624",41,5,77,4750733,4753618,2885,2.9,"20"
"2732",41,7,47,4756497,4759228,2731,2.7,"20"
"2826",41,2,50,4761341,4763654,2313,2.3,"0"
"2928",41,4,68,4765777,4768390,2613,2.6,"0"
"3028",41,1,33,4771023,4773553,2530,2.5,"20"
"3129",41,1,49,4776845,4779420,2575,2.6,"20"
"3227",41,8,24,4785154,4787996,2842,2.8,"0"
"3428",41,7,39,4793823,4796873,3050,3,"20"
"3525",41,7,23,4798872,4801794,2922,2.9,"20"
"3721",41,3,27,4806389,4809362,2973,3,"20"
"3925",41,4,4,4814241,4816717,2476,2.5,"0"
"4130",41,5,53,4822471,4825166,2695,2.7,"20"
"4233",41,7,7,4827292,4829689,2397,2.4,"20"
"4430",41,2,18,4835089,4837306,2217,2.2,"0"
"4626",41,4,36,4842844,4847489,4645,4.6,"0"
"4732",41,6,62,4849504,4853391,3887,3.9,"0"
"4826",41,1,57,4855533,4858069,2536,2.5,"20"
"4931",41,6,78,4862474,4865024,2550,2.5,"0"
"5029",41,5,5,4868750,4872026,3276,3.3,"20"
"5226",41,1,41,4878035,4880518,2483,2.5,"20"
"5332",41,2,34,4882551,4885797,3246,3.2,"0"
"5427",41,2,26,4887973,4890422,2449,2.4,"0"
"5630",41,6,22,4895147,4897505,2358,2.4,"0"
"5827",41,4,76,4905980,4908579,2599,2.6,"0"
"5928",41,6,14,4943683,4945951,2268,2.3,"0"
"6125",41,2,10,4950862,4953204,2342,2.3,"0"
"6323",41,6,6,4958144,4960792,2648,2.6,"0"
"6526",41,3,59,4965143,4967983,2840,2.8,"20"
"6630",41,8,48,4970029,4973200,3171,3.2,"0"
"6724",41,8,64,4976959,4979711,2752,2.8,"0"
"6832",41,3,19,4981784,4984239,2455,2.5,"20"
"7028",41,8,40,4990198,4992521,2323,2.3,"0"
"7138",41,7,31,4995375,4998048,2673,2.7,"20"
"7331",41,3,51,5005270,5007943,2673,2.7,"20"
"7430",41,7,71,5009912,5012422,2510,2.5,"20"
"7533",41,6,54,5015311,5017506,2195,2.2,"0"
"7630",41,4,20,5021343,5023399,2056,2.1,"0"
"7828",41,1,65,5029916,5032513,2597,2.6,"20"
"7933",41,5,13,5034480,5036863,2383,2.4,"20"
"8134",41,8,32,5041380,5043813,2433,2.4,"0"
"8325",41,1,25,5048778,5051237,2459,2.5,"20"
"8532",41,3,35,5057922,5060380,2458,2.5,"20"
"8628",41,5,37,5063245,5066038,2793,2.8,"20"
"8727",41,6,70,5068324,5070676,2352,2.4,"0"
"8832",41,7,55,5074019,5076782,2763,2.8,"20"
"8924",41,2,58,5078703,5081252,2549,2.5,"0"
"9035",41,1,73,5085847,5088480,2633,2.6,"20"
"9130",41,1,9,5090481,5093225,2744,2.7,"20"
"9328",41,3,43,5097923,5100119,2196,2.2,"20"
"9434",41,1,17,5102306,5104994,2688,2.7,"20"
"9632",41,4,60,5109661,5112131,2470,2.5,"0"
"9732",41,6,38,5114821,5117103,2282,2.3,"0"
"9825",41,8,16,5120339,5122854,2515,2.5,"0"
"10022",41,3,11,5127983,5130063,2080,2.1,"20"
"10230",41,2,66,5136698,5140077,3379,3.4,"0"
"10326",41,3,75,5141913,5144221,2308,2.3,"20"
"10428",41,1,1,5147865,5150146,2281,2.3,"20"
"10630",41,4,44,5154925,5157158,2233,2.2,"0"
"10724",41,2,74,5159784,5161915,2131,2.1,"0"
"10830",41,5,45,5163791,5165839,2048,2,"20"
"10925",41,2,2,5169020,5171581,2561,2.6,"0"
"11131",41,6,46,5179625,5182600,2975,3,"0"
"11229",41,2,42,5184740,5186824,2084,2.1,"0"
"11331",41,3,67,5188785,5191316,2531,2.5,"20"
"11426",41,4,52,5196590,5198512,1922,1.9,"0"
"11527",41,8,56,5200472,5202446,1974,2,"0"
"11627",41,7,15,5206537,5208473,1936,1.9,"20"
"11827",41,8,72,5213700,5216889,3189,3.2,"0"
"11921",41,7,63,5218904,5221683,2779,2.8,"20"
"12018",41,5,29,5224498,5227003,2505,2.5,"20"
"10146",42,3,2,1338386,1342297,3911,3.9,"20"
"1238",42,5,68,1349517,1353991,4474,4.5,"20"
"1330",42,4,3,1356051,1360576,4525,4.5,"0"
"1529",42,5,52,1367986,1372478,4492,4.5,"20"
"1632",42,4,67,1374868,1379550,4682,4.7,"0"
"1725",42,5,28,1381629,1385696,4067,4.1,"20"
"1925",42,1,32,1391882,1395813,3931,3.9,"20"
"2130",42,7,62,1401361,1406077,4716,4.7,"20"
"2221",42,1,56,1408140,1411675,3535,3.5,"20"
"2330",42,4,11,1413715,1420418,6703,6.7,"0"
"2531",42,2,33,1429621,1434580,4959,5,"0"
"2625",42,8,7,1437303,1441999,4696,4.7,"0"
"2827",42,6,77,1448238,1452161,3923,3.9,"0"
"2929",42,6,5,1454246,1459950,5704,5.7,"0"
"3130",42,4,43,1465870,1469798,3928,3.9,"0"
"3228",42,3,50,1471840,1475586,3746,3.7,"20"
"3327",42,7,54,1477616,1483737,6121,6.1,"20"
"3429",42,6,53,1486215,1490591,4376,4.4,"0"
"3526",42,5,36,1492612,1497431,4819,4.8,"20"
"3635",42,1,8,1499485,1504362,4877,4.9,"20"
"3831",42,7,14,1510143,1515894,5751,5.8,"20"
"4027",42,5,4,1522456,1527821,5365,5.4,"20"
"4234",42,1,16,1532658,1539712,7054,7.1,"20"
"4431",42,6,29,1544975,1548637,3662,3.7,"0"
"4627",42,8,79,1554086,1558046,3960,4,"0"
"4733",42,2,73,1560258,1564746,4488,4.5,"0"
"4827",42,1,40,1566749,1570787,4038,4,"20"
"4932",42,2,9,1572936,1577487,4551,4.6,"0"
"5130",42,1,48,1582928,1587528,4600,4.6,"20"
"5227",42,2,17,1589631,1595445,5814,5.8,"0"
"5428",42,1,64,1600682,1604845,4163,4.2,"20"
"5526",42,2,1,1607311,1610639,3328,3.3,"0"
"5734",42,5,76,1615344,1618784,3440,3.4,"20"
"5828",42,8,23,1621420,1624337,2917,2.9,"0"
"6032",42,3,66,1629310,1633538,4228,4.2,"20"
"6126",42,8,15,1635306,1638148,2842,2.8,"0"
"6324",42,8,39,1643879,1648626,4747,4.7,"0"
"6431",42,7,22,1650502,1655255,4753,4.8,"20"
"6631",42,7,78,1660573,1665569,4996,5,"20"
"6725",42,6,69,1667494,1671375,3881,3.9,"0"
"6833",42,2,49,1673831,1677251,3420,3.4,"0"
"6927",42,5,20,1679110,1683597,4487,4.5,"20"
"7139",42,2,65,1689120,1693284,4164,4.2,"0"
"7227",42,4,35,1695203,1698542,3339,3.3,"0"
"7332",42,5,12,1700854,1704294,3440,3.4,"20"
"7534",42,4,59,1709795,1713723,3928,3.9,"0"
"7631",42,6,21,1715468,1718299,2831,2.8,"0"
"7829",42,4,19,1723833,1727171,3338,3.3,"0"
"8029",42,8,47,1734232,1737632,3400,3.4,"0"
"8135",42,3,10,1739717,1744274,4557,4.6,"20"
"8326",42,7,70,1749683,1756857,7174,7.2,"20"
"8426",42,7,38,1758633,1762363,3730,3.7,"20"
"8533",42,7,30,1764332,1767625,3293,3.3,"20"
"8728",42,4,51,1772658,1776471,3813,3.8,"0"
"8833",42,6,45,1779713,1783215,3502,3.5,"0"
"8925",42,6,37,1785187,1789071,3884,3.9,"0"
"9036",42,6,13,1791567,1795029,3462,3.5,"0"
"9232",42,3,26,1799946,1804478,4532,4.5,"20"
"9435",42,8,63,1809335,1813196,3861,3.9,"0"
"9528",42,7,6,1815352,1819650,4298,4.3,"20"
"9733",42,6,61,1824746,1828936,4190,4.2,"0"
"9826",42,2,25,1830889,1833980,3091,3.1,"0"
"10023",42,3,18,1840535,1845186,4651,4.7,"20"
"10231",42,4,75,1850493,1853759,3266,3.3,"0"
"10327",42,7,46,1855812,1860072,4260,4.3,"20"
"10429",42,3,34,1862141,1865633,3492,3.5,"20"
"10530",42,1,72,1867667,1870660,2993,3,"20"
"10631",42,4,27,1872381,1875401,3020,3,"0"
"10831",42,1,80,1883375,1887419,4044,4,"20"
"10926",42,1,24,1889786,1893734,3948,3.9,"20"
"11132",42,5,44,1899408,1903031,3623,3.6,"20"
"11230",42,8,55,1905989,1910510,4521,4.5,"0"
"11332",42,3,74,1912415,1917799,5384,5.4,"20"
"11427",42,2,41,1920102,1923585,3483,3.5,"0"
"11528",42,3,42,1925747,1929359,3612,3.6,"20"
"11628",42,8,71,1931452,1937111,5659,5.7,"0"
"11726",42,5,60,1940926,1944314,3388,3.4,"20"
"11828",42,8,31,1946338,1950269,3931,3.9,"0"
"12019",42,3,58,1955195,1959144,3949,3.9,"20"
"12126",42,2,57,1961645,1964835,3190,3.2,"0"
"10147",43,4,58,6108239,6111192,2953,3,"0"
"11106",43,2,48,6113223,6116786,3563,3.6,"0"
"1239",43,2,64,6119631,6122993,3362,3.4,"0"
"1331",43,5,75,6125062,6127451,2389,2.4,"20"
"1433",43,5,35,6129188,6131790,2602,2.6,"20"
"1530",43,5,3,6133831,6136747,2916,2.9,"20"
"1726",43,8,30,6141352,6144132,2780,2.8,"0"
"1926",43,3,49,6149387,6151822,2435,2.4,"20"
"2030",43,1,23,6154363,6156691,2328,2.3,"20"
"2222",43,1,7,6162852,6165994,3142,3.1,"20"
"2426",43,7,29,6170694,6175427,4733,4.7,"20"
"2626",43,7,5,6180897,6184184,3287,3.3,"20"
"2828",43,4,26,6190171,6193438,3267,3.3,"0"
"3029",43,1,47,6199309,6201753,2444,2.4,"20"
"3131",43,6,68,6205091,6207944,2853,2.9,"0"
"3229",43,4,10,6211359,6214049,2690,2.7,"0"
"3430",43,1,15,6219765,6222199,2434,2.4,"20"
"3636",43,4,66,6226596,6229370,2774,2.8,"0"
"3722",43,6,76,6231682,6235167,3485,3.5,"0"
"3832",43,6,12,6237223,6240231,3008,3,"0"
"4028",43,6,4,6245267,6248304,3037,3,"0"
"4235",43,2,8,6252763,6255593,2830,2.8,"0"
"4432",43,7,37,6262941,6267066,4125,4.1,"20"
"4528",43,6,36,6269035,6271814,2779,2.8,"0"
"4628",43,5,19,6273789,6276146,2357,2.4,"20"
"4828",43,7,45,6282645,6285114,2469,2.5,"20"
"4933",43,6,28,6287101,6290129,3028,3,"0"
"5131",43,7,53,6297170,6300321,3151,3.2,"20"
"5228",43,3,9,6302783,6306049,3266,3.3,"20"
"5429",43,4,74,6310652,6313288,2636,2.6,"0"
"5527",43,6,20,6315415,6317854,2439,2.4,"0"
"5735",43,4,50,6323429,6326098,2669,2.7,"0"
"5829",43,7,13,6328830,6331953,3123,3.1,"20"
"6033",43,8,22,6335984,6339262,3278,3.3,"0"
"6235",43,3,73,6343374,6346691,3317,3.3,"20"
"6325",43,1,31,6348796,6352177,3381,3.4,"20"
"6527",43,1,79,6356522,6359626,3104,3.1,"20"
"6632",43,6,60,6361673,6364006,2333,2.3,"0"
"6726",43,6,52,6365978,6368559,2581,2.6,"0"
"6834",43,3,33,6370640,6373279,2639,2.6,"20"
"6928",43,5,67,6375226,6379353,4127,4.1,"20"
"7029",43,8,78,6381570,6384780,3210,3.2,"0"
"7140",43,4,34,6387857,6390792,2935,2.9,"0"
"7228",43,1,55,6392928,6395774,2846,2.8,"20"
"7333",43,3,41,6397765,6400162,2397,2.4,"20"
"7431",43,4,18,6402231,6404912,2681,2.7,"0"
"7632",43,6,44,6412115,6415155,3040,3,"0"
"7731",43,3,57,6417688,6420965,3277,3.3,"20"
"7830",43,4,42,6423410,6426420,3010,3,"0"
"7934",43,3,65,6428619,6431577,2958,3,"20"
"8030",43,5,11,6433517,6435818,2301,2.3,"20"
"8227",43,8,70,6440802,6445115,4313,4.3,"0"
"8327",43,1,63,6447937,6450785,2848,2.8,"20"
"8427",43,2,40,6454370,6457452,3082,3.1,"0"
"8534",43,8,62,6460327,6463385,3058,3.1,"0"
"8629",43,5,51,6465213,6467532,2319,2.3,"20"
"8729",43,5,59,6469457,6472117,2660,2.7,"20"
"8834",43,8,46,6476338,6479319,2981,3,"0"
"8926",43,3,25,6481040,6484696,3656,3.7,"20"
"9131",43,7,77,6489427,6491965,2538,2.5,"20"
"9233",43,2,24,6494954,6497517,2563,2.6,"0"
"9436",43,8,38,6503118,6505855,2737,2.7,"0"
"9529",43,5,27,6507834,6510485,2651,2.7,"20"
"9734",43,7,61,6514930,6518110,3180,3.2,"20"
"9827",43,2,32,6520287,6523641,3354,3.4,"0"
"10024",43,2,56,6527983,6529858,1875,1.9,"0"
"10148",43,1,71,6532044,6534471,2427,2.4,"20"
"10232",43,8,54,6537457,6540338,2881,2.9,"0"
"10328",43,2,72,6542597,6545673,3076,3.1,"0"
"10430",43,1,39,6548366,6551500,3134,3.1,"20"
"10531",43,3,17,6553551,6555950,2399,2.4,"20"
"10725",43,5,43,6560353,6563988,3635,3.6,"20"
"10832",43,3,1,6565991,6568377,2386,2.4,"20"
"11030",43,2,80,6573476,6577908,4432,4.4,"0"
"11133",43,4,2,6579904,6582650,2746,2.7,"0"
"11333",43,7,69,6587149,6589599,2450,2.5,"20"
"11428",43,7,21,6591447,6594036,2589,2.6,"20"
"11629",43,8,6,6598474,6601495,3021,3,"0"
"11829",43,2,16,6606838,6610144,3306,3.3,"0"
"12020",43,8,14,6616464,6624005,7541,7.5,"0"
"10149",44,6,27,7678981,7684506,5525,5.5,"0"
"1240",44,7,28,7689679,7695770,6091,6.1,"20"
"1434",44,1,78,7701573,7708423,6850,6.8,"20"
"1531",44,1,70,7711378,7717815,6437,6.4,"20"
"1633",44,8,53,7719907,7725419,5512,5.5,"0"
"1727",44,2,55,7727544,7732525,4981,5,"0"
"1830",44,3,56,7735427,7738569,3142,3.1,"20"
"1927",44,8,37,7740795,7744777,3982,4,"0"
"2031",44,6,75,7748595,7751377,2782,2.8,"0"
"2131",44,5,26,7754943,7760237,5294,5.3,"20"
"2331",44,5,10,7767805,7771280,3475,3.5,"20"
"2532",44,5,18,7778769,7782790,4021,4,"20"
"2733",44,7,36,7789228,7793058,3830,3.8,"20"
"2829",44,7,60,7795289,7797950,2661,2.7,"20"
"2930",44,5,50,7801214,7804727,3513,3.5,"20"
"3030",44,8,69,7807118,7809952,2834,2.8,"0"
"3132",44,6,59,7812294,7815578,3284,3.3,"0"
"3230",44,3,64,7818433,7821138,2705,2.7,"20"
"3328",44,2,79,7825519,7830309,4790,4.8,"0"
"3431",44,8,13,7832957,7836394,3437,3.4,"0"
"3637",44,8,77,7844122,7847211,3089,3.1,"0"
"3723",44,6,43,7851008,7855000,3992,4,"0"
"3833",44,6,11,7857591,7859737,2146,2.1,"0"
"4029",44,5,42,7867006,7871924,4918,4.9,"20"
"4131",44,3,16,7874685,7877848,3163,3.2,"20"
"4324",44,2,63,7883858,7888268,4410,4.4,"0"
"4433",44,2,39,7890279,7893694,3415,3.4,"0"
"4529",44,5,2,7896604,7899275,2671,2.7,"20"
"4734",44,4,57,7908684,7913263,4579,4.6,"0"
"4829",44,7,4,7917377,7920496,3119,3.1,"20"
"5030",44,4,9,7926920,7930531,3611,3.6,"0"
"5229",44,1,38,7936884,7939648,2764,2.8,"20"
"5333",44,1,46,7943291,7946905,3614,3.6,"20"
"5430",44,4,65,7949029,7953903,4874,4.9,"0"
"5528",44,3,80,7955976,7958669,2693,2.7,"20"
"5631",44,5,74,7960645,7965298,4653,4.7,"20"
"5736",44,2,7,7967379,7970232,2853,2.9,"0"
"5929",44,3,24,7976353,7983095,6742,6.7,"20"
"6127",44,1,54,7990628,7998268,7640,7.6,"20"
"6236",44,8,45,8000770,8002869,2099,2.1,"0"
"6326",44,6,35,8005587,8008299,2712,2.7,"0"
"6432",44,4,73,8011762,8015904,4142,4.1,"0"
"6528",44,6,3,8017861,8020694,2833,2.8,"0"
"6727",44,8,5,8026919,8029705,2786,2.8,"0"
"6929",44,2,15,8036192,8040239,4047,4,"0"
"7141",44,3,8,8045704,8050017,4313,4.3,"20"
"7334",44,5,66,8055547,8058601,3054,3.1,"20"
"7432",44,7,44,8061672,8064649,2977,3,"20"
"7535",44,1,14,8066767,8073213,6446,6.4,"20"
"7732",44,8,29,8080617,8083813,3196,3.2,"0"
"7935",44,3,32,8090212,8094238,4026,4,"20"
"8136",44,2,71,8098872,8101991,3119,3.1,"0"
"8228",44,3,40,8104443,8106976,2533,2.5,"20"
"8328",44,8,61,8108923,8111800,2877,2.9,"0"
"8428",44,2,47,8113768,8116283,2515,2.5,"0"
"8535",44,7,68,8118318,8122937,4619,4.6,"20"
"8630",44,4,41,8125705,8128169,2464,2.5,"0"
"8730",44,3,72,8132645,8136070,3425,3.4,"20"
"8835",44,4,25,8138267,8141987,3720,3.7,"0"
"9037",44,5,58,8149388,8152690,3302,3.3,"20"
"9132",44,4,17,8154862,8158676,3814,3.8,"0"
"9329",44,5,34,8168343,8174340,5997,6,"20"
"9437",44,2,23,8177952,8182090,4138,4.1,"0"
"9633",44,7,12,8188742,8194661,5919,5.9,"20"
"9828",44,3,48,8201103,8203667,2564,2.6,"20"
"9934",44,7,20,8205942,8207773,1831,1.8,"20"
"10150",44,1,22,8212545,8215694,3149,3.1,"20"
"10329",44,1,30,8223900,8226515,2615,2.6,"20"
"10532",44,6,51,8231099,8235050,3951,4,"0"
"10632",44,6,19,8237098,8239403,2305,2.3,"0"
"10833",44,1,62,8246052,8249852,3800,3.8,"20"
"10927",44,8,21,8252288,8254612,2324,2.3,"0"
"11134",44,6,67,8261538,8264348,2810,2.8,"0"
"11231",44,2,31,8266508,8269918,3410,3.4,"0"
"11429",44,7,76,8276084,8283111,7027,7,"20"
"11529",44,7,52,8285429,8288427,2998,3,"20"
"11630",44,4,49,8290417,8292955,2538,2.5,"0"
"11727",44,1,6,8295810,8299654,3844,3.8,"20"
"11922",44,4,1,8306799,8314771,7972,8,"0"
"12127",44,4,33,8321701,8323528,1827,1.8,"0"
"10151",45,7,11,12300939,12304263,3324,3.3,"20"
"1241",45,3,55,12310758,12315866,5108,5.1,"20"
"1332",45,6,2,12319881,12326544,6663,6.7,"0"
"1532",45,5,25,12335677,12340258,4581,4.6,"20"
"1728",45,1,29,12345335,12350055,4720,4.7,"20"
"1928",45,1,5,12355395,12359053,3658,3.7,"20"
"2132",45,2,38,12365126,12368333,3207,3.2,"0"
"2223",45,2,62,12372023,12376361,4338,4.3,"0"
"2332",45,4,32,12382284,12385339,3055,3.1,"0"
"2533",45,1,77,12391011,12394816,3805,3.8,"20"
"2627",45,3,47,12398212,12400839,2627,2.6,"20"
"2734",45,4,72,12403873,12407518,3645,3.6,"0"
"2830",45,5,17,12412695,12416963,4268,4.3,"20"
"3031",45,1,37,12421354,12424432,3078,3.1,"20"
"3133",45,6,74,12427749,12431021,3272,3.3,"0"
"3231",45,8,60,12433389,12437930,4541,4.5,"0"
"3329",45,2,22,12440491,12444890,4399,4.4,"0"
"3527",45,1,13,12451005,12453844,2839,2.8,"20"
"3724",45,5,1,12459204,12461953,2749,2.7,"20"
"3926",45,2,46,12467495,12471254,3759,3.8,"0"
"4030",45,3,23,12474483,12476446,1963,2,"20"
"4236",45,7,51,12481552,12484353,2801,2.8,"20"
"4325",45,7,35,12488698,12492032,3334,3.3,"20"
"4434",45,1,45,12495361,12497572,2211,2.2,"20"
"4530",45,8,44,12500728,12504283,3555,3.6,"0"
"4629",45,1,61,12507367,12510089,2722,2.7,"20"
"4735",45,4,40,12513070,12517096,4026,4,"0"
"4830",45,3,7,12521031,12523874,2843,2.8,"20"
"5031",45,2,30,12531055,12533495,2440,2.4,"0"
"5230",45,3,31,12537810,12541030,3220,3.2,"20"
"5431",45,6,34,12545401,12548675,3274,3.3,"0"
"5529",45,4,16,12552006,12555280,3274,3.3,"0"
"5737",45,3,63,12560581,12563995,3414,3.4,"20"
"5830",45,7,75,12566751,12571482,4731,4.7,"20"
"5930",45,6,42,12574185,12577133,2948,2.9,"0"
"6034",45,5,65,12580462,12585950,5488,5.5,"20"
"6128",45,4,24,12589190,12592280,3090,3.1,"0"
"6327",45,7,43,12597319,12601303,3984,4,"20"
"6433",45,7,27,12603482,12607982,4500,4.5,"20"
"6633",45,4,48,12612389,12615435,3046,3,"0"
"6728",45,8,4,12619520,12621675,2155,2.2,"0"
"6930",45,3,39,12627119,12629932,2813,2.8,"20"
"7030",45,6,50,12633209,12638623,5414,5.4,"0"
"7142",45,2,78,12642965,12646100,3135,3.1,"0"
"7229",45,8,52,12648733,12651468,2735,2.7,"0"
"7335",45,3,15,12655125,12658061,2936,2.9,"20"
"7536",45,1,69,12665747,12668283,2536,2.5,"20"
"7633",45,5,57,12671092,12673803,2711,2.7,"20"
"7733",45,2,70,12676493,12679109,2616,2.6,"0"
"7831",45,4,80,12683127,12684949,1822,1.8,"0"
"7936",45,6,66,12687145,12690079,2934,2.9,"0"
"8031",45,3,71,12692247,12694533,2286,2.3,"20"
"8137",45,8,68,12697328,12699441,2113,2.1,"0"
"8229",45,4,64,12701986,12704039,2053,2.1,"0"
"8329",45,1,21,12706653,12708951,2298,2.3,"20"
"8536",45,8,20,12715053,12718261,3208,3.2,"0"
"8731",45,8,12,12724955,12727742,2787,2.8,"0"
"8927",45,7,3,12732303,12734582,2279,2.3,"20"
"9133",45,2,54,12740408,12742952,2544,2.5,"0"
"9234",45,3,79,12745363,12747620,2257,2.3,"20"
"9330",45,5,41,12750442,12752562,2120,2.1,"20"
"9438",45,8,76,12756372,12758782,2410,2.4,"0"
"9530",45,5,73,12761646,12765465,3819,3.8,"20"
"9634",45,5,9,12769074,12771001,1927,1.9,"20"
"9829",45,7,19,12776085,12778044,1959,2,"20"
"10025",45,2,14,12786357,12790569,4212,4.2,"0"
"10233",45,8,36,12796032,12799143,3111,3.1,"0"
"10330",45,2,6,12803983,12806478,2495,2.5,"0"
"10533",45,4,8,12812509,12815497,2988,3,"0"
"10726",45,6,10,12825360,12828230,2870,2.9,"0"
"10928",45,8,28,12833381,12836128,2747,2.7,"0"
"11135",45,6,18,12842002,12845854,3852,3.9,"0"
"11334",45,7,67,12850073,12854119,4046,4,"20"
"11430",45,1,53,12857714,12860388,2674,2.7,"20"
"11530",45,6,26,12867198,12869966,2768,2.8,"0"
"11728",45,4,56,12879750,12881903,2153,2.2,"0"
"11830",45,6,58,12884932,12887743,2811,2.8,"0"
"11923",45,5,33,12890354,12892382,2028,2,"20"
"12021",45,5,49,12895161,12896893,1732,1.7,"20"
"12128",45,7,59,12900994,12904174,3180,3.2,"20"
"10152",46,5,80,309622,312876,3254,3.3,"20"
"11107",46,3,38,315035,318071,3036,3,"20"
"1242",46,1,76,320861,326569,5708,5.7,"20"
"1333",46,1,28,328841,331507,2666,2.7,"20"
"1533",46,1,36,336976,339439,2463,2.5,"20"
"1634",46,6,25,341445,343602,2157,2.2,"0"
"1831",46,7,42,348340,352768,4428,4.4,"20"
"1929",46,5,56,355080,357272,2192,2.2,"20"
"2032",46,5,40,359618,362069,2451,2.5,"20"
"2133",46,6,57,364906,367962,3056,3.1,"0"
"2224",46,1,20,370257,373485,3228,3.2,"20"
"2427",46,7,74,379596,383045,3449,3.4,"20"
"2534",46,1,68,385273,387204,1931,1.9,"20"
"2628",46,8,75,389504,391989,2485,2.5,"0"
"2735",46,5,8,394604,397812,3208,3.2,"20"
"2931",46,7,18,402733,405204,2471,2.5,"20"
"3134",46,6,41,409907,413006,3099,3.1,"0"
"3232",46,3,62,414969,418770,3801,3.8,"20"
"3330",46,8,3,420939,423422,2483,2.5,"0"
"3528",46,8,11,429226,432604,3378,3.4,"0"
"3725",46,8,19,437533,440246,2713,2.7,"0"
"3927",46,7,26,445741,448351,2610,2.6,"20"
"4132",46,4,79,453609,456677,3068,3.1,"0"
"4237",46,2,13,458763,461918,3155,3.2,"0"
"4435",46,2,21,467412,469776,2364,2.4,"0"
"4630",46,3,46,474747,477214,2467,2.5,"20"
"4736",46,3,22,479169,481967,2798,2.8,"20"
"4934",46,4,63,488090,490579,2489,2.5,"0"
"5032",46,6,73,493421,496087,2666,2.7,"0"
"5132",46,2,45,498375,500901,2526,2.5,"0"
"5231",46,1,44,504394,506535,2141,2.1,"20"
"5334",46,4,7,508637,511411,2774,2.8,"0"
"5530",46,6,65,516790,520073,3283,3.3,"0"
"5632",46,2,61,522104,524509,2405,2.4,"0"
"5738",46,5,24,527624,530842,3218,3.2,"20"
"5931",46,8,59,536168,539818,3650,3.6,"0"
"6035",46,3,70,542014,544723,2709,2.7,"20"
"6129",46,8,43,546760,548612,1852,1.9,"0"
"6237",46,1,60,550597,554119,3522,3.5,"20"
"6328",46,4,31,557003,559422,2419,2.4,"0"
"6529",46,8,51,564651,566826,2175,2.2,"0"
"6634",46,6,33,569059,571520,2461,2.5,"0"
"6729",46,2,77,573608,576446,2838,2.8,"0"
"6835",46,2,5,578486,580647,2161,2.2,"0"
"7031",46,7,66,585417,588489,3072,3.1,"20"
"7143",46,3,30,590386,592414,2028,2,"20"
"7336",46,4,23,596839,599064,2225,2.2,"0"
"7537",46,1,12,604815,607403,2588,2.6,"20"
"7734",46,3,54,612644,614897,2253,2.3,"20"
"7832",46,1,52,616783,619041,2258,2.3,"20"
"7937",46,3,6,623816,627384,3568,3.6,"20"
"8138",46,5,48,633992,635831,1839,1.8,"20"
"8230",46,7,2,638239,640028,1789,1.8,"20"
"8429",46,3,78,647999,651718,3719,3.7,"20"
"8537",46,6,1,655386,658717,3331,3.3,"0"
"8732",46,7,10,663744,666300,2556,2.6,"20"
"8928",46,6,49,671238,674520,3282,3.3,"0"
"9038",46,8,35,676991,679539,2548,2.5,"0"
"9134",46,4,55,682900,686116,3216,3.2,"0"
"9235",46,5,72,688451,692262,3811,3.8,"20"
"9331",46,2,29,695146,697737,2591,2.6,"0"
"9531",46,5,64,702350,704268,1918,1.9,"20"
"9635",46,4,39,706685,709423,2738,2.7,"0"
"9735",46,5,32,712092,714246,2154,2.2,"20"
"9935",46,6,17,719047,721155,2108,2.1,"0"
"10153",46,8,67,728583,731951,3368,3.4,"0"
"10234",46,8,27,734512,737663,3151,3.2,"0"
"10431",46,4,15,742560,744308,1748,1.7,"0"
"10633",46,2,69,750527,752665,2138,2.1,"0"
"10727",46,5,16,754737,756888,2151,2.2,"20"
"10929",46,2,53,761787,763875,2088,2.1,"0"
"11031",46,6,9,766331,769218,2887,2.9,"0"
"11232",46,4,47,774309,776041,1732,1.7,"0"
"11335",46,7,34,779487,781604,2117,2.1,"20"
"11431",46,4,71,784916,786746,1830,1.8,"0"
"11531",46,7,58,791453,794036,2583,2.6,"20"
"11631",46,1,4,798796,801420,2624,2.6,"20"
"11831",46,3,14,807267,809886,2619,2.6,"20"
"12022",46,7,50,816355,819682,3327,3.3,"20"
"12129",46,2,37,823092,825944,2852,2.9,"0"
"10154",47,1,43,9397380,9400658,3278,3.3,"20"
"11108",47,8,74,9402810,9406424,3614,3.6,"0"
"1243",47,2,4,9408200,9411442,3242,3.2,"0"
"1435",47,3,61,9415913,9420385,4472,4.5,"20"
"1534",47,8,26,9422269,9425980,3711,3.7,"0"
"1729",47,4,62,9433475,9438642,5167,5.2,"0"
"1832",47,7,25,9440956,9443530,2574,2.6,"20"
"2033",47,2,20,9448427,9451402,2975,3,"0"
"2225",47,3,77,9456240,9458858,2618,2.6,"20"
"2333",47,3,29,9460895,9464120,3225,3.2,"20"
"2535",47,4,6,9468855,9473159,4304,4.3,"0"
"2736",47,3,53,9479666,9482629,2963,3,"20"
"2831",47,5,79,9484760,9488959,4199,4.2,"20"
"2932",47,8,10,9492358,9495548,3190,3.2,"0"
"3135",47,8,2,9500539,9503936,3397,3.4,"0"
"3331",47,6,72,9509698,9515318,5620,5.6,"0"
"3432",47,3,45,9517484,9520255,2771,2.8,"20"
"3529",47,5,7,9523452,9526381,2929,2.9,"20"
"3726",47,4,22,9532427,9536965,4538,4.5,"0"
"3928",47,2,76,9543989,9547315,3326,3.3,"0"
"4031",47,3,37,9549232,9553421,4189,4.2,"20"
"4133",47,5,31,9555616,9559645,4029,4,"20"
"4326",47,6,32,9569484,9573622,4138,4.1,"0"
"4531",47,2,60,9578196,9580731,2535,2.5,"0"
"4631",47,5,47,9582674,9584832,2158,2.2,"20"
"4737",47,8,66,9586990,9590133,3143,3.1,"0"
"4831",47,7,73,9592593,9596652,4059,4.1,"20"
"4935",47,4,54,9599410,9602353,2943,2.9,"0"
"5033",47,5,39,9604796,9607351,2555,2.6,"20"
"5133",47,3,13,9609551,9612309,2758,2.8,"20"
"5335",47,1,11,9616674,9620976,4302,4.3,"20"
"5531",47,3,69,9627239,9631846,4607,4.6,"20"
"5633",47,4,78,9633544,9636337,2793,2.8,"0"
"5739",47,7,41,9639466,9642262,2796,2.8,"20"
"5831",47,6,8,9644437,9647602,3165,3.2,"0"
"6036",47,7,57,9654527,9657316,2789,2.8,"20"
"6130",47,2,68,9659218,9662475,3257,3.3,"0"
"6238",47,5,55,9664183,9666658,2475,2.5,"20"
"6329",47,6,24,9668562,9671879,3317,3.3,"0"
"6530",47,8,58,9678503,9682292,3789,3.8,"0"
"6635",47,7,9,9684645,9688450,3805,3.8,"20"
"6836",47,6,40,9693293,9695715,2422,2.4,"0"
"6931",47,6,48,9697548,9701926,4378,4.4,"0"
"7032",47,5,63,9703623,9706896,3273,3.3,"20"
"7144",47,6,56,9708761,9711797,3036,3,"0"
"7230",47,4,70,9714264,9718386,4122,4.1,"0"
"7337",47,1,35,9721242,9723528,2286,2.3,"20"
"7433",47,7,1,9726958,9729563,2605,2.6,"20"
"7634",47,7,17,9736248,9739443,3195,3.2,"20"
"7833",47,2,44,9743617,9746622,3005,3,"0"
"7938",47,1,75,9748323,9750465,2142,2.1,"20"
"8032",47,8,42,9752352,9755465,3113,3.1,"0"
"8139",47,8,18,9758674,9762881,4207,4.2,"0"
"8330",47,7,33,9768184,9770223,2039,2,"20"
"8430",47,3,21,9773888,9776526,2638,2.6,"20"
"8631",47,2,52,9781613,9783877,2264,2.3,"0"
"8733",47,2,36,9785739,9788584,2845,2.8,"0"
"8836",47,1,3,9791497,9795165,3668,3.7,"20"
"9039",47,1,51,9799653,9802401,2748,2.7,"20"
"9135",47,1,27,9804375,9806864,2489,2.5,"20"
"9332",47,1,59,9812771,9816222,3451,3.5,"20"
"9439",47,8,50,9818941,9820684,1743,1.7,"0"
"9532",47,8,34,9823751,9826397,2646,2.6,"0"
"9636",47,2,12,9828214,9830675,2461,2.5,"0"
"9830",47,1,67,9838363,9842652,4289,4.3,"20"
"9936",47,5,15,9845029,9847417,2388,2.4,"20"
"10155",47,4,14,9853195,9856756,3561,3.6,"0"
"10331",47,5,23,9861575,9863458,1883,1.9,"20"
"10534",47,7,49,9868573,9870925,2352,2.4,"20"
"10634",47,6,64,9872678,9874326,1648,1.6,"0"
"10728",47,7,65,9876027,9878252,2225,2.2,"20"
"10834",47,2,28,9881430,9883824,2394,2.4,"0"
"11032",47,6,16,9890260,9893429,3169,3.2,"0"
"11233",47,4,30,9898534,9900653,2119,2.1,"0"
"11432",47,3,5,9904918,9907832,2914,2.9,"20"
"11632",47,4,38,9912851,9915519,2668,2.7,"0"
"11729",47,4,46,9917292,9919837,2545,2.5,"0"
"11832",47,1,19,9923111,9925073,1962,2,"20"
"12023",47,5,71,9930915,9934196,3281,3.3,"20"
"12130",47,6,80,9936284,9938489,2205,2.2,"0"
"10156",48,5,6,591180,596653,5473,5.5,"20"
"1244",48,2,59,601431,605567,4136,4.1,"0"
"1334",48,5,70,607608,612512,4904,4.9,"20"
"1436",48,6,39,615135,619730,4595,4.6,"0"
"1535",48,8,25,622298,628286,5988,6,"0"
"1730",48,6,55,633357,639072,5715,5.7,"0"
"1833",48,3,12,641915,648563,6648,6.6,"20"
"2034",48,3,68,655119,659099,3980,4,"20"
"2134",48,7,8,661527,666070,4543,4.5,"20"
"2334",48,1,66,673338,677975,4637,4.6,"20"
"2428",48,4,21,680265,683225,2960,3,"0"
"2629",48,8,17,690468,695797,5329,5.3,"0"
"2832",48,5,38,701044,706320,5276,5.3,"20"
"2933",48,6,7,710553,716835,6282,6.3,"0"
"3136",48,2,3,725497,728785,3288,3.3,"0"
"3332",48,7,72,733380,738519,5139,5.1,"20"
"3433",48,7,40,742904,747284,4380,4.4,"20"
"3530",48,1,50,751877,754734,2857,2.9,"20"
"3638",48,5,46,760375,767481,7106,7.1,"20"
"3727",48,8,65,772371,776702,4331,4.3,"0"
"3834",48,1,26,779326,783209,3883,3.9,"20"
"4032",48,3,36,788150,791041,2891,2.9,"20"
"4134",48,5,78,793766,797993,4227,4.2,"20"
"4238",48,6,31,800565,804400,3835,3.8,"0"
"4436",48,1,18,809366,813662,4296,4.3,"20"
"4632",48,6,47,819383,822915,3532,3.5,"0"
"4738",48,7,56,825782,829005,3223,3.2,"20"
"4832",48,2,19,831208,834681,3473,3.5,"0"
"5034",48,4,77,844713,848508,3795,3.8,"0"
"5134",48,3,76,850708,854868,4160,4.2,"20"
"5232",48,8,73,857635,862602,4967,5,"0"
"5336",48,2,43,864572,867573,3001,3,"0"
"5432",48,4,5,869785,872814,3029,3,"0"
"5634",48,3,20,878466,882273,3807,3.8,"20"
"5832",48,5,22,888767,893190,4423,4.4,"20"
"6037",48,3,28,898347,901252,2905,2.9,"20"
"6239",48,2,27,907425,911390,3965,4,"0"
"6434",48,6,23,917808,921731,3923,3.9,"0"
"6636",48,5,30,926400,929804,3404,3.4,"20"
"6837",48,1,2,934271,937118,2847,2.8,"20"
"7033",48,3,4,942718,947400,4682,4.7,"20"
"7231",48,3,60,951844,955081,3237,3.2,"20"
"7338",48,2,75,957855,960437,2582,2.6,"0"
"7434",48,5,62,962122,966786,4664,4.7,"20"
"7538",48,1,74,970249,973317,3068,3.1,"20"
"7635",48,2,11,975582,979083,3501,3.5,"0"
"7834",48,2,67,983232,990567,7335,7.3,"0"
"7939",48,4,37,993938,996600,2662,2.7,"0"
"8033",48,3,52,998588,1001553,2965,3,"20"
"8140",48,8,41,1003899,1006534,2635,2.6,"0"
"8231",48,6,79,1008596,1012316,3720,3.7,"0"
"8331",48,1,10,1014242,1018677,4435,4.4,"20"
"8538",48,7,80,1023876,1026750,2874,2.9,"20"
"8632",48,8,49,1028671,1031099,2428,2.4,"0"
"8734",48,6,63,1032918,1036757,3839,3.8,"0"
"8837",48,7,24,1038555,1042125,3570,3.6,"20"
"9040",48,3,44,1046669,1050002,3333,3.3,"20"
"9136",48,1,58,1051948,1056466,4518,4.5,"20"
"9236",48,5,54,1058471,1062296,3825,3.8,"20"
"9333",48,7,32,1065735,1069416,3681,3.7,"20"
"9533",48,4,53,1073951,1079075,5124,5.1,"0"
"9637",48,8,9,1080803,1085222,4419,4.4,"0"
"9831",48,4,45,1090632,1093878,3246,3.2,"0"
"9937",48,1,42,1096916,1100094,3178,3.2,"20"
"10026",48,8,33,1102028,1104729,2701,2.7,"0"
"10157",48,4,61,1106737,1110894,4157,4.2,"0"
"10235",48,7,48,1114186,1119322,5136,5.1,"20"
"10332",48,2,35,1122107,1125806,3699,3.7,"0"
"10432",48,4,29,1127874,1131568,3694,3.7,"0"
"10635",48,7,16,1136507,1139117,2610,2.6,"20"
"10835",48,4,13,1144650,1147806,3156,3.2,"0"
"11033",48,2,51,1152089,1155297,3208,3.2,"0"
"11136",48,8,1,1157134,1160944,3810,3.8,"0"
"11336",48,5,14,1166497,1169833,3336,3.3,"20"
"11532",48,7,64,1182289,1186022,3733,3.7,"20"
"11633",48,6,71,1187918,1190945,3027,3,"0"
"11730",48,8,57,1192726,1196197,3471,3.5,"0"
"11833",48,4,69,1198143,1200727,2584,2.6,"0"
"11924",48,1,34,1202611,1206389,3778,3.8,"20"
"12024",48,6,15,1208265,1210144,1879,1.9,"0"
"10158",49,2,50,1795369,1800835,5466,5.5,"0"
"11109",49,2,10,1803904,1808549,4645,4.6,"0"
"1335",49,1,41,1814719,1818617,3898,3.9,"20"
"1437",49,3,67,1822092,1829675,7583,7.6,"20"
"1536",49,5,5,1832729,1837083,4354,4.4,"20"
"1731",49,7,55,1843866,1849321,5455,5.5,"20"
"1834",49,3,19,1851585,1855157,3572,3.6,"20"
"2035",49,8,48,1862810,1867930,5120,5.1,"0"
"2135",49,1,17,1870432,1875606,5174,5.2,"20"
"2335",49,5,53,1880446,1884898,4452,4.5,"20"
"2429",49,7,23,1887001,1890528,3527,3.5,"20"
"2630",49,8,56,1895021,1898826,3805,3.8,"0"
"2737",49,8,40,1900839,1905699,4860,4.9,"0"
"2833",49,8,64,1908679,1911822,3143,3.1,"0"
"2934",49,2,26,1914533,1919027,4494,4.5,"0"
"3137",49,5,61,1924288,1928198,3910,3.9,"20"
"3233",49,7,15,1930220,1933829,3609,3.6,"20"
"3434",49,4,4,1939075,1943214,4139,4.1,"0"
"3639",49,1,1,1948068,1951329,3261,3.3,"20"
"3835",49,4,20,1956847,1960033,3186,3.2,"0"
"4033",49,7,31,1965077,1971655,6578,6.6,"20"
"4239",49,2,74,1977566,1981483,3917,3.9,"0"
"4327",49,7,47,1983751,1986943,3192,3.2,"20"
"4437",49,1,57,1989323,1993438,4115,4.1,"20"
"4532",49,3,59,1995930,2000319,4389,4.4,"20"
"4633",49,4,28,2002504,2006113,3609,3.6,"0"
"4833",49,8,24,2011381,2017497,6116,6.1,"0"
"5035",49,2,42,2025380,2030638,5258,5.3,"0"
"5135",49,6,38,2033235,2037400,4165,4.2,"0"
"5233",49,7,7,2040356,2043323,2967,3,"20"
"5433",49,3,75,2051369,2057011,5642,5.6,"20"
"5532",49,3,27,2059851,2063703,3852,3.9,"20"
"5740",49,1,49,2070330,2075452,5122,5.1,"20"
"5833",49,6,14,2077917,2081141,3224,3.2,"0"
"6038",49,5,37,2086712,2090198,3486,3.5,"20"
"6131",49,3,3,2092158,2096030,3872,3.9,"20"
"6330",49,1,33,2101473,2103932,2459,2.5,"20"
"6435",49,4,76,2105911,2110444,4533,4.5,"0"
"6531",49,2,58,2112404,2115665,3261,3.3,"0"
"6637",49,2,2,2117544,2120501,2957,3,"0"
"6838",49,6,70,2125656,2130005,4349,4.3,"0"
"6932",49,3,35,2131917,2135214,3297,3.3,"20"
"7034",49,8,80,2137055,2139924,2869,2.9,"0"
"7145",49,8,72,2144224,2148688,4464,4.5,"0"
"7232",49,3,43,2151971,2155316,3345,3.3,"20"
"7339",49,2,34,2157577,2161791,4214,4.2,"0"
"7435",49,7,79,2163816,2167731,3915,3.9,"20"
"7539",49,1,73,2173255,2179193,5938,5.9,"20"
"7636",49,4,12,2182209,2186533,4324,4.3,"0"
"7835",49,8,8,2192489,2195307,2818,2.8,"0"
"8034",49,5,69,2201132,2204357,3225,3.2,"20"
"8141",49,2,66,2208962,2212529,3567,3.6,"0"
"8232",49,1,9,2214514,2217686,3172,3.2,"20"
"8431",49,4,60,2225295,2228662,3367,3.4,"0"
"8539",49,6,30,2230528,2233715,3187,3.2,"0"
"8735",49,8,32,2238430,2241641,3211,3.2,"0"
"8929",49,7,71,2246515,2249432,2917,2.9,"20"
"9041",49,6,62,2251692,2254970,3278,3.3,"0"
"9137",49,4,36,2257450,2260781,3331,3.3,"0"
"9237",49,1,65,2262816,2266335,3519,3.5,"20"
"9334",49,2,18,2268247,2274457,6210,6.2,"0"
"9534",49,6,78,2280671,2284651,3980,4,"0"
"9638",49,6,22,2286598,2292577,5979,6,"0"
"9832",49,4,52,2299285,2302819,3534,3.5,"0"
"9938",49,5,77,2304791,2307884,3093,3.1,"20"
"10027",49,5,45,2309846,2312430,2584,2.6,"20"
"10159",49,4,44,2315092,2318069,2977,3,"0"
"10236",49,5,21,2323002,2327007,4005,4,"20"
"10433",49,3,11,2336546,2339176,2630,2.6,"20"
"10636",49,3,51,2346294,2350077,3783,3.8,"20"
"10729",49,6,46,2352014,2356663,4649,4.6,"0"
"10836",49,6,54,2361059,2364464,3405,3.4,"0"
"10930",49,5,13,2366629,2370567,3938,3.9,"20"
"11137",49,1,25,2375333,2378427,3094,3.1,"20"
"11337",49,5,29,2383980,2390010,6030,6,"20"
"11533",49,7,39,2399389,2403904,4515,4.5,"20"
"11634",49,7,63,2407098,2414884,7786,7.8,"20"
"11731",49,4,68,2417485,2421052,3567,3.6,"0"
"11834",49,8,16,2423306,2426778,3472,3.5,"0"
"12025",49,6,6,2438746,2445865,7119,7.1,"0"
"10160",50,8,63,3745782,3750746,4964,5,"0"
"11138",50,6,53,3753360,3760466,7106,7.1,"0"
"1245",50,4,19,3763220,3770241,7021,7,"0"
"1438",50,5,44,3783816,3791393,7577,7.6,"20"
"1537",50,6,13,3822505,3826777,4272,4.3,"0"
"1732",50,1,40,3832815,3837297,4482,4.5,"20"
"1835",50,2,9,3840727,3840859,132,0.1,"0"
"2036",50,4,67,3848686,3854899,6213,6.2,"0"
"2136",50,2,25,3857216,3862658,5442,5.4,"0"
"2336",50,7,46,3867491,3873510,6019,6,"20"
"2430",50,4,3,3875453,3880243,4790,4.8,"0"
"2631",50,1,64,3886032,3890355,4323,4.3,"20"
"2738",50,6,5,3892553,3897117,4564,4.6,"0"
"2935",50,4,27,3905324,3909834,4510,4.5,"0"
"3138",50,2,1,3916336,3922240,5904,5.9,"0"
"3333",50,6,61,3928894,3932966,4072,4.1,"0"
"3435",50,1,24,3935436,3941900,6464,6.5,"20"
"3640",50,8,31,3949600,3956023,6423,6.4,"0"
"3836",50,5,76,3962914,3969672,6758,6.8,"20"
"3929",50,6,29,3971908,3974814,2906,2.9,"0"
"4135",50,3,2,3980439,3986298,5859,5.9,"20"
"4328",50,7,22,3994080,4000147,6067,6.1,"20"
"4533",50,4,35,4005432,4010319,4887,4.9,"0"
"4634",50,7,30,4012032,4015849,3817,3.8,"20"
"4834",50,6,45,4020735,4024365,3630,3.6,"0"
"4936",50,2,73,4026663,4031078,4415,4.4,"0"
"5036",50,3,26,4034446,4038353,3907,3.9,"20"
"5234",50,8,79,4044419,4050313,5894,5.9,"0"
"5337",50,2,57,4052275,4058907,6632,6.6,"0"
"5434",50,7,62,4061905,4066736,4831,4.8,"20"
"5533",50,5,60,4068707,4073042,4335,4.3,"20"
"5635",50,6,37,4075421,4078703,3282,3.3,"0"
"5741",50,8,55,4080694,4084928,4234,4.2,"0"
"5834",50,8,7,4087318,4093441,6123,6.1,"0"
"6039",50,8,39,4102207,4106638,4431,4.4,"0"
"6132",50,3,50,4110945,4115856,4911,4.9,"20"
"6240",50,6,69,4117727,4123192,5465,5.5,"0"
"6331",50,5,68,4127306,4131598,4292,4.3,"20"
"6436",50,1,8,4133919,4137030,3111,3.1,"20"
"6638",50,2,49,4142732,4146316,3584,3.6,"0"
"6730",50,3,58,4148638,4152325,3687,3.7,"20"
"6839",50,1,72,4154186,4159809,5623,5.6,"20"
"6933",50,2,65,4162690,4167662,4972,5,"0"
"7035",50,8,47,4169386,4172069,2683,2.7,"0"
"7146",50,1,32,4174695,4177565,2870,2.9,"20"
"7340",50,7,6,4182344,4186216,3872,3.9,"20"
"7540",50,1,16,4191691,4195349,3658,3.7,"20"
"7735",50,3,66,4201775,4206165,4390,4.4,"20"
"7836",50,1,80,4208663,4211599,2936,2.9,"20"
"7940",50,3,18,4214276,4218707,4431,4.4,"20"
"8142",50,7,38,4226617,4233018,6401,6.4,"20"
"8233",50,8,23,4235369,4238006,2637,2.6,"0"
"8432",50,2,33,4243009,4246139,3130,3.1,"0"
"8540",50,3,10,4248652,4253072,4420,4.4,"20"
"8736",50,4,43,4258308,4261954,3646,3.6,"0"
"8838",50,1,48,4263605,4269565,5960,6,"20"
"8930",50,5,36,4272246,4275886,3640,3.6,"20"
"9042",50,5,20,4278357,4282123,3766,3.8,"20"
"9238",50,4,51,4288511,4291338,2827,2.8,"0"
"9335",50,5,4,4293272,4299296,6024,6,"20"
"9535",50,7,78,4303967,4307416,3449,3.4,"20"
"9639",50,2,17,4309296,4312822,3526,3.5,"0"
"9833",50,4,59,4320619,4326279,5660,5.7,"0"
"9939",50,7,54,4328034,4332364,4330,4.3,"20"
"10028",50,5,12,4335438,4338857,3419,3.4,"20"
"10237",50,3,34,4346195,4351042,4847,4.8,"20"
"10333",50,8,15,4353157,4355863,2706,2.7,"0"
"10535",50,4,75,4362964,4367662,4698,4.7,"0"
"10637",50,8,71,4370582,4374445,3863,3.9,"0"
"10730",50,7,70,4376279,4380532,4253,4.3,"20"
"10837",50,7,14,4383683,4387639,3956,4,"20"
"11034",50,6,21,4393549,4397291,3742,3.7,"0"
"11234",50,5,52,4402363,4406222,3859,3.9,"20"
"11338",50,3,74,4408781,4412449,3668,3.7,"20"
"11433",50,3,42,4414902,4418049,3147,3.1,"20"
"11534",50,2,41,4419895,4424560,4665,4.7,"0"
"11635",50,5,28,4426707,4431102,4395,4.4,"20"
"11835",50,1,56,4436722,4441250,4528,4.5,"20"
"11925",50,4,11,4444250,4447000,2750,2.8,"0"
"12131",50,6,77,4454157,4457592,3435,3.4,"0"
"10161",51,1,7,4915312,4919745,4433,4.4,"20"
"1246",51,3,17,4932408,4936904,4496,4.5,"20"
"1439",51,3,9,4941622,4946774,5152,5.2,"20"
"1635",51,4,74,4952090,4956635,4545,4.5,"0"
"1733",51,1,71,4959286,4964083,4797,4.8,"20"
"1836",51,8,14,4965997,4971353,5356,5.4,"0"
"2037",51,1,23,4976093,4979927,3834,3.8,"20"
"2226",51,3,1,4985180,4990458,5278,5.3,"20"
"2431",51,2,16,4995952,4999719,3767,3.8,"0"
"2632",51,3,33,5004814,5009393,4579,4.6,"20"
"2739",51,5,59,5013075,5019439,6364,6.4,"20"
"2834",51,6,68,5021704,5026865,5161,5.2,"0"
"2936",51,6,12,5029227,5033526,4299,4.3,"0"
"3139",51,3,73,5039057,5044731,5674,5.7,"20"
"3234",51,8,6,5050720,5056240,5520,5.5,"0"
"3436",51,8,70,5062874,5066803,3929,3.9,"0"
"3531",51,8,22,5068735,5075206,6471,6.5,"0"
"3728",51,7,29,5080727,5085989,5262,5.3,"20"
"3930",51,8,62,5090471,5095720,5249,5.2,"0"
"4034",51,2,24,5098974,5103695,4721,4.7,"0"
"4240",51,5,11,5111096,5115052,3956,4,"20"
"4438",51,8,54,5119996,5125779,5783,5.8,"0"
"4534",51,5,19,5127768,5133259,5491,5.5,"20"
"4739",51,4,26,5141244,5144916,3672,3.7,"0"
"4937",51,4,58,5155339,5160410,5071,5.1,"0"
"5037",51,7,37,5162408,5165989,3581,3.6,"20"
"5136",51,4,42,5168190,5172493,4303,4.3,"0"
"5235",51,4,50,5174371,5179169,4798,4.8,"0"
"5338",51,2,48,5181137,5186126,4989,5,"0"
"5435",51,5,27,5187963,5192831,4868,4.9,"20"
"5636",51,7,77,5197496,5202962,5466,5.5,"20"
"5742",51,4,66,5206035,5210369,4334,4.3,"0"
"5835",51,5,43,5212255,5216039,3784,3.8,"20"
"5932",51,8,78,5218285,5221845,3560,3.6,"0"
"6040",51,6,76,5224774,5230433,5659,5.7,"0"
"6133",51,5,67,5232395,5236520,4125,4.1,"20"
"6241",51,7,61,5238598,5249012,10414,10.4,"20"
"6332",51,5,3,5251814,5257049,5235,5.2,"20"
"6532",51,6,44,5263499,5267603,4104,4.1,"0"
"6639",51,3,49,5270717,5273157,2440,2.4,"20"
"6731",51,5,75,5275314,5278646,3332,3.3,"20"
"6840",51,1,55,5280529,5284006,3477,3.5,"20"
"6934",51,7,45,5285897,5289678,3781,3.8,"20"
"7036",51,7,69,5291750,5295474,3724,3.7,"20"
"7147",51,6,60,5299321,5302040,2719,2.7,"0"
"7233",51,5,35,5303802,5307511,3709,3.7,"20"
"7341",51,4,10,5309350,5312356,3006,3,"0"
"7541",51,2,40,5319410,5324857,5447,5.4,"0"
"7637",51,3,41,5326726,5332169,5443,5.4,"20"
"7736",51,6,52,5335599,5340116,4517,4.5,"0"
"7837",51,1,79,5342777,5346023,3246,3.2,"20"
"7941",51,5,51,5347680,5353643,5963,6,"20"
"8035",51,4,34,5355562,5360225,4663,4.7,"0"
"8143",51,2,64,5362032,5364803,2771,2.8,"0"
"8234",51,3,65,5367686,5370637,2951,3,"20"
"8332",51,8,30,5372779,5375812,3033,3,"0"
"8541",51,2,32,5381757,5385148,3391,3.4,"0"
"8737",51,2,72,5389538,5394446,4908,4.9,"0"
"8839",51,3,25,5396518,5399088,2570,2.6,"20"
"9043",51,7,53,5403979,5408934,4955,5,"20"
"9138",51,6,36,5410893,5415380,4487,4.5,"0"
"9239",51,2,8,5417163,5420209,3046,3,"0"
"9440",51,1,15,5425484,5428427,2943,2.9,"20"
"9640",51,6,20,5434056,5436576,2520,2.5,"0"
"9834",51,2,56,5442522,5444896,2374,2.4,"0"
"9940",51,3,57,5446710,5449523,2813,2.8,"20"
"10029",51,8,46,5451206,5455027,3821,3.8,"0"
"10162",51,7,13,5457473,5461721,4248,4.2,"20"
"10334",51,1,47,5465852,5468131,2279,2.3,"20"
"10434",51,4,18,5470219,5474905,4686,4.7,"0"
"10638",51,4,2,5480606,5483358,2752,2.8,"0"
"10838",51,7,21,5488220,5491400,3180,3.2,"20"
"11035",51,8,38,5498455,5502195,3740,3.7,"0"
"11139",51,1,39,5504906,5508473,3567,3.6,"20"
"11235",51,1,63,5510702,5514978,4276,4.3,"20"
"11339",51,6,28,5516799,5519561,2762,2.8,"0"
"11535",51,1,31,5525069,5530936,5867,5.9,"20"
"11732",51,6,4,5536739,5541953,5214,5.2,"0"
"11926",51,7,5,5548823,5552277,3454,3.5,"20"
"12132",51,2,80,5558111,5560269,2158,2.2,"0"
"10163",52,4,33,9564317,9568272,3955,4,"0"
"11140",52,3,56,9570165,9574290,4125,4.1,"20"
"1247",52,8,5,9578316,9582792,4476,4.5,"0"
"1440",52,7,52,9590823,9595690,4867,4.9,"20"
"1538",52,7,60,9598562,9603142,4580,4.6,"20"
"1636",52,7,4,9606480,9610695,4215,4.2,"20"
"1837",52,6,51,9621570,9625542,3972,4,"0"
"1930",52,1,30,9627761,9632031,4270,4.3,"20"
"2137",52,2,63,9639299,9642896,3597,3.6,"0"
"2227",52,1,38,9645450,9649293,3843,3.8,"20"
"2337",52,8,21,9651547,9655973,4426,4.4,"0"
"2536",52,7,68,9661665,9664289,2624,2.6,"20"
"2633",52,5,74,9667413,9671002,3589,3.6,"20"
"2740",52,4,9,9676291,9679940,3649,3.6,"0"
"2937",52,2,15,9687955,9691494,3539,3.5,"0"
"3140",52,1,46,9698264,9701060,2796,2.8,"20"
"3235",52,6,75,9703258,9706814,3556,3.6,"0"
"3334",52,1,62,9709427,9712929,3502,3.5,"20"
"3437",52,3,24,9714793,9718228,3435,3.4,"20"
"3641",52,4,41,9724967,9727781,2814,2.8,"0"
"3729",52,2,7,9729810,9732040,2230,2.2,"0"
"3931",52,6,19,9741161,9744335,3174,3.2,"0"
"4136",52,5,10,9752379,9754971,2592,2.6,"20"
"4329",52,5,26,9764144,9767237,3093,3.1,"20"
"4535",52,5,18,9773058,9775051,1993,2,"20"
"4740",52,3,80,9780597,9783614,3017,3,"20"
"4835",52,4,1,9787561,9789552,1991,2,"0"
"5038",52,2,47,9797032,9799655,2623,2.6,"0"
"5137",52,6,3,9804480,9806429,1949,1.9,"0"
"5339",52,8,77,9813144,9815144,2000,2,"0"
"5436",52,8,53,9817651,9821508,3857,3.9,"0"
"5534",52,8,61,9824138,9827275,3137,3.1,"0"
"5637",52,3,64,9830155,9832271,2116,2.1,"20"
"5743",52,5,66,9836106,9838286,2180,2.2,"20"
"5836",52,6,67,9842214,9845469,3255,3.3,"0"
"5933",52,3,32,9849850,9852885,3035,3,"20"
"6134",52,6,11,9861221,9863590,2369,2.4,"0"
"6333",52,4,25,9873180,9877278,4098,4.1,"0"
"6533",52,3,8,9883644,9887077,3433,3.4,"20"
"6732",52,8,29,9898471,9901183,2712,2.7,"0"
"6935",52,1,14,9911862,9915562,3700,3.7,"20"
"7148",52,1,78,9921319,9924614,3295,3.3,"20"
"7234",52,4,49,9927618,9929770,2152,2.2,"0"
"7342",52,1,6,9932249,9935279,3030,3,"20"
"7542",52,7,76,9942789,9946645,3856,3.9,"20"
"7638",52,7,44,9950450,9953541,3091,3.1,"20"
"7737",52,4,65,9956383,9958907,2524,2.5,"0"
"7838",52,8,37,9962796,9965054,2258,2.3,"0"
"7942",52,8,69,9967675,9969935,2260,2.3,"0"
"8036",52,7,20,9975730,9977938,2208,2.2,"20"
"8235",52,2,79,9984150,9987226,3076,3.1,"0"
"8333",52,2,55,9989837,9991624,1787,1.8,"0"
"8433",52,1,70,9995477,9999182,3705,3.7,"20"
"8542",52,4,17,10002140,10004141,2001,2,"0"
"8738",52,7,28,10009369,10011408,2039,2,"20"
"8931",52,6,35,10021316,10024247,2931,2.9,"0"
"9044",52,3,48,10028017,10030396,2379,2.4,"20"
"9139",52,6,27,10035553,10039264,3711,3.7,"0"
"9336",52,3,16,10045363,10047395,2032,2,"20"
"9536",52,2,31,10052743,10055258,2515,2.5,"0"
"9736",52,5,42,10061273,10065284,4011,4,"20"
"9835",52,1,22,10068695,10071342,2647,2.6,"20"
"10030",52,5,34,10077323,10080883,3560,3.6,"20"
"10164",52,3,72,10084677,10087018,2341,2.3,"20"
"10238",52,5,58,10089144,10089231,87,0.1,"20"
"10335",52,4,73,10100682,10103605,2923,2.9,"0"
"10435",52,8,45,10105982,10108095,2113,2.1,"0"
"10536",52,7,12,10112181,10114847,2666,2.7,"20"
"10731",52,3,40,10120826,10123210,2384,2.4,"20"
"10839",52,5,50,10126981,10128842,1861,1.9,"20"
"10931",52,1,54,10134278,10136536,2258,2.3,"20"
"11036",52,6,59,10139053,10141342,2289,2.3,"0"
"11141",52,2,39,10148032,10151048,3016,3,"0"
"11236",52,8,13,10153597,10156233,2636,2.6,"0"
"11434",52,5,2,10162801,10165396,2595,2.6,"20"
"11636",52,2,23,10172713,10174889,2176,2.2,"0"
"11836",52,7,36,10181108,10183544,2436,2.4,"20"
"11927",52,4,57,10187200,10189610,2410,2.4,"0"
"12026",52,2,71,10192292,10194868,2576,2.6,"0"
"12133",52,6,43,10199054,10201516,2462,2.5,"0"
"10165",53,3,15,11038982,11046400,7418,7.4,"20"
"1248",53,2,54,11055964,11063901,7937,7.9,"0"
"1336",53,7,11,11070045,11079579,9534,9.5,"20"
"1539",53,1,61,11087849,11095050,7201,7.2,"20"
"1637",53,5,9,11100576,11107699,7123,7.1,"20"
"1838",53,4,64,11116764,11123532,6768,6.8,"0"
"1931",53,1,77,11129216,11135857,6641,6.6,"20"
"2038",53,2,14,11139113,11146005,6892,6.9,"0"
"2228",53,4,56,11153756,11158961,5205,5.2,"0"
"2338",53,1,45,11161405,11166805,5400,5.4,"20"
"2432",53,2,70,11169748,11176361,6613,6.6,"0"
"2537",53,2,22,11178762,11185123,6361,6.4,"0"
"2741",53,7,75,11196350,11201292,4942,4.9,"20"
"2835",53,7,35,11205008,11211215,6207,6.2,"20"
"2938",53,7,19,11213198,11220728,7530,7.5,"20"
"3141",53,5,65,11231411,11238222,6811,6.8,"20"
"3236",53,1,5,11243126,11250030,6904,6.9,"20"
"3438",53,6,74,11262389,11270323,7934,7.9,"0"
"3532",53,6,66,11397758,11403918,6160,6.2,"0"
"3642",53,4,40,11409060,11415422,6362,6.4,"0"
"3730",53,1,13,11417531,11424567,7036,7,"20"
"3932",53,8,44,11433579,11438662,5083,5.1,"0"
"4035",53,3,23,11447730,11451316,3586,3.6,"20"
"4241",53,8,36,11460022,11465930,5908,5.9,"0"
"4330",53,1,69,11533390,11538425,5035,5,"20"
"4439",53,6,34,11540755,11546372,5617,5.6,"0"
"4536",53,7,3,11549046,11555731,6685,6.7,"20"
"4741",53,4,24,11562811,11568756,5945,5.9,"0"
"4938",53,4,48,11576281,11581491,5210,5.2,"0"
"5039",53,1,29,11583754,11588856,5102,5.1,"20"
"5236",53,5,57,11594799,11599603,4804,4.8,"20"
"5340",53,6,18,11602048,11606725,4677,4.7,"0"
"5535",53,8,4,11613422,11618228,4806,4.8,"0"
"5744",53,7,43,11623581,11628023,4442,4.4,"20"
"5837",53,3,31,11630345,11635036,4691,4.7,"20"
"6041",53,2,6,11640541,11644792,4251,4.3,"0"
"6242",53,6,58,11653353,11657367,4014,4,"0"
"6334",53,8,52,11660576,11667957,7381,7.4,"0"
"6437",53,7,27,11671365,11677180,5815,5.8,"20"
"6640",53,8,76,11683931,11688824,4893,4.9,"0"
"6733",53,2,38,11693735,11700403,6668,6.7,"0"
"6841",53,7,59,11703529,11710888,7359,7.4,"20"
"6936",53,6,2,11715211,11720589,5378,5.4,"0"
"7149",53,6,42,11727784,11731941,4157,4.2,"0"
"7235",53,8,60,11735285,11739604,4319,4.3,"0"
"7343",53,2,30,11744429,11748677,4248,4.2,"0"
"7543",53,8,28,11753918,11760524,6606,6.6,"0"
"7738",53,4,8,11766848,11775016,8168,8.2,"0"
"7943",53,1,21,11825842,11830621,4779,4.8,"20"
"8144",53,2,46,11836834,11840851,4017,4,"0"
"8236",53,3,39,11843140,11848213,5073,5.1,"20"
"8334",53,5,1,11850372,11855801,5429,5.4,"20"
"8543",53,3,47,11861010,11865781,4771,4.8,"20"
"8633",53,1,37,11871301,11875331,4030,4,"20"
"8739",53,2,62,11878831,11883652,4821,4.8,"0"
"8840",53,3,55,11886219,11892382,6163,6.2,"20"
"8932",53,6,10,11894368,11899302,4934,4.9,"0"
"9140",53,6,26,11905284,11909942,4658,4.7,"0"
"9337",53,4,72,11916496,11922833,6337,6.3,"0"
"9441",53,7,51,11925193,11929732,4539,4.5,"20"
"9537",53,2,78,11932204,11938789,6585,6.6,"0"
"9641",53,7,67,11941613,11947344,5731,5.7,"20"
"9737",53,5,41,11950340,11954877,4537,4.5,"20"
"9836",53,4,32,11957923,11962797,4874,4.9,"0"
"10031",53,5,25,11968110,11972774,4664,4.7,"20"
"10239",53,4,80,11978002,11982275,4273,4.3,"0"
"10336",53,8,68,11984790,11989382,4592,4.6,"0"
"10436",53,5,73,11992080,11997634,5554,5.6,"20"
"10537",53,5,49,12000489,12004484,3995,4,"20"
"10639",53,3,7,12007010,12011036,4026,4,"20"
"10840",53,1,53,12017501,12024924,7423,7.4,"20"
"10932",53,4,16,12027584,12031650,4066,4.1,"0"
"11142",53,3,63,12037529,12042463,4934,4.9,"20"
"11237",53,3,79,12045897,12049485,3588,3.6,"20"
"11340",53,3,71,12052075,12056398,4323,4.3,"20"
"11435",53,5,33,12058643,12061846,3203,3.2,"20"
"11536",53,8,20,12065978,12070339,4361,4.4,"0"
"11733",53,8,12,12077067,12084075,7008,7,"0"
"11928",53,5,17,12093676,12099294,5618,5.6,"20"
"12134",53,6,50,12104883,12108566,3683,3.7,"0"
"10166",54,7,66,10047836,10051550,3714,3.7,"20"
"11143",54,5,80,10053776,10057159,3383,3.4,"20"
"1249",54,5,72,10059307,10064024,4717,4.7,"20"
"1337",54,4,71,10066028,10068864,2836,2.8,"0"
"1441",54,6,25,10071235,10074618,3383,3.4,"0"
"1638",54,4,39,10081169,10084241,3072,3.1,"0"
"1734",54,7,10,10087115,10090884,3769,3.8,"20"
"1932",54,4,15,10096319,10098393,2074,2.1,"0"
"2138",54,8,27,10103438,10105897,2459,2.5,"0"
"2339",54,6,9,10111930,10114823,2893,2.9,"0"
"2538",54,8,51,10119943,10122703,2760,2.8,"0"
"2634",54,7,58,10125102,10127138,2036,2,"20"
"2742",54,5,8,10129811,10131896,2085,2.1,"20"
"2939",54,5,64,10136885,10138610,1725,1.7,"20"
"3032",54,2,61,10140603,10142589,1986,2,"0"
"3142",54,7,18,10144607,10147298,2691,2.7,"20"
"3335",54,3,78,10152664,10155105,2441,2.4,"20"
"3439",54,6,65,10156955,10159388,2433,2.4,"0"
"3533",54,8,11,10161331,10163499,2168,2.2,"0"
"3731",54,5,56,10169153,10171196,2043,2,"20"
"3837",54,8,67,10173028,10174806,1778,1.8,"0"
"3933",54,3,46,10176684,10179006,2322,2.3,"20"
"4036",54,6,73,10181063,10183105,2042,2,"0"
"4137",54,1,44,10185276,10187387,2111,2.1,"20"
"4242",54,1,60,10191243,10193523,2280,2.3,"20"
"4331",54,4,7,10196834,10199710,2876,2.9,"0"
"4537",54,3,70,10205263,10207785,2522,2.5,"20"
"4635",54,2,21,10209846,10212051,2205,2.2,"0"
"4836",54,3,62,10217739,10220130,2391,2.4,"20"
"4939",54,5,32,10223663,10226342,2679,2.7,"20"
"5138",54,7,42,10230988,10233032,2044,2,"20"
"5237",54,6,57,10234963,10237030,2067,2.1,"0"
"5341",54,4,79,10238776,10240784,2008,2,"0"
"5437",54,8,43,10244655,10247199,2544,2.5,"0"
"5536",54,3,14,10249004,10251200,2196,2.2,"20"
"5745",54,2,53,10256807,10258892,2085,2.1,"0"
"5838",54,3,22,10261673,10264088,2415,2.4,"20"
"6042",54,4,63,10269250,10270912,1662,1.7,"0"
"6135",54,2,45,10272741,10274276,1535,1.5,"0"
"6243",54,2,37,10276143,10277949,1806,1.8,"0"
"6335",54,4,55,10279868,10281513,1645,1.6,"0"
"6438",54,1,12,10291581,10295268,3687,3.7,"20"
"6641",54,6,49,10300008,10301896,1888,1.9,"0"
"6734",54,8,59,10307564,10309605,2041,2,"0"
"6842",54,1,4,10312060,10314080,2020,2,"20"
"7037",54,8,75,10318391,10320679,2288,2.3,"0"
"7150",54,1,68,10322681,10324204,1523,1.5,"20"
"7236",54,7,50,10325952,10327477,1525,1.5,"20"
"7344",54,2,77,10329458,10331471,2013,2,"0"
"7436",54,8,35,10333866,10336212,2346,2.3,"0"
"7544",54,8,19,10338329,10340003,1674,1.7,"0"
"7739",54,5,24,10346295,10348098,1803,1.8,"20"
"7944",54,1,28,10354281,10356066,1785,1.8,"20"
"8145",54,4,31,10361301,10363238,1937,1.9,"0"
"8335",54,1,76,10369263,10371755,2492,2.5,"20"
"8434",54,2,13,10374866,10377649,2783,2.8,"0"
"8634",54,6,1,10383909,10385735,1826,1.8,"0"
"8841",54,3,30,10390652,10392211,1559,1.6,"20"
"9045",54,6,33,10396523,10397911,1388,1.4,"0"
"9141",54,5,16,10400428,10402162,1734,1.7,"20"
"9338",54,4,47,10406603,10407892,1289,1.3,"0"
"9442",54,6,41,10416562,10418504,1942,1.9,"0"
"9538",54,5,48,10420407,10422516,2109,2.1,"20"
"9642",54,6,17,10424269,10426029,1760,1.8,"0"
"9837",54,3,54,10430823,10432648,1825,1.8,"20"
"9941",54,2,5,10439209,10442632,3423,3.4,"0"
"10167",54,7,74,10447262,10449964,2702,2.7,"20"
"10240",54,1,52,10453442,10455248,1806,1.8,"20"
"10337",54,4,23,10457244,10459117,1873,1.9,"0"
"10538",54,3,6,10463375,10464851,1476,1.5,"20"
"10732",54,7,34,10470091,10471867,1776,1.8,"20"
"10841",54,5,40,10475375,10477217,1842,1.8,"20"
"10933",54,1,20,10481132,10483265,2133,2.1,"20"
"11144",54,8,3,10494169,10495766,1597,1.6,"0"
"11341",54,3,38,10500172,10502042,1870,1.9,"20"
"11436",54,7,26,10503840,10505616,1776,1.8,"20"
"11637",54,2,69,10510513,10512153,1640,1.6,"0"
"11734",54,7,2,10513911,10515285,1374,1.4,"20"
"11929",54,1,36,10520679,10522093,1414,1.4,"20"
"12027",54,2,29,10526949,10529130,2181,2.2,"0"
"10168",55,5,31,8688544,8692393,3849,3.8,"20"
"1250",55,8,50,8696789,8699831,3042,3,"0"
"1338",55,1,67,8704496,8710277,5781,5.8,"20"
"1442",55,2,44,8723642,8729884,6242,6.2,"0"
"1540",55,5,79,8731797,8736987,5190,5.2,"20"
"1639",55,3,69,8739175,8743613,4438,4.4,"20"
"1735",55,5,39,8745867,8748707,2840,2.8,"20"
"1839",55,2,60,8750545,8753506,2961,3,"0"
"1933",55,1,51,8755759,8758716,2957,3,"20"
"2039",55,4,70,8761380,8766161,4781,4.8,"0"
"2139",55,7,57,8768477,8772227,3750,3.8,"20"
"2229",55,4,46,8774694,8778806,4112,4.1,"0"
"2340",55,7,73,8780633,8785662,5029,5,"20"
"2433",55,3,77,8787363,8790281,2918,2.9,"20"
"2539",55,4,22,8791935,8797552,5617,5.6,"0"
"2743",55,2,52,8803055,8807457,4402,4.4,"0"
"2836",55,6,8,8809756,8817487,7731,7.7,"0"
"3033",55,7,49,8823345,8828978,5633,5.6,"20"
"3143",55,8,66,8831166,8835044,3878,3.9,"0"
"3237",55,3,45,8836749,8839715,2966,3,"20"
"3336",55,1,27,8841731,8845466,3735,3.7,"20"
"3534",55,1,35,8850322,8854629,4307,4.3,"20"
"3643",55,1,11,8856373,8859252,2879,2.9,"20"
"3838",55,8,26,8864572,8869799,5227,5.2,"0"
"4037",55,6,64,8874859,8877073,2214,2.2,"0"
"4138",55,4,38,8880104,8882843,2739,2.7,"0"
"4243",55,4,6,8884629,8888166,3537,3.5,"0"
"4440",55,8,34,8892494,8897372,4878,4.9,"0"
"4538",55,4,14,8899142,8902023,2881,2.9,"0"
"4742",55,3,61,8906992,8911187,4195,4.2,"20"
"4837",55,4,78,8913077,8916368,3291,3.3,"0"
"4940",55,8,2,8918298,8921372,3074,3.1,"0"
"5139",55,7,9,8926270,8933936,7666,7.7,"20"
"5342",55,1,19,8939169,8941942,2773,2.8,"20"
"5537",55,6,32,8950868,8953651,2783,2.8,"0"
"5746",55,5,47,8958949,8960754,1805,1.8,"20"
"5839",55,2,28,8962700,8967331,4631,4.6,"0"
"6043",55,7,65,8973776,8981368,7592,7.6,"20"
"6136",55,6,40,8983709,8987093,3384,3.4,"0"
"6244",55,6,72,8989996,8993019,3023,3,"0"
"6336",55,2,68,8995164,8997556,2392,2.4,"0"
"6439",55,6,80,8999630,9002048,2418,2.4,"0"
"6534",55,8,10,9004368,9007962,3594,3.6,"0"
"6735",55,8,58,9013354,9017983,4629,4.6,"0"
"6843",55,2,12,9020264,9022728,2464,2.5,"0"
"7038",55,3,21,9029473,9034441,4968,5,"20"
"7237",55,7,33,9039791,9042913,3122,3.1,"20"
"7345",55,7,25,9044853,9050524,5671,5.7,"20"
"7545",55,7,41,9057011,9062631,5620,5.6,"20"
"7639",55,3,13,9068286,9071491,3205,3.2,"20"
"7839",55,6,48,9092486,9096389,3903,3.9,"0"
"7945",55,6,56,9098548,9100459,1911,1.9,"0"
"8037",55,7,17,9102168,9104757,2589,2.6,"20"
"8237",55,4,62,9109271,9119729,10458,10.5,"0"
"8336",55,3,37,9121629,9125042,3413,3.4,"20"
"8435",55,3,53,9126870,9131652,4782,4.8,"20"
"8544",55,4,30,9133510,9135218,1708,1.7,"0"
"8740",55,3,29,9139248,9144698,5450,5.5,"20"
"8933",55,8,74,9150017,9154550,4533,4.5,"0"
"9046",55,1,59,9156968,9160232,3264,3.3,"20"
"9142",55,1,75,9162234,9164297,2063,2.1,"20"
"9240",55,3,5,9167181,9169244,2063,2.1,"20"
"9443",55,1,43,9174819,9179433,4614,4.6,"20"
"9539",55,2,36,9181457,9184416,2959,3,"0"
"9643",55,5,15,9187300,9190179,2879,2.9,"20"
"9838",55,5,7,9194721,9198478,3757,3.8,"20"
"10032",55,5,23,9205805,9209326,3521,3.5,"20"
"10241",55,5,71,9213325,9217162,3837,3.8,"20"
"10338",55,6,24,9219376,9224598,5222,5.2,"0"
"10539",55,7,1,9229974,9233644,3670,3.7,"20"
"10733",55,4,54,9238515,9241827,3312,3.3,"0"
"10842",55,8,42,9244168,9247451,3283,3.3,"0"
"10934",55,5,55,9249379,9251880,2501,2.5,"20"
"11037",55,2,20,9255784,9258341,2557,2.6,"0"
"11238",55,6,16,9263196,9270160,6964,7,"0"
"11437",55,2,76,9278844,9283701,4857,4.9,"0"
"11537",55,1,3,9286006,9290632,4626,4.6,"20"
"11735",55,8,18,9295856,9299882,4026,4,"0"
"11930",55,2,4,9305237,9310010,4773,4.8,"0"
"12135",55,5,63,9314504,9320892,6388,6.4,"20"
"10169",56,2,3,84947,88601,3654,3.7,"0"
"1251",56,5,38,93817,99661,5844,5.8,"20"
"1339",56,7,56,101957,107648,5691,5.7,"20"
"1443",56,7,16,109577,114693,5116,5.1,"20"
"1640",56,4,53,119907,124270,4363,4.4,"0"
"1736",56,6,71,126038,130233,4195,4.2,"0"
"1840",56,8,1,132189,137639,5450,5.5,"0"
"2040",56,3,76,142884,153577,10693,10.7,"20"
"2140",56,7,64,155415,159945,4530,4.5,"20"
"2230",56,7,80,162241,167216,4975,5,"20"
"2341",56,6,31,169069,174453,5384,5.4,"0"
"2540",56,2,11,179335,186432,7097,7.1,"0"
"2744",56,8,33,193695,198192,4497,4.5,"0"
"2837",56,5,62,200165,210352,10187,10.2,"20"
"2940",56,8,73,213342,218316,4974,5,"0"
"3034",56,4,21,220667,224307,3640,3.6,"0"
"3238",56,3,60,229842,234917,5075,5.1,"20"
"3337",56,8,65,236751,243889,7138,7.1,"0"
"3440",56,6,63,246444,252949,6505,6.5,"0"
"3535",56,3,44,254890,258793,3903,3.9,"20"
"3644",56,6,39,260529,264542,4013,4,"0"
"3732",56,1,18,266249,270776,4527,4.5,"20"
"3934",56,2,35,277360,282153,4793,4.8,"0"
"4038",56,1,42,284899,290149,5250,5.2,"20"
"4139",56,4,45,293390,296578,3188,3.2,"0"
"4244",56,4,5,298555,305479,6924,6.9,"0"
"4441",56,3,12,311750,314926,3176,3.2,"20"
"4636",56,1,2,320187,323732,3545,3.5,"20"
"4838",56,6,79,329202,332810,3608,3.6,"0"
"4941",56,7,32,334730,338802,4072,4.1,"20"
"5140",56,2,43,343845,347022,3177,3.2,"0"
"5238",56,7,72,348789,357899,9110,9.1,"20"
"5343",56,3,28,360637,364887,4250,4.2,"20"
"5538",56,6,23,371378,374006,2628,2.6,"0"
"5747",56,8,9,378591,386373,7782,7.8,"0"
"5934",56,5,54,392113,399496,7383,7.4,"20"
"6044",56,3,68,401235,405996,4761,4.8,"20"
"6137",56,5,46,408983,414586,5603,5.6,"20"
"6245",56,1,74,416531,420335,3804,3.8,"20"
"6337",56,3,52,422717,426896,4179,4.2,"20"
"6440",56,4,77,428608,433007,4399,4.4,"0"
"6535",56,4,29,434667,442348,7681,7.7,"0"
"6736",56,8,49,447901,451658,3757,3.8,"0"
"6844",56,3,20,453334,457999,4665,4.7,"20"
"7039",56,8,57,463307,466601,3294,3.3,"0"
"7151",56,6,47,468299,471059,2760,2.8,"0"
"7238",56,5,78,474324,481238,6914,6.9,"20"
"7346",56,1,66,482948,487854,4906,4.9,"20"
"7437",56,5,30,489642,495328,5686,5.7,"20"
"7640",56,5,22,500734,509328,8594,8.6,"20"
"7840",56,8,25,514914,518725,3811,3.8,"0"
"8038",56,4,13,524105,530802,6697,6.7,"0"
"8238",56,5,6,540280,546580,6300,6.3,"20"
"8436",56,5,14,551600,555212,3612,3.6,"20"
"8635",56,1,26,560687,567896,7209,7.2,"20"
"8842",56,7,48,574199,579088,4889,4.9,"20"
"8934",56,1,34,580805,587354,6549,6.5,"20"
"9047",56,3,4,589191,592838,3647,3.6,"20"
"9241",56,7,40,597410,601263,3853,3.9,"20"
"9339",56,2,19,604332,609723,5391,5.4,"0"
"9540",56,3,36,617807,621850,4043,4,"20"
"9644",56,8,41,623787,627362,3575,3.6,"0"
"9738",56,2,67,629017,633541,4524,4.5,"0"
"9839",56,7,24,635214,641984,6770,6.8,"20"
"10033",56,2,51,650785,654964,4179,4.2,"0"
"10170",56,2,75,657034,660074,3040,3,"0"
"10242",56,1,58,662719,666279,3560,3.6,"20"
"10339",56,2,59,667960,671550,3590,3.6,"0"
"10437",56,6,55,673924,681558,7634,7.6,"0"
"10540",56,1,50,683188,686073,2885,2.9,"20"
"10640",56,4,37,687867,691967,4100,4.1,"0"
"10734",56,8,17,693925,697893,3968,4,"0"
"10935",56,5,70,703179,711016,7837,7.8,"20"
"11038",56,6,15,713744,717816,4072,4.1,"0"
"11239",56,1,10,724424,729023,4599,4.6,"20"
"11438",56,4,61,734048,738726,4678,4.7,"0"
"11538",56,4,69,740371,743462,3091,3.1,"0"
"11638",56,7,8,747254,752642,5388,5.4,"20"
"11837",56,2,27,757660,760855,3195,3.2,"0"
"12028",56,6,7,765747,771761,6014,6,"0"
"10171",57,1,41,11807235,11813355,6120,6.1,"20"
"11145",57,5,29,11815944,11823048,7104,7.1,"20"
"1340",57,7,47,11827883,11836168,8285,8.3,"20"
"1444",57,4,60,11839291,11844660,5369,5.4,"0"
"1541",57,7,71,11847641,11854730,7089,7.1,"20"
"1641",57,1,1,11857006,11864322,7316,7.3,"20"
"1841",57,2,42,11869405,11876052,6647,6.6,"0"
"1934",57,5,69,11878316,11883942,5626,5.6,"20"
"2041",57,1,25,11886077,11891333,5256,5.3,"20"
"2231",57,1,65,11896391,11903627,7236,7.2,"20"
"2342",57,8,48,11905856,11913850,7994,8,"0"
"2434",57,2,66,11915746,11920560,4814,4.8,"0"
"2541",57,4,44,11923398,11929421,6023,6,"0"
"2635",57,5,45,11931585,11936307,4722,4.7,"20"
"2745",57,3,67,11938286,11944327,6041,6,"20"
"2838",57,8,24,11946307,11952525,6218,6.2,"0"
"3035",57,2,18,11959173,11963141,3968,4,"0"
"3239",57,4,76,11969347,11974478,5131,5.1,"0"
"3338",57,7,7,11978284,11984098,5814,5.8,"20"
"3536",57,6,30,11991209,11995345,4136,4.1,"0"
"3733",57,8,40,11999964,12005260,5296,5.3,"0"
"3839",57,7,55,12007388,12013489,6101,6.1,"20"
"3935",57,4,20,12015328,12019929,4601,4.6,"0"
"4140",57,6,14,12027683,12032988,5305,5.3,"0"
"4332",57,7,79,12038874,12043034,4160,4.2,"20"
"4442",57,5,5,12044859,12050637,5778,5.8,"20"
"4637",57,6,6,12056599,12062354,5755,5.8,"0"
"4839",57,3,43,12067330,12072369,5039,5,"20"
"4942",57,7,31,12074365,12079384,5019,5,"20"
"5141",57,2,34,12084323,12089563,5240,5.2,"0"
"5239",57,5,21,12092336,12098006,5670,5.7,"20"
"5438",57,8,80,12103274,12107035,3761,3.8,"0"
"5539",57,2,58,12108878,12114556,5678,5.7,"0"
"5638",57,1,33,12116493,12121028,4535,4.5,"20"
"5748",57,6,70,12123320,12128909,5589,5.6,"0"
"5840",57,1,73,12130983,12136726,5743,5.7,"20"
"5935",57,4,68,12138847,12143846,4999,5,"0"
"6045",57,8,56,12145940,12151018,5078,5.1,"0"
"6138",57,3,3,12152774,12159077,6303,6.3,"20"
"6338",57,5,53,12164302,12169967,5665,5.7,"20"
"6441",57,5,61,12172174,12178246,6072,6.1,"20"
"6536",57,8,8,12180363,12186108,5745,5.7,"0"
"6737",57,4,28,12192792,12197437,4645,4.6,"0"
"6937",57,8,16,12202897,12208015,5118,5.1,"0"
"7152",57,6,46,12213104,12218041,4937,4.9,"0"
"7239",57,7,63,12219808,12225717,5909,5.9,"20"
"7347",57,4,12,12227782,12232644,4862,4.9,"0"
"7546",57,8,64,12237504,12242068,4564,4.6,"0"
"7641",57,4,52,12243886,12249199,5313,5.3,"0"
"7740",57,2,50,12251089,12255721,4632,4.6,"0"
"7841",57,6,54,12257699,12262811,5112,5.1,"0"
"7946",57,3,51,12264696,12269734,5038,5,"20"
"8039",57,3,35,12271732,12276973,5241,5.2,"20"
"8146",57,6,22,12278712,12284035,5323,5.3,"0"
"8337",57,5,37,12290682,12296388,5706,5.7,"20"
"8437",57,6,78,12298234,12303176,4942,4.9,"0"
"8545",57,5,13,12305110,12311324,6214,6.2,"20"
"8741",57,1,49,12316291,12321054,4763,4.8,"20"
"8843",57,8,32,12322922,12327621,4699,4.7,"0"
"9048",57,2,2,12333162,12338306,5144,5.1,"0"
"9242",57,1,57,12344177,12348717,4540,4.5,"20"
"9340",57,2,26,12350688,12357272,6584,6.6,"0"
"9541",57,2,10,12365717,12370462,4745,4.7,"0"
"9739",57,3,19,12377194,12382812,5618,5.6,"20"
"9942",57,4,4,12390722,12394372,3650,3.6,"0"
"10172",57,3,11,12399077,12403855,4778,4.8,"20"
"10340",57,5,77,12408545,12412708,4163,4.2,"20"
"10438",57,3,75,12414512,12419727,5215,5.2,"20"
"10541",57,7,39,12421575,12427967,6392,6.4,"20"
"10641",57,2,74,12429694,12434426,4732,4.7,"0"
"10735",57,1,9,12436173,12442057,5884,5.9,"20"
"10936",57,8,72,12447214,12451633,4419,4.4,"0"
"11039",57,3,59,12454057,12458335,4278,4.3,"20"
"11146",57,6,62,12460774,12466262,5488,5.5,"0"
"11240",57,3,27,12468202,12472640,4438,4.4,"20"
"11439",57,1,17,12477272,12482588,5316,5.3,"20"
"11639",57,7,23,12489000,12493466,4466,4.5,"20"
"11838",57,4,36,12497993,12502573,4580,4.6,"0"
"11931",57,7,15,12504989,12509297,4308,4.3,"20"
"12136",57,6,38,12514582,12522108,7526,7.5,"0"
"10173",58,1,72,13786318,13790213,3895,3.9,"20"
"11147",58,3,26,13793110,13796218,3108,3.1,"20"
"1341",58,8,31,13802751,13806305,3554,3.6,"0"
"1542",58,6,5,13812968,13817511,4543,4.5,"0"
"1737",58,2,17,13823041,13826774,3733,3.7,"0"
"1935",58,7,78,13833880,13837086,3206,3.2,"20"
"2042",58,2,73,13839440,13843149,3709,3.7,"0"
"2141",58,6,37,13848061,13853374,5313,5.3,"0"
"2232",58,7,6,13855326,13860282,4956,5,"20"
"2435",58,7,46,13866192,13869298,3106,3.1,"20"
"2542",58,1,48,13872774,13876242,3468,3.5,"20"
"2636",58,7,62,13881638,13886071,4433,4.4,"20"
"2746",58,5,20,13888583,13891026,2443,2.4,"20"
"2941",58,3,50,13898769,13900757,1988,2,"20"
"3036",58,2,49,13903006,13906191,3185,3.2,"0"
"3144",58,3,2,13909361,13914101,4740,4.7,"20"
"3339",58,8,63,13920071,13925570,5499,5.5,"0"
"3441",58,4,67,13927761,13931964,4203,4.2,"0"
"3537",58,2,33,13934502,13936903,2401,2.4,"0"
"3645",58,3,42,13938663,13942087,3424,3.4,"20"
"3734",58,5,52,13944392,13947863,3471,3.5,"20"
"3840",58,3,18,13952215,13958716,6501,6.5,"20"
"4039",58,2,25,13964287,13966808,2521,2.5,"0"
"4245",58,8,47,13972446,13974714,2268,2.3,"0"
"4333",58,2,1,13976654,13978513,1859,1.9,"0"
"4539",58,6,61,13983470,13987294,3824,3.8,"0"
"4638",58,1,80,13990498,13992786,2288,2.3,"20"
"4743",58,5,68,13996773,14001164,4391,4.4,"20"
"4840",58,8,23,14016850,14019313,2463,2.5,"0"
"5040",58,1,56,14025404,14027573,2169,2.2,"20"
"5142",58,7,22,14030491,14034519,4028,4,"20"
"5344",58,7,54,14040428,14045472,5044,5,"20"
"5439",58,8,71,14047520,14051889,4369,4.4,"0"
"5540",58,5,60,14062518,14065564,3046,3,"20"
"5639",58,5,44,14067974,14070847,2873,2.9,"20"
"5749",58,3,58,14072839,14075950,3111,3.1,"20"
"5841",58,1,16,14080804,14083316,2512,2.5,"20"
"6046",58,6,29,14089167,14091903,2736,2.7,"0"
"6246",58,6,21,14099262,14101776,2514,2.5,"0"
"6442",58,8,39,14106536,14108846,2310,2.3,"0"
"6537",58,1,32,14111987,14115040,3053,3.1,"20"
"6738",58,3,66,14122220,14125549,3329,3.3,"20"
"6845",58,3,74,14128349,14131747,3398,3.4,"20"
"6938",58,1,24,14139259,14142571,3312,3.3,"20"
"7153",58,5,4,14149488,14153309,3821,3.8,"20"
"7348",58,8,15,14159989,14163355,3366,3.4,"0"
"7547",58,5,28,14170291,14173053,2762,2.8,"20"
"7741",58,1,40,14178042,14180238,2196,2.2,"20"
"7842",58,3,10,14182129,14185111,2982,3,"20"
"8040",58,8,79,14190874,14195027,4153,4.2,"0"
"8147",58,5,76,14197520,14200790,3270,3.3,"20"
"8239",58,4,43,14203657,14206742,3085,3.1,"0"
"8338",58,6,69,14209439,14213631,4192,4.2,"0"
"8438",58,5,12,14215786,14217853,2067,2.1,"20"
"8636",58,1,8,14224550,14228629,4079,4.1,"20"
"8844",58,4,19,14234567,14237286,2719,2.7,"0"
"9049",58,8,55,14243075,14246147,3072,3.1,"0"
"9143",58,4,3,14249352,14252151,2799,2.8,"0"
"9341",58,3,34,14258147,14261189,3042,3,"20"
"9444",58,4,27,14266335,14268452,2117,2.1,"0"
"9645",58,2,65,14275587,14278446,2859,2.9,"0"
"9740",58,7,30,14281862,14284209,2347,2.3,"20"
"9943",58,2,9,14291385,14294632,3247,3.2,"0"
"10174",58,4,59,14299702,14302186,2484,2.5,"0"
"10243",58,6,77,14304481,14306380,1899,1.9,"0"
"10341",58,6,45,14309463,14311413,1950,2,"0"
"10439",58,2,57,14315621,14319176,3555,3.6,"0"
"10542",58,6,13,14321641,14324094,2453,2.5,"0"
"10736",58,7,14,14330058,14334082,4024,4,"20"
"10937",58,2,41,14347424,14349475,2051,2.1,"0"
"11040",58,6,53,14358461,14360418,1957,2,"0"
"11148",58,4,75,14362699,14365009,2310,2.3,"0"
"11241",58,7,70,14367034,14370128,3094,3.1,"20"
"11342",58,7,38,14372838,14375279,2441,2.4,"20"
"11440",58,5,36,14377236,14379731,2495,2.5,"20"
"11539",58,8,7,14382209,14385987,3778,3.8,"0"
"11736",58,1,64,14393892,14395770,1878,1.9,"20"
"11839",58,4,35,14398425,14400963,2538,2.5,"0"
"11932",58,4,51,14402732,14404698,1966,2,"0"
"12029",58,4,11,14408339,14412100,3761,3.8,"0"
"10175",59,7,37,2242586,2246475,3889,3.9,"20"
"11149",59,3,17,2248369,2254864,6495,6.5,"20"
"1342",59,8,14,2259690,2264249,4559,4.6,"0"
"1543",59,1,39,2269833,2275913,6080,6.1,"20"
"1642",59,6,52,2277949,2282009,4060,4.1,"0"
"1738",59,1,55,2284168,2288127,3959,4,"20"
"1842",59,7,45,2289953,2293677,3724,3.7,"20"
"1936",59,1,31,2295935,2300791,4856,4.9,"20"
"2142",59,1,71,2306574,2310395,3821,3.8,"20"
"2233",59,8,78,2313017,2316964,3947,3.9,"0"
"2343",59,4,18,2318898,2322740,3842,3.8,"0"
"2543",59,8,30,2327511,2330835,3324,3.3,"0"
"2747",59,8,38,2335131,2338847,3716,3.7,"0"
"2839",59,7,29,2340468,2343285,2817,2.8,"20"
"3037",59,2,40,2347719,2351065,3346,3.3,"0"
"3145",59,5,51,2352828,2357061,4233,4.2,"20"
"3240",59,1,63,2359073,2362130,3057,3.1,"20"
"3340",59,5,43,2364446,2367237,2791,2.8,"20"
"3442",59,6,12,2368997,2372069,3072,3.1,"0"
"3646",59,2,72,2376755,2382500,5745,5.7,"0"
"3735",59,7,61,2384260,2392513,8253,8.3,"20"
"3841",59,1,23,2394495,2398443,3948,3.9,"20"
"4040",59,4,10,2403630,2408140,4510,4.5,"0"
"4246",59,4,58,2414808,2420252,5444,5.4,"0"
"4334",59,7,69,2422195,2425203,3008,3,"20"
"4443",59,8,70,2429414,2433580,4166,4.2,"0"
"4540",59,4,66,2435529,2438499,2970,3,"0"
"4639",59,6,20,2440350,2443665,3315,3.3,"0"
"4841",59,7,53,2449141,2453226,4085,4.1,"20"
"4943",59,7,21,2455879,2460722,4843,4.8,"20"
"5143",59,4,74,2468909,2472084,3175,3.2,"0"
"5240",59,5,3,2473908,2479659,5751,5.8,"20"
"5440",59,3,65,2484409,2489233,4824,4.8,"20"
"5541",59,6,44,2491258,2493759,2501,2.5,"0"
"5640",59,6,60,2495426,2498430,3004,3,"0"
"5750",59,4,34,2500237,2503640,3403,3.4,"0"
"5842",59,6,28,2505345,2508481,3136,3.1,"0"
"6047",59,6,4,2513366,2516478,3112,3.1,"0"
"6247",59,6,68,2521133,2523712,2579,2.6,"0"
"6339",59,3,25,2525428,2527839,2411,2.4,"20"
"6538",59,4,26,2533018,2536198,3180,3.2,"0"
"6739",59,5,27,2541919,2546145,4226,4.2,"20"
"6939",59,2,64,2550803,2553271,2468,2.5,"0"
"7040",59,5,75,2555078,2558548,3470,3.5,"20"
"7154",59,4,2,2560180,2564569,4389,4.4,"0"
"7349",59,3,49,2569969,2573456,3487,3.5,"20"
"7438",59,5,59,2575246,2578402,3156,3.2,"20"
"7548",59,2,8,2580123,2583611,3488,3.5,"0"
"7742",59,7,13,2588254,2591765,3511,3.5,"20"
"7947",59,1,15,2596011,2600089,4078,4.1,"20"
"8148",59,3,33,2607075,2609484,2409,2.4,"20"
"8240",59,6,76,2611255,2615318,4063,4.1,"0"
"8339",59,2,80,2617037,2619400,2363,2.4,"0"
"8439",59,3,9,2621157,2624113,2956,3,"20"
"8637",59,1,79,2629023,2631242,2219,2.2,"20"
"8742",59,4,42,2633464,2636872,3408,3.4,"0"
"8845",59,5,35,2639579,2642017,2438,2.4,"20"
"8935",59,4,50,2643870,2645624,1754,1.8,"0"
"9050",59,1,47,2647390,2649761,2371,2.4,"20"
"9144",59,3,73,2651627,2654592,2965,3,"20"
"9243",59,2,48,2656238,2662523,6285,6.3,"0"
"9342",59,3,1,2664317,2666812,2495,2.5,"20"
"9542",59,7,5,2673224,2677539,4315,4.3,"20"
"9741",59,5,67,2682794,2688720,5926,5.9,"20"
"9840",59,5,19,2690548,2693405,2857,2.9,"20"
"10034",59,2,24,2699646,2704058,4412,4.4,"0"
"10244",59,2,16,2708572,2711390,2818,2.8,"0"
"10440",59,5,11,2716232,2719740,3508,3.5,"20"
"10642",59,2,56,2725338,2728197,2859,2.9,"0"
"10737",59,8,46,2729880,2732919,3039,3,"0"
"10843",59,1,7,2734677,2737798,3121,3.1,"20"
"11041",59,8,62,2743769,2747126,3357,3.4,"0"
"11150",59,3,41,2748856,2751381,2525,2.5,"20"
"11242",59,2,32,2753067,2755697,2630,2.6,"0"
"11441",59,8,54,2759902,2763781,3879,3.9,"0"
"11540",59,3,57,2766042,2768917,2875,2.9,"20"
"11640",59,8,22,2771145,2774601,3456,3.5,"0"
"11840",59,8,6,2778788,2785108,6320,6.3,"0"
"12030",59,7,77,2790034,2794011,3977,4,"20"
"12137",59,6,36,2795913,2799613,3700,3.7,"0"
"10176",60,8,5,2029822,2034114,4292,4.3,"0"
"1252",60,7,4,2040803,2044702,3899,3.9,"20"
"1445",60,6,59,2050293,2056655,6362,6.4,"0"
"1544",60,8,21,2058589,2062368,3779,3.8,"0"
"1739",60,5,10,2070018,2074805,4787,4.8,"20"
"1937",60,1,14,2084587,2089017,4430,4.4,"20"
"2143",60,3,64,2097077,2101131,4054,4.1,"20"
"2234",60,8,61,2105940,2113732,7792,7.8,"0"
"2344",60,6,43,2115793,2120648,4855,4.9,"0"
"2436",60,2,31,2124276,2129308,5032,5,"0"
"2637",60,7,76,2136880,2142932,6052,6.1,"20"
"2748",60,1,38,2146811,2152350,5539,5.5,"20"
"2840",60,2,71,2154693,2159022,4329,4.3,"0"
"2942",60,1,30,2161500,2165590,4090,4.1,"20"
"3146",60,2,63,2173321,2177761,4440,4.4,"0"
"3241",60,5,50,2180868,2185765,4897,4.9,"20"
"3341",60,4,25,2188025,2191719,3694,3.7,"0"
"3538",60,6,19,2198004,2201404,3400,3.4,"0"
"3736",60,6,27,2209658,2215955,6297,6.3,"0"
"3936",60,1,6,2224700,2230182,5482,5.5,"20"
"4141",60,7,44,2237401,2243268,5867,5.9,"20"
"4247",60,5,34,2248137,2255947,7810,7.8,"20"
"4335",60,8,37,2259716,2265316,5600,5.6,"0"
"4444",60,2,7,2267652,2271258,3606,3.6,"0"
"4640",60,1,22,2282758,2291207,8449,8.4,"20"
"4842",60,7,68,2299140,2303557,4417,4.4,"20"
"4944",60,1,46,2306881,2312892,6011,6,"20"
"5041",60,6,3,2316842,2321653,4811,4.8,"0"
"5241",60,7,28,2331008,2334666,3658,3.7,"20"
"5441",60,8,29,2343001,2351348,8347,8.3,"0"
"5641",60,3,48,2362346,2366769,4423,4.4,"20"
"5751",60,3,56,2371146,2373654,2508,2.5,"20"
"5843",60,2,55,2377817,2380931,3114,3.1,"0"
"5936",60,1,78,2383976,2389906,5930,5.9,"20"
"6048",60,4,57,2396766,2400344,3578,3.6,"0"
"6139",60,6,51,2405008,2409917,4909,4.9,"0"
"6248",60,1,62,2415438,2423335,7897,7.9,"20"
"6340",60,2,15,2427165,2430641,3476,3.5,"0"
"6539",60,3,8,2437938,2442772,4834,4.8,"20"
"6740",60,8,45,2451874,2454816,2942,2.9,"0"
"6846",60,4,65,2458835,2464368,5533,5.5,"0"
"6940",60,5,66,2467311,2472045,4734,4.7,"20"
"7041",60,3,80,2476866,2480691,3825,3.8,"20"
"7155",60,3,24,2482607,2486638,4031,4,"20"
"7350",60,1,54,2493882,2499093,5211,5.2,"20"
"7439",60,3,32,2503718,2509227,5509,5.5,"20"
"7642",60,5,2,2515442,2517788,2346,2.3,"20"
"7843",60,4,17,2525132,2531566,6434,6.4,"0"
"8041",60,5,58,2536901,2541816,4915,4.9,"20"
"8149",60,3,16,2544168,2549769,5601,5.6,"20"
"8340",60,8,77,2558018,2562479,4461,4.5,"0"
"8440",60,4,33,2564675,2568093,3418,3.4,"0"
"8546",60,5,74,2570724,2574848,4124,4.1,"20"
"8638",60,1,70,2577474,2582539,5065,5.1,"20"
"8743",60,2,39,2585565,2588999,3434,3.4,"0"
"8846",60,2,47,2591073,2593457,2384,2.4,"0"
"8936",60,7,60,2596251,2600088,3837,3.8,"20"
"9051",60,5,18,2605093,2608697,3604,3.6,"20"
"9244",60,8,53,2615795,2620505,4710,4.7,"0"
"9343",60,4,49,2623206,2626717,3511,3.5,"0"
"9445",60,2,79,2629602,2633623,4021,4,"0"
"9543",60,8,69,2637735,2642065,4330,4.3,"0"
"9646",60,7,52,2645115,2650758,5643,5.6,"20"
"9742",60,6,75,2653737,2657486,3749,3.7,"0"
"9841",60,3,72,2659527,2665794,6267,6.3,"20"
"9944",60,5,42,2668058,2673582,5524,5.5,"20"
"10035",60,4,41,2676261,2680540,4279,4.3,"0"
"10177",60,4,9,2684600,2688987,4387,4.4,"0"
"10342",60,4,73,2698015,2702847,4832,4.8,"0"
"10441",60,3,40,2705600,2709007,3407,3.4,"20"
"10543",60,5,26,2711439,2716309,4870,4.9,"20"
"10738",60,7,12,2726481,2732791,6310,6.3,"20"
"10938",60,6,11,2738870,2741375,2505,2.5,"0"
"11151",60,6,67,2747385,2751976,4591,4.6,"0"
"11243",60,8,13,2754884,2759344,4460,4.5,"0"
"11442",60,4,1,2764891,2768144,3253,3.3,"0"
"11641",60,6,35,2774503,2778586,4083,4.1,"0"
"11737",60,2,23,2780612,2784533,3921,3.9,"0"
"11933",60,7,20,2789973,2793921,3948,3.9,"20"
"12138",60,7,36,2799621,2803852,4231,4.2,"20"
"10178",61,6,18,7618203,7623381,5178,5.2,"0"
"1253",61,4,16,7629104,7631686,2582,2.6,"0"
"1446",61,6,58,7637971,7642863,4892,4.9,"0"
"1545",61,4,40,7646189,7648555,2366,2.4,"0"
"1643",61,7,75,7654286,7656981,2695,2.7,"20"
"1740",61,3,7,7660308,7665910,5602,5.6,"20"
"1938",61,2,22,7673888,7678606,4718,4.7,"0"
"2144",61,1,69,7685341,7688892,3551,3.6,"20"
"2235",61,5,17,7692281,7697367,5086,5.1,"20"
"2437",61,5,25,7703716,7706441,2725,2.7,"20"
"2638",61,5,49,7711723,7714408,2685,2.7,"20"
"2749",61,5,41,7717430,7719653,2223,2.2,"20"
"2841",61,2,70,7723251,7727211,3960,4,"0"
"2943",61,2,62,7729994,7734210,4216,4.2,"0"
"3038",61,3,47,7737117,7739502,2385,2.4,"20"
"3147",61,4,48,7741950,7748386,6436,6.4,"0"
"3242",61,2,14,7751568,7754848,3280,3.3,"0"
"3443",61,6,34,7761983,7767393,5410,5.4,"0"
"3539",61,2,54,7770834,7773950,3116,3.1,"0"
"3647",61,1,45,7776028,7777864,1836,1.8,"20"
"3737",61,5,65,7780599,7785687,5088,5.1,"20"
"3842",61,6,66,7788117,7790609,2492,2.5,"0"
"3937",61,1,13,7792801,7795477,2676,2.7,"20"
"4142",61,2,30,7799753,7802210,2457,2.5,"0"
"4336",61,3,55,7806758,7809358,2600,2.6,"20"
"4445",61,7,11,7812388,7814228,1840,1.8,"20"
"4641",61,8,20,7819871,7823879,4008,4,"0"
"4843",61,1,29,7829108,7831435,2327,2.3,"20"
"5042",61,5,33,7837568,7840107,2539,2.5,"20"
"5144",61,5,1,7842400,7844344,1944,1.9,"20"
"5345",61,7,59,7850276,7853178,2902,2.9,"20"
"5442",61,1,77,7856372,7859748,3376,3.4,"20"
"5542",61,2,38,7861651,7864644,2993,3,"0"
"5642",61,2,6,7866693,7870640,3947,3.9,"0"
"5844",61,3,23,7875236,7876824,1588,1.6,"20"
"6049",61,3,39,7881316,7885036,3720,3.7,"20"
"6140",61,8,12,7887059,7889331,2272,2.3,"0"
"6341",61,7,43,7893935,7896286,2351,2.4,"20"
"6443",61,8,36,7898202,7902446,4244,4.2,"0"
"6540",61,6,10,7904292,7907418,3126,3.1,"0"
"6741",61,2,78,7914084,7916536,2452,2.5,"0"
"6847",61,3,31,7918388,7921441,3053,3.1,"20"
"7042",61,7,67,7926847,7929892,3045,3,"20"
"7156",61,6,50,7932398,7934511,2113,2.1,"0"
"7240",61,6,26,7936271,7938781,2510,2.5,"0"
"7440",61,8,76,7945408,7951301,5893,5.9,"0"
"7549",61,6,2,7953083,7955727,2644,2.6,"0"
"7743",61,5,9,7961396,7964403,3007,3,"20"
"7948",61,5,57,7969756,7972947,3191,3.2,"20"
"8042",61,4,56,7974972,7977480,2508,2.5,"0"
"8150",61,4,72,7979578,7983009,3431,3.4,"0"
"8241",61,2,46,7984852,7987177,2325,2.3,"0"
"8341",61,1,53,7989843,7995460,5617,5.6,"20"
"8441",61,4,64,7997210,7999803,2593,2.6,"0"
"8547",61,8,28,8001692,8004878,3186,3.2,"0"
"8744",61,1,37,8010167,8013241,3074,3.1,"20"
"8847",61,3,79,8015007,8017791,2784,2.8,"20"
"8937",61,3,15,8019830,8023964,4134,4.1,"20"
"9145",61,7,27,8030456,8033520,3064,3.1,"20"
"9344",61,7,51,8039358,8042758,3400,3.4,"20"
"9446",61,8,52,8044541,8046585,2044,2,"0"
"9544",61,4,8,8048446,8052692,4246,4.2,"0"
"9743",61,5,73,8057847,8061236,3389,3.4,"20"
"9842",61,8,4,8063035,8070413,7378,7.4,"0"
"10036",61,8,60,8074225,8076089,1864,1.9,"0"
"10179",61,1,5,8077791,8080077,2286,2.3,"20"
"10343",61,3,71,8084448,8087077,2629,2.6,"20"
"10442",61,7,35,8088790,8091109,2319,2.3,"20"
"10544",61,6,42,8092991,8095912,2921,2.9,"0"
"10643",61,8,44,8097678,8100708,3030,3,"0"
"10739",61,4,32,8102801,8105646,2845,2.8,"0"
"10939",61,4,80,8110058,8113309,3251,3.3,"0"
"11042",61,7,19,8115283,8118137,2854,2.9,"20"
"11244",61,8,68,8124145,8126919,2774,2.8,"0"
"11343",61,1,21,8128815,8132296,3481,3.5,"20"
"11541",61,7,3,8137521,8140128,2607,2.6,"20"
"11738",61,1,61,8144476,8147017,2541,2.5,"20"
"11841",61,6,74,8150162,8152722,2560,2.6,"0"
"11934",61,4,24,8154495,8156820,2325,2.3,"0"
"12139",61,3,63,8162391,8165529,3138,3.1,"20"
"10180",62,3,22,187275,193054,5779,5.8,"20"
"1254",62,6,9,200654,205844,5190,5.2,"0"
"1447",62,1,68,213174,218326,5152,5.2,"20"
"1546",62,7,74,220674,229924,9250,9.2,"20"
"1644",62,8,27,231788,236447,4659,4.7,"0"
"1843",62,2,69,242048,245664,3616,3.6,"0"
"1939",62,4,79,247650,250725,3075,3.1,"0"
"2043",62,8,75,252719,256236,3517,3.5,"0"
"2145",62,8,43,258170,260880,2710,2.7,"0"
"2236",62,3,70,262713,277410,14697,14.7,"20"
"2345",62,3,38,279275,284918,5643,5.6,"20"
"2438",62,2,77,287040,290875,3835,3.8,"0"
"2544",62,4,23,292743,296023,3280,3.3,"0"
"2750",62,5,48,301088,307215,6127,6.1,"20"
"2842",62,7,2,309257,318895,9638,9.6,"20"
"3039",62,7,58,325499,332025,6526,6.5,"20"
"3148",62,6,65,333970,338180,4210,4.2,"0"
"3243",62,4,55,341050,344512,3462,3.5,"0"
"3342",62,1,76,347876,357249,9373,9.4,"20"
"3444",62,5,80,359050,364420,5370,5.4,"20"
"3540",62,3,6,366371,374850,8479,8.5,"20"
"3738",62,2,37,382370,386407,4037,4,"0"
"3843",62,6,41,388304,392697,4393,4.4,"0"
"3938",62,5,24,394712,402144,7432,7.4,"20"
"4143",62,8,19,406609,409393,2784,2.8,"0"
"4337",62,1,4,417994,421536,3542,3.5,"20"
"4541",62,4,7,425928,428917,2989,3,"0"
"4744",62,7,34,435708,444637,8929,8.9,"20"
"4844",62,2,29,446605,450781,4176,4.2,"0"
"5043",62,6,17,455924,460488,4564,4.6,"0"
"5242",62,7,50,465518,469959,4441,4.4,"20"
"5346",62,8,67,471680,476484,4804,4.8,"0"
"5443",62,7,10,478977,485639,6662,6.7,"20"
"5643",62,5,8,491843,501449,9606,9.6,"20"
"5845",62,8,35,515241,519420,4179,4.2,"0"
"5937",62,1,44,522619,527685,5066,5.1,"20"
"6050",62,3,62,529760,534038,4278,4.3,"20"
"6141",62,5,32,535874,538526,2652,2.7,"20"
"6342",62,7,42,544513,550980,6467,6.5,"20"
"6444",62,6,49,552986,555038,2052,2.1,"0"
"6541",62,4,63,557347,559214,1867,1.9,"0"
"6642",62,8,59,561671,564297,2626,2.6,"0"
"6742",62,3,14,568251,573308,5057,5.1,"20"
"6941",62,6,25,577983,580833,2850,2.8,"0"
"7157",62,1,12,586022,589967,3945,3.9,"20"
"7351",62,4,39,596083,598390,2307,2.3,"0"
"7441",62,5,56,600192,604311,4119,4.1,"20"
"7550",62,6,1,606330,608341,2011,2,"0"
"7744",62,7,26,615709,621455,5746,5.7,"20"
"7949",62,1,20,657898,660581,2683,2.7,"20"
"8151",62,2,5,665685,667483,1798,1.8,"0"
"8342",62,7,66,672828,677671,4843,4.8,"20"
"8442",62,8,51,679830,684941,5111,5.1,"0"
"8548",62,4,47,686685,689658,2973,3,"0"
"8639",62,3,46,691527,694514,2987,3,"20"
"8745",62,2,53,696453,698830,2377,2.4,"0"
"8848",62,2,45,703567,705314,1747,1.7,"0"
"8938",62,8,11,707091,708678,1587,1.6,"0"
"9146",62,3,54,712642,718739,6097,6.1,"20"
"9245",62,1,52,720559,724248,3689,3.7,"20"
"9345",62,2,13,726217,728260,2043,2,"0"
"9545",62,4,15,732365,734374,2009,2,"0"
"9744",62,4,71,740757,742924,2167,2.2,"0"
"9843",62,5,16,745075,747412,2337,2.3,"20"
"10037",62,8,3,755940,758255,2315,2.3,"0"
"10245",62,2,61,763813,765493,1680,1.7,"0"
"10344",62,3,30,770812,773870,3058,3.1,"20"
"10545",62,2,21,779410,783152,3742,3.7,"0"
"10740",62,5,72,789314,793354,4040,4,"20"
"10844",62,6,73,795130,796882,1752,1.8,"0"
"10940",62,6,57,798563,803152,4589,4.6,"0"
"11043",62,4,31,805364,808000,2636,2.6,"0"
"11245",62,1,28,813329,815931,2602,2.6,"20"
"11443",62,1,36,822888,825372,2484,2.5,"20"
"11542",62,3,78,827365,830028,2663,2.7,"20"
"11642",62,5,64,833453,838295,4842,4.8,"20"
"11739",62,1,60,840206,842118,1912,1.9,"20"
"11842",62,5,40,845163,847724,2561,2.6,"20"
"11935",62,7,18,852634,854606,1972,2,"20"
"12140",62,6,33,860979,862454,1475,1.5,"0"
"10181",63,8,58,10126715,10131071,4356,4.4,"0"
"11152",63,6,16,10139269,10144213,4944,4.9,"0"
"1343",63,1,67,10151816,10157360,5544,5.5,"20"
"1448",63,7,57,10165009,10169072,4063,4.1,"20"
"1547",63,2,36,10174299,10178809,4510,4.5,"0"
"1645",63,5,39,10184150,10190240,6090,6.1,"20"
"1741",63,7,33,10256472,10261391,4919,4.9,"20"
"1844",63,8,26,10269606,10274379,4773,4.8,"0"
"2044",63,5,47,10283556,10286722,3166,3.2,"20"
"2146",63,7,41,10299196,10305316,6120,6.1,"20"
"2237",63,1,27,10319834,10323253,3419,3.4,"20"
"2439",63,6,40,10344169,10348888,4719,4.7,"0"
"2545",63,8,50,10352936,10359350,6414,6.4,"0"
"2639",63,1,19,10362839,10366612,3773,3.8,"20"
"2843",63,1,43,10377313,10380615,3302,3.3,"20"
"2944",63,2,44,10383383,10386361,2978,3,"0"
"3040",63,7,9,10388195,10392460,4265,4.3,"20"
"3244",63,7,49,10398600,10401500,2900,2.9,"20"
"3343",63,6,72,10405243,10408615,3372,3.4,"0"
"3445",63,8,18,10411347,10413725,2378,2.4,"0"
"3648",63,7,25,10418819,10422021,3202,3.2,"20"
"3844",63,4,30,10428323,10430524,2201,2.2,"0"
"4041",63,4,70,10436582,10439429,2847,2.8,"0"
"4144",63,2,68,10442156,10444553,2397,2.4,"0"
"4248",63,2,20,10448279,10450274,1995,2,"0"
"4446",63,4,46,10456134,10458863,2729,2.7,"0"
"4542",63,3,61,10461933,10465871,3938,3.9,"20"
"4642",63,8,10,10468165,10471657,3492,3.5,"0"
"4845",63,4,54,10477527,10481084,3557,3.6,"0"
"4945",63,8,42,10484204,10488990,4786,4.8,"0"
"5044",63,8,2,10491363,10495842,4479,4.5,"0"
"5243",63,7,73,10503695,10508444,4749,4.7,"20"
"5347",63,7,65,10510536,10514907,4371,4.4,"20"
"5444",63,3,13,10517723,10522214,4491,4.5,"20"
"5644",63,4,14,10527896,10531903,4007,4,"0"
"5846",63,2,28,10538665,10543209,4544,4.5,"0"
"6051",63,8,34,10551500,10556996,5496,5.5,"0"
"6142",63,4,38,10559371,10563036,3665,3.7,"0"
"6249",63,6,80,10566886,10569516,2630,2.6,"0"
"6343",63,6,8,10573616,10577172,3556,3.6,"0"
"6542",63,5,15,10585065,10588761,3696,3.7,"20"
"6743",63,5,7,10597430,10600274,2844,2.8,"20"
"6942",63,5,55,10623215,10627204,3989,4,"20"
"7043",63,5,63,10644157,10647900,3743,3.7,"20"
"7158",63,8,66,10650390,10652797,2407,2.4,"0"
"7241",63,1,59,10655057,10658533,3476,3.5,"20"
"7352",63,5,79,10660753,10664261,3508,3.5,"20"
"7442",63,1,3,10667299,10672433,5134,5.1,"20"
"7643",63,4,78,10677095,10680704,3609,3.6,"0"
"7745",63,3,29,10687756,10690322,2566,2.6,"20"
"7950",63,1,35,10697829,10702174,4345,4.3,"20"
"8043",63,6,32,10704821,10708645,3824,3.8,"0"
"8242",63,5,23,10716875,10719733,2858,2.9,"20"
"8443",63,6,64,10725134,10728667,3533,3.5,"0"
"8549",63,1,75,10731619,10734531,2912,2.9,"20"
"8640",63,5,31,10738197,10741224,3027,3,"20"
"8849",63,3,69,10783296,10785847,2551,2.6,"20"
"8939",63,1,51,10787673,10789601,1928,1.9,"20"
"9052",63,7,17,10792405,10795982,3577,3.6,"20"
"9246",63,2,76,10801882,10804298,2416,2.4,"0"
"9346",63,8,74,10808306,10810339,2033,2,"0"
"9447",63,4,22,10814451,10817347,2896,2.9,"0"
"9647",63,1,11,10821804,10824130,2326,2.3,"20"
"9844",63,3,45,10831690,10834085,2395,2.4,"20"
"9945",63,4,62,10836332,10839717,3385,3.4,"0"
"10038",63,6,24,10843503,10847570,4067,4.1,"0"
"10246",63,5,71,10853147,10855963,2816,2.8,"20"
"10345",63,3,21,10858173,10861106,2933,2.9,"20"
"10546",63,4,6,10869009,10872336,3327,3.3,"0"
"10741",63,7,1,10878769,10882368,3599,3.6,"20"
"10941",63,3,53,10887825,10892048,4223,4.2,"20"
"11044",63,2,52,10895078,10897516,2438,2.4,"0"
"11153",63,2,60,10901707,10904259,2552,2.6,"0"
"11246",63,2,4,10906402,10908603,2201,2.2,"0"
"11444",63,6,48,10914056,10914217,161,0.2,"0"
"11543",63,3,5,10920257,10924006,3749,3.7,"20"
"11740",63,3,77,10930569,10934382,3813,3.8,"20"
"11843",63,2,12,10936903,10938722,1819,1.8,"0"
"12031",63,3,37,10944718,10946853,2135,2.1,"20"
"12141",63,6,56,10950053,10952616,2563,2.6,"0"
"10182",64,7,80,277126,280131,3005,3,"20"
"11154",64,4,29,287661,292089,4428,4.4,"0"
"1344",64,7,32,296501,301322,4821,4.8,"20"
"1548",64,7,48,306470,309494,3024,3,"20"
"1646",64,3,12,311325,314798,3473,3.5,"20"
"1845",64,3,20,320037,322531,2494,2.5,"20"
"2045",64,5,46,327056,329749,2693,2.7,"20"
"2147",64,1,42,331599,334622,3023,3,"20"
"2238",64,8,1,337949,339671,1722,1.7,"0"
"2440",64,8,25,345593,347700,2107,2.1,"0"
"2640",64,5,6,354886,358387,3501,3.5,"20"
"2844",64,2,19,364538,366970,2432,2.4,"0"
"3041",64,3,76,372549,375191,2642,2.6,"20"
"3149",64,3,36,376980,379937,2957,3,"20"
"3245",64,3,44,382140,384517,2377,2.4,"20"
"3344",64,6,23,387540,389362,1822,1.8,"0"
"3541",64,1,66,393509,396005,2496,2.5,"20"
"3649",64,4,45,398447,401100,2653,2.7,"0"
"3739",64,3,52,402788,404736,1948,1.9,"20"
"3845",64,6,79,406413,409305,2892,2.9,"0"
"3939",64,2,3,412024,415116,3092,3.1,"0"
"4145",64,6,47,421386,423976,2590,2.6,"0"
"4249",64,1,2,425749,428185,2436,2.4,"20"
"4447",64,5,70,433225,438792,5567,5.6,"20"
"4543",64,6,71,442168,445981,3813,3.8,"0"
"4643",64,5,30,448898,451288,2390,2.4,"20"
"4846",64,8,41,455520,457985,2465,2.5,"0"
"4946",64,7,72,460126,462809,2683,2.7,"20"
"5045",64,5,22,464634,467473,2839,2.8,"20"
"5244",64,8,33,471341,473419,2078,2.1,"0"
"5348",64,2,59,475720,478403,2683,2.7,"0"
"5445",64,5,54,480740,483281,2541,2.5,"20"
"5543",64,1,18,485461,487753,2292,2.3,"20"
"5752",64,2,11,494442,496202,1760,1.8,"0"
"5938",64,2,43,500730,502666,1936,1.9,"0"
"6052",64,6,15,505912,507886,1974,2,"0"
"6250",64,3,68,512491,514428,1937,1.9,"20"
"6344",64,7,16,516161,518381,2220,2.2,"20"
"6543",64,8,57,523524,526773,3249,3.2,"0"
"6643",64,5,62,528436,530661,2225,2.2,"20"
"6744",64,1,34,533602,536960,3358,3.4,"20"
"6848",64,7,40,538787,541546,2759,2.8,"20"
"6943",64,4,13,543165,545238,2073,2.1,"0"
"7159",64,1,10,549127,551186,2059,2.1,"20"
"7353",64,3,28,555649,557994,2345,2.3,"20"
"7551",64,1,50,562364,564694,2330,2.3,"20"
"7644",64,5,38,566820,570547,3727,3.7,"20"
"7746",64,4,21,572258,574473,2215,2.2,"0"
"7951",64,2,27,578803,581096,2293,2.3,"0"
"8152",64,8,49,585725,589384,3659,3.7,"0"
"8243",64,8,65,592610,595964,3354,3.4,"0"
"8343",64,4,53,597649,600822,3173,3.2,"0"
"8444",64,2,51,604052,606478,2426,2.4,"0"
"8550",64,7,24,610521,613732,3211,3.2,"20"
"8746",64,7,56,618452,620438,1986,2,"20"
"8850",64,4,69,622056,623896,1840,1.8,"0"
"8940",64,2,35,625635,627766,2131,2.1,"0"
"9053",64,4,61,629430,632524,3094,3.1,"0"
"9147",64,8,9,634460,637183,2723,2.7,"0"
"9347",64,1,74,641258,643970,2712,2.7,"20"
"9448",64,1,26,645756,648565,2809,2.8,"20"
"9648",64,6,7,652753,655318,2565,2.6,"0"
"9845",64,5,14,660313,662524,2211,2.2,"20"
"10039",64,5,78,668850,671951,3101,3.1,"20"
"10183",64,3,60,673600,675910,2310,2.3,"20"
"10247",64,8,17,678685,682098,3413,3.4,"0"
"10443",64,8,73,685962,689119,3157,3.2,"0"
"10547",64,7,8,690809,693160,2351,2.4,"20"
"10742",64,4,77,697871,700390,2519,2.5,"0"
"10845",64,1,58,704418,706743,2325,2.3,"20"
"10942",64,4,37,708406,712292,3886,3.9,"0"
"11045",64,7,64,714243,715981,1738,1.7,"20"
"11155",64,2,75,717530,719338,1808,1.8,"0"
"11247",64,6,55,720888,722944,2056,2.1,"0"
"11344",64,6,63,724560,726698,2138,2.1,"0"
"11445",64,6,39,728303,730374,2071,2.1,"0"
"11544",64,3,4,733719,736212,2493,2.5,"20"
"11741",64,4,5,740251,742728,2477,2.5,"0"
"11936",64,6,31,747183,749945,2762,2.8,"0"
"12142",64,2,67,756562,758516,1954,2,"0"
