"","subj","cond","item","start","end","duration_ms","duration_s","deg"
"10",1,5,69,4635046,4643337,8291,8.3,"20"
"11",1,8,32,4646477,4655398,8921,8.9,"0"
"13",1,3,51,4659568,4666852,7284,7.3,"20"
"14",1,4,4,4668879,4676379,7500,7.5,"0"
"16",1,7,55,4680312,4687764,7452,7.5,"20"
"17",1,7,23,4689848,4698823,8975,9,"20"
"19",1,8,72,4703109,4711507,8398,8.4,"0"
"20",1,5,29,4713012,4720233,7221,7.2,"20"
"22",1,1,57,4724729,4729539,4810,4.8,"20"
"23",1,4,76,4731773,4740510,8737,8.7,"0"
"24",1,7,63,4742659,4750827,8168,8.2,"20"
"25",1,6,30,4752444,4760270,7826,7.8,"0"
"27",1,3,27,4764448,4769330,4882,4.9,"20"
"29",1,2,42,4774563,4781927,7364,7.4,"0"
"30",1,6,62,4783337,4792272,8935,8.9,"0"
"31",1,7,71,4794651,4800026,5375,5.4,"20"
"32",1,8,48,4802080,4808554,6474,6.5,"0"
"33",1,8,56,4809871,4813275,3404,3.4,"0"
"34",1,3,3,4816561,4827988,11427,11.4,"20"
"36",1,7,31,4832044,4840786,8742,8.7,"20"
"38",1,3,11,4844531,4854597,10066,10.1,"20"
"40",1,6,6,4858410,4863838,5428,5.4,"0"
"42",1,1,17,4867929,4873538,5609,5.6,"20"
"44",1,7,39,4877345,4883939,6594,6.6,"20"
"45",1,6,54,4885512,4892713,7201,7.2,"0"
"46",1,4,44,4894618,4900783,6165,6.2,"0"
"47",1,3,59,4902291,4908360,6069,6.1,"20"
"48",1,5,21,4909578,4914438,4860,4.9,"20"
"50",1,8,8,4919440,4926327,6887,6.9,"0"
"52",1,4,20,4930993,4934683,3690,3.7,"0"
"54",1,4,12,4940088,4943392,3304,3.3,"0"
"56",1,3,19,4949931,4953064,3133,3.1,"20"
"58",1,2,58,4958921,4967355,8434,8.4,"0"
"59",1,8,40,4969135,4976477,7342,7.3,"0"
"60",1,2,50,4978011,4980907,2896,2.9,"0"
"61",1,1,25,4982430,4988763,6333,6.3,"20"
"63",1,8,24,4992844,4999165,6321,6.3,"0"
"65",1,4,52,5003719,5009008,5289,5.3,"0"
"66",1,4,60,5011470,5017931,6461,6.5,"0"
"67",1,8,80,5019540,5026492,6952,7,"0"
"68",1,7,79,5030107,5036259,6152,6.2,"20"
"69",1,5,37,5039536,5043131,3595,3.6,"20"
"70",1,6,70,5044844,5051188,6344,6.3,"0"
"71",1,1,33,5053447,5056803,3356,3.4,"20"
"72",1,1,41,5058882,5065082,6200,6.2,"20"
"73",1,4,28,5066829,5071397,4568,4.6,"0"
"75",1,3,75,5075764,5080531,4767,4.8,"20"
"76",1,1,49,5081822,5086875,5053,5.1,"20"
"77",1,6,78,5088718,5095466,6748,6.7,"0"
"78",1,7,47,5097262,5103248,5986,6,"20"
"79",1,5,13,5105679,5114706,9027,9,"20"
"81",1,6,22,5119001,5126489,7488,7.5,"0"
"83",1,3,43,5131758,5136521,4763,4.8,"20"
"84",1,2,10,5140167,5145377,5210,5.2,"0"
"86",1,3,67,5150011,5155355,5344,5.3,"20"
"87",1,8,64,5156764,5162629,5865,5.9,"0"
"88",1,1,9,5165483,5170069,4586,4.6,"20"
"90",1,5,45,5174439,5179630,5191,5.2,"20"
"91",1,2,18,5181099,5188810,7711,7.7,"0"
"93",1,2,34,5193824,5198326,4502,4.5,"0"
"94",1,5,5,5199918,5205733,5815,5.8,"20"
"96",1,5,61,5210186,5216926,6740,6.7,"20"
"97",1,7,7,5219916,5224437,4521,4.5,"20"
"99",1,1,1,5233589,5241454,7865,7.9,"20"
"101",1,4,68,5246486,5250219,3733,3.7,"0"
"102",1,6,38,5251893,5256368,4475,4.5,"0"
"103",1,2,2,5259335,5263474,4139,4.1,"0"
"105",1,6,46,5271786,5278945,7159,7.2,"0"
"106",1,7,15,5280524,5288175,7651,7.7,"20"
"108",1,2,66,5294375,5300216,5841,5.8,"0"
"109",1,8,16,5304667,5311801,7134,7.1,"0"
"111",1,5,53,5319473,5326011,6538,6.5,"20"
"112",1,2,26,5327540,5335490,7950,8,"0"
"114",1,2,74,5341951,5354351,12400,12.4,"0"
"115",1,6,14,5355839,5364351,8512,8.5,"0"
"117",1,1,73,5369610,5384756,15146,15.1,"20"
"118",1,5,77,5386639,5394351,7712,7.7,"20"
"119",1,1,65,5395920,5406340,10420,10.4,"20"
"120",1,3,35,5407844,5415853,8009,8,"20"
"121",1,4,36,5419657,5426168,6511,6.5,"0"
"1010",2,1,8,2343514,2348308,4794,4.8,"20"
"12",2,6,61,2355689,2360003,4314,4.3,"0"
"131",2,8,39,2363882,2370406,6524,6.5,"0"
"141",2,2,41,2372456,2376704,4248,4.2,"0"
"15",2,7,14,2380995,2386042,5047,5,"20"
"171",2,1,72,2395407,2399368,3961,4,"20"
"18",2,7,46,2401584,2405170,3586,3.6,"20"
"191",2,8,79,2410103,2413759,3656,3.7,"0"
"201",2,1,80,2419358,2422212,2854,2.9,"20"
"21",2,6,21,2424793,2428428,3635,3.6,"0"
"231",2,6,53,2437094,2441385,4291,4.3,"0"
"241",2,8,7,2445056,2448368,3312,3.3,"0"
"26",2,4,11,2457145,2459853,2708,2.7,"0"
"28",2,5,36,2469342,2476383,7041,7,"20"
"291",2,5,12,2481554,2485575,4021,4,"20"
"311",2,7,62,2494034,2498818,4784,4.8,"20"
"321",2,7,30,2502811,2506709,3898,3.9,"20"
"341",2,7,78,2513488,2516487,2999,3,"20"
"35",2,4,75,2519361,2522179,2818,2.8,"0"
"361",2,6,37,2524787,2527904,3117,3.1,"0"
"37",2,7,6,2534288,2537714,3426,3.4,"20"
"39",2,8,23,2545328,2548196,2868,2.9,"0"
"41",2,4,3,2556075,2558808,2733,2.7,"0"
"43",2,1,32,2566427,2569732,3305,3.3,"20"
"451",2,2,33,2574894,2577227,2333,2.3,"0"
"461",2,6,13,2580827,2584194,3367,3.4,"0"
"481",2,4,19,2589973,2592733,2760,2.8,"0"
"501",2,6,29,2601307,2604124,2817,2.8,"0"
"521",2,5,60,2611312,2614194,2882,2.9,"20"
"53",2,6,45,2617833,2620426,2593,2.6,"0"
"541",2,3,74,2624131,2627333,3202,3.2,"20"
"55",2,3,10,2633712,2637611,3899,3.9,"20"
"57",2,5,76,2646317,2650114,3797,3.8,"20"
"581",2,1,40,2654741,2657379,2638,2.6,"20"
"591",2,5,44,2662867,2665473,2606,2.6,"20"
"601",2,8,71,2671318,2673849,2531,2.5,"0"
"611",2,7,22,2682715,2688813,6098,6.1,"20"
"631",2,3,26,2697229,2701767,4538,4.5,"20"
"651",2,1,24,2708525,2712553,4028,4,"20"
"671",2,2,25,2724979,2728521,3542,3.5,"0"
"691",2,2,57,2735517,2739680,4163,4.2,"0"
"701",2,8,15,2745850,2748509,2659,2.7,"0"
"721",2,1,48,2752374,2756508,4134,4.1,"20"
"731",2,3,2,2762368,2765046,2678,2.7,"20"
"751",2,3,34,2776109,2780188,4079,4.1,"20"
"761",2,1,64,2784719,2787662,2943,2.9,"20"
"771",2,7,70,2795274,2800299,5025,5,"20"
"781",2,5,52,2802624,2805434,2810,2.8,"20"
"791",2,8,55,2810577,2813916,3339,3.3,"0"
"80",2,2,1,2818456,2821169,2713,2.7,"0"
"82",2,2,17,2833760,2837107,3347,3.3,"0"
"841",2,4,35,2840431,2843524,3093,3.1,"0"
"85",2,3,50,2845364,2847929,2565,2.6,"20"
"861",2,6,77,2851862,2855069,3207,3.2,"0"
"871",2,4,43,2857117,2860064,2947,2.9,"0"
"881",2,4,67,2863146,2867009,3863,3.9,"0"
"89",2,5,4,2869160,2872163,3003,3,"20"
"911",2,5,20,2879725,2882097,2372,2.4,"20"
"931",2,2,9,2891735,2894407,2672,2.7,"0"
"95",2,7,54,2898710,2902419,3709,3.7,"20"
"961",2,5,68,2907669,2911910,4241,4.2,"20"
"971",2,2,49,2916614,2918819,2205,2.2,"0"
"98",2,3,58,2923157,2926277,3120,3.1,"20"
"991",2,2,73,2935202,2942223,7021,7,"0"
"100",2,3,42,2945106,2948993,3887,3.9,"20"
"1011",2,4,59,2953052,2956288,3236,3.2,"0"
"1021",2,8,31,2967638,2973855,6217,6.2,"0"
"104",2,3,66,2982046,2985165,3119,3.1,"20"
"1051",2,8,63,2989959,2993927,3968,4,"0"
"1061",2,2,65,2999636,3004208,4572,4.6,"0"
"107",2,4,27,3007186,3010032,2846,2.8,"0"
"1091",2,6,69,3019916,3024511,4595,4.6,"0"
"110",2,1,16,3026757,3030182,3425,3.4,"20"
"1121",2,7,38,3037417,3043632,6215,6.2,"20"
"113",2,8,47,3046247,3048682,2435,2.4,"0"
"1141",2,6,5,3054012,3057261,3249,3.2,"0"
"116",2,4,51,3065724,3069494,3770,3.8,"0"
"1171",2,5,28,3073883,3078112,4229,4.2,"20"
"1191",2,3,18,3085732,3089697,3965,4,"20"
"1211",2,1,56,3095748,3099487,3739,3.7,"20"
"1012",3,1,63,28156326,28164485,8159,8.2,"20"
"1110",3,1,79,28166970,28174655,7685,7.7,"20"
"122",3,3,41,28176672,28181367,4695,4.7,"20"
"132",3,5,11,28183119,28188320,5201,5.2,"20"
"151",3,8,46,28195419,28199835,4416,4.4,"0"
"161",3,7,45,28201466,28206723,5257,5.3,"20"
"172",3,3,33,28215708,28220873,5165,5.2,"20"
"181",3,6,52,28223883,28232555,8672,8.7,"0"
"192",3,7,29,28234783,28239828,5045,5,"20"
"211",3,2,80,28259692,28264521,4829,4.8,"0"
"221",3,5,51,28269046,28276036,6990,7,"20"
"232",3,2,48,28278171,28282596,4425,4.4,"0"
"242",3,3,57,28295526,28301039,5513,5.5,"20"
"251",3,6,60,28303928,28310251,6323,6.3,"0"
"261",3,5,67,28316107,28328059,11952,12,"20"
"271",3,4,18,28332513,28336149,3636,3.6,"0"
"292",3,6,20,28361362,28366217,4855,4.9,"0"
"312",3,4,26,28377652,28382281,4629,4.6,"0"
"331",3,4,2,28405155,28412231,7076,7.1,"0"
"351",3,8,14,28418370,28425684,7314,7.3,"0"
"371",3,7,37,28432432,28436642,4210,4.2,"20"
"381",3,1,71,28438570,28442341,3771,3.8,"20"
"391",3,1,31,28447940,28452902,4962,5,"20"
"411",3,1,39,28471487,28475075,3588,3.6,"20"
"421",3,4,66,28482374,28487265,4891,4.9,"0"
"431",3,8,6,28494516,28499239,4723,4.7,"0"
"452",3,5,75,28533997,28538525,4528,4.5,"20"
"462",3,1,47,28542318,28546106,3788,3.8,"20"
"471",3,3,73,28549074,28553814,4740,4.7,"20"
"482",3,6,4,28555398,28558768,3370,3.4,"0"
"502",3,6,68,28563555,28566881,3326,3.3,"0"
"51",3,2,72,28569662,28573779,4117,4.1,"0"
"522",3,2,24,28576011,28579777,3766,3.8,"0"
"542",3,3,49,28588837,28591973,3136,3.1,"20"
"551",3,5,27,28594249,28598154,3905,3.9,"20"
"571",3,1,55,28603002,28606452,3450,3.5,"20"
"582",3,8,30,28608355,28610725,2370,2.4,"0"
"602",3,8,22,28615378,28618103,2725,2.7,"0"
"62",3,2,16,28622427,28625773,3346,3.3,"0"
"64",3,6,28,28632008,28635388,3380,3.4,"0"
"661",3,4,42,28642842,28646185,3343,3.3,"0"
"672",3,7,53,28648469,28652856,4387,4.4,"20"
"681",3,2,64,28656206,28658541,2335,2.3,"0"
"692",3,5,59,28660807,28663962,3155,3.2,"20"
"702",3,4,34,28666936,28671068,4132,4.1,"0"
"711",3,8,54,28673709,28677907,4198,4.2,"0"
"722",3,8,38,28680478,28685225,4747,4.7,"0"
"732",3,5,43,28687016,28690836,3820,3.8,"20"
"74",3,3,1,28693126,28696384,3258,3.3,"20"
"762",3,7,21,28701663,28705046,3383,3.4,"20"
"782",3,5,3,28710082,28713591,3509,3.5,"20"
"801",3,8,78,28719014,28722635,3621,3.6,"0"
"811",3,4,10,28724107,28728011,3904,3.9,"0"
"831",3,1,7,28735803,28740302,4499,4.5,"20"
"851",3,7,61,28747166,28752365,5199,5.2,"20"
"862",3,3,25,28753858,28757815,3957,4,"20"
"882",3,4,50,28770557,28773555,2998,3,"0"
"891",3,5,35,28774934,28778119,3185,3.2,"20"
"901",3,7,5,28780921,28783546,2625,2.6,"20"
"92",3,5,19,28790222,28793229,3007,3,"20"
"941",3,3,65,28799629,28804165,4536,4.5,"20"
"951",3,7,13,28805926,28808939,3013,3,"20"
"972",3,6,44,28813680,28816845,3165,3.2,"0"
"981",3,7,77,28818319,28821512,3193,3.2,"20"
"992",3,6,76,28824516,28827257,2741,2.7,"0"
"1001",3,7,69,28830114,28834545,4431,4.4,"20"
"1013",3,3,9,28836285,28840473,4188,4.2,"20"
"1031",3,1,15,28846184,28849218,3034,3,"20"
"1052",3,2,56,28853380,28857190,3810,3.8,"0"
"1062",3,6,36,28859894,28863890,3996,4,"0"
"1071",3,8,70,28867116,28871049,3933,3.9,"0"
"1081",3,6,12,28872352,28875150,2798,2.8,"0"
"1101",3,2,32,28881233,28883801,2568,2.6,"0"
"1122",3,4,58,28888495,28891763,3268,3.3,"0"
"1131",3,4,74,28893091,28896772,3681,3.7,"0"
"1142",3,2,8,28898821,28901153,2332,2.3,"0"
"1161",3,1,23,28906167,28908908,2741,2.7,"20"
"1181",3,8,62,28914523,28918977,4454,4.5,"0"
"1192",3,2,40,28923620,28926494,2874,2.9,"0"
"1201",3,3,17,28930691,28933730,3039,3,"20"
"1014",4,6,27,7341245,7344513,3268,3.3,"0"
"123",4,8,45,7348453,7352663,4210,4.2,"0"
"133",4,5,42,7360411,7365409,4998,5,"20"
"142",4,8,69,7368548,7371586,3038,3,"0"
"152",4,2,31,7375062,7379243,4181,4.2,"0"
"173",4,8,37,7383827,7387169,3342,3.3,"0"
"182",4,4,73,7390148,7396060,5912,5.9,"0"
"193",4,8,21,7397389,7401740,4351,4.4,"0"
"212",4,6,75,7406960,7409201,2241,2.2,"0"
"222",4,8,29,7411986,7414901,2915,2.9,"0"
"243",4,7,4,7418972,7421530,2558,2.6,"20"
"262",4,8,61,7426509,7429287,2778,2.8,"0"
"272",4,1,22,7433075,7437892,4817,4.8,"20"
"293",4,6,59,7445002,7448370,3368,3.4,"0"
"301",4,3,64,7453050,7456062,3012,3,"20"
"313",4,7,76,7462554,7465658,3104,3.1,"20"
"322",4,1,62,7471567,7474528,2961,3,"20"
"332",4,3,72,7478740,7482303,3563,3.6,"20"
"342",4,1,46,7486765,7490497,3732,3.7,"20"
"352",4,2,47,7494690,7496758,2068,2.1,"0"
"362",4,7,28,7500579,7503258,2679,2.7,"20"
"382",4,6,11,7509280,7511723,2443,2.4,"0"
"401",4,7,36,7520217,7522898,2681,2.7,"20"
"412",4,7,52,7525834,7528056,2222,2.2,"20"
"422",4,5,50,7531649,7533831,2182,2.2,"20"
"432",4,2,63,7541307,7544183,2876,2.9,"0"
"441",4,7,60,7549870,7552935,3065,3.1,"20"
"453",4,3,80,7559384,7562382,2998,3,"20"
"463",4,2,7,7565109,7567889,2780,2.8,"0"
"483",4,8,13,7573514,7576318,2804,2.8,"0"
"503",4,4,33,7580394,7582349,1955,2,"0"
"511",4,2,55,7584158,7587344,3186,3.2,"0"
"523",4,7,44,7591540,7594766,3226,3.2,"20"
"531",4,3,24,7596401,7599014,2613,2.6,"20"
"552",4,1,70,7604640,7607341,2701,2.7,"20"
"561",4,1,30,7610043,7612659,2616,2.6,"20"
"583",4,4,1,7617904,7621466,3562,3.6,"0"
"603",4,2,71,7629089,7632721,3632,3.6,"0"
"612",4,6,43,7637394,7639769,2375,2.4,"0"
"621",4,5,10,7641969,7645269,3300,3.3,"20"
"641",4,7,12,7655192,7658180,2988,3,"20"
"662",4,3,32,7671929,7676144,4215,4.2,"20"
"682",4,6,67,7682168,7685425,3257,3.3,"0"
"693",4,7,20,7687361,7689360,1999,2,"20"
"712",4,1,6,7702172,7705976,3804,3.8,"20"
"733",4,7,68,7711804,7714331,2527,2.5,"20"
"741",4,6,35,7719245,7721867,2622,2.6,"0"
"752",4,8,5,7726082,7729726,3644,3.6,"0"
"772",4,3,40,7735783,7738335,2552,2.6,"20"
"783",4,2,79,7741418,7746559,5141,5.1,"0"
"792",4,5,58,7749235,7752496,3261,3.3,"20"
"802",4,4,57,7755589,7758365,2776,2.8,"0"
"812",4,4,65,7762779,7766650,3871,3.9,"0"
"821",4,5,2,7769795,7772407,2612,2.6,"20"
"842",4,3,8,7781084,7784401,3317,3.3,"20"
"863",4,1,54,7789906,7792408,2502,2.5,"20"
"872",4,2,23,7800426,7802598,2172,2.2,"0"
"892",4,6,3,7810634,7813692,3058,3.1,"0"
"912",4,6,51,7818944,7822207,3263,3.3,"0"
"921",4,5,66,7824835,7827627,2792,2.8,"20"
"932",4,6,19,7830324,7834570,4246,4.2,"0"
"952",4,3,56,7840033,7842516,2483,2.5,"20"
"962",4,1,78,7847746,7850571,2825,2.8,"20"
"973",4,2,39,7854816,7857622,2806,2.8,"0"
"982",4,4,41,7860738,7862741,2003,2,"0"
"993",4,4,25,7868449,7870510,2061,2.1,"0"
"1015",4,3,48,7876404,7881562,5158,5.2,"20"
"1022",4,1,38,7885607,7889708,4101,4.1,"20"
"1032",4,2,15,7891857,7893989,2132,2.1,"0"
"1053",4,5,26,7901857,7904864,3007,3,"20"
"1072",4,4,17,7915069,7918482,3413,3.4,"0"
"1092",4,5,34,7923472,7927107,3635,3.6,"20"
"1102",4,4,49,7930507,7933131,2624,2.6,"0"
"1111",4,8,53,7937986,7944183,6197,6.2,"0"
"1123",4,3,16,7952346,7955861,3515,3.5,"20"
"1143",4,5,74,7960909,7963487,2578,2.6,"20"
"1151",4,1,14,7966636,7970117,3481,3.5,"20"
"1172",4,5,18,7976248,7982091,5843,5.8,"20"
"1193",4,8,77,7986911,7989438,2527,2.5,"0"
"1202",4,4,9,7996714,8000954,4240,4.2,"0"
"1016",5,3,23,4681666,4683494,1828,1.8,"20"
"124",5,7,43,4686893,4689870,2977,3,"20"
"134",5,2,70,4691314,4693656,2342,2.3,"0"
"143",5,5,17,4695557,4697804,2247,2.2,"20"
"162",5,3,63,4701654,4704233,2579,2.6,"20"
"174",5,4,32,4705784,4708406,2622,2.6,"0"
"194",5,1,45,4712087,4714183,2096,2.1,"20"
"202",5,1,53,4715834,4718375,2541,2.5,"20"
"213",5,2,30,4719927,4722054,2127,2.1,"0"
"233",5,4,24,4725443,4727968,2525,2.5,"0"
"252",5,4,40,4732595,4735438,2843,2.8,"0"
"263",5,2,78,4736971,4739090,2119,2.1,"0"
"273",5,8,12,4740676,4742748,2072,2.1,"0"
"294",5,7,51,4748238,4750803,2565,2.6,"20"
"302",5,2,62,4752125,4754286,2161,2.2,"0"
"314",5,6,2,4756680,4758960,2280,2.3,"0"
"333",5,8,52,4762679,4764755,2076,2.1,"0"
"343",5,5,57,4767554,4769746,2192,2.2,"20"
"353",5,8,44,4772368,4774652,2284,2.3,"0"
"363",5,1,5,4776228,4778458,2230,2.2,"20"
"383",5,6,58,4782845,4785298,2453,2.5,"0"
"392",5,5,9,4786857,4788945,2088,2.1,"20"
"413",5,7,19,4792907,4794661,1754,1.8,"20"
"433",5,1,61,4799285,4801442,2157,2.2,"20"
"442",5,1,21,4803310,4805455,2145,2.1,"20"
"464",5,5,73,4809270,4811430,2160,2.2,"20"
"472",5,4,8,4812985,4815416,2431,2.4,"0"
"49",5,3,15,4820831,4822911,2080,2.1,"20"
"512",5,5,65,4826125,4827928,1803,1.8,"20"
"524",5,6,42,4829526,4831885,2359,2.4,"0"
"532",5,4,56,4833561,4835642,2081,2.1,"0"
"543",5,2,54,4837851,4841708,3857,3.9,"0"
"553",5,8,4,4843182,4845658,2476,2.5,"0"
"572",5,4,16,4849337,4851233,1896,1.9,"0"
"592",5,7,35,4855422,4857344,1922,1.9,"20"
"604",5,4,80,4858880,4860769,1889,1.9,"0"
"613",5,2,14,4862424,4864961,2537,2.5,"0"
"632",5,6,10,4869536,4872339,2803,2.8,"0"
"652",5,7,3,4878425,4880842,2417,2.4,"20"
"673",5,1,37,4884357,4887926,3569,3.6,"20"
"683",5,1,69,4890039,4893217,3178,3.2,"20"
"694",5,4,64,4895164,4897352,2188,2.2,"0"
"703",5,3,31,4898749,4902277,3528,3.5,"20"
"723",5,8,60,4907038,4910731,3693,3.7,"0"
"734",5,7,11,4912727,4914653,1926,1.9,"20"
"753",5,5,33,4918650,4920641,1991,2,"20"
"763",5,7,67,4922152,4924659,2507,2.5,"20"
"773",5,2,46,4925947,4928442,2495,2.5,"0"
"784",5,6,18,4929723,4932318,2595,2.6,"0"
"803",5,2,6,4935980,4938830,2850,2.8,"0"
"822",5,8,76,4943543,4946595,3052,3.1,"0"
"832",5,3,79,4948012,4949946,1934,1.9,"20"
"843",5,8,36,4951646,4953437,1791,1.8,"0"
"852",5,8,68,4955360,4957114,1754,1.8,"0"
"864",5,5,1,4959310,4961260,1950,2,"20"
"883",5,7,59,4964458,4966387,1929,1.9,"20"
"893",5,3,55,4967967,4969989,2022,2,"20"
"902",5,6,34,4971991,4973795,1804,1.8,"0"
"913",5,3,39,4976709,4978667,1958,2,"20"
"922",5,2,22,4980311,4982135,1824,1.8,"0"
"942",5,2,38,4987398,4989490,2092,2.1,"0"
"953",5,5,49,4990964,4992821,1857,1.9,"20"
"963",5,3,71,4994558,4996275,1717,1.7,"20"
"974",5,4,72,4998633,5001267,2634,2.6,"0"
"983",5,1,77,5002913,5004914,2001,2,"20"
"994",5,7,75,5007080,5009585,2505,2.5,"20"
"1002",5,8,28,5011683,5014116,2433,2.4,"0"
"1023",5,5,25,5018646,5020973,2327,2.3,"20"
"1041",5,8,20,5024712,5027000,2288,2.3,"0"
"1063",5,6,66,5030953,5033405,2452,2.5,"0"
"1073",5,3,47,5035436,5037093,1657,1.7,"20"
"1082",5,1,13,5038535,5040612,2077,2.1,"20"
"1103",5,6,50,5043717,5045669,1952,2,"0"
"1112",5,1,29,5047609,5050021,2412,2.4,"20"
"1132",5,3,7,5053628,5055844,2216,2.2,"20"
"1152",5,6,26,5060696,5064802,4106,4.1,"0"
"1173",5,6,74,5068612,5072227,3615,3.6,"0"
"1182",5,4,48,5073829,5076054,2225,2.2,"0"
"1194",5,5,41,5077403,5080898,3495,3.5,"20"
"1203",5,7,27,5083059,5086720,3661,3.7,"20"
"1017",6,4,63,2749761,2753133,3372,3.4,"0"
"1113",6,5,32,2756588,2760864,4276,4.3,"20"
"135",6,4,79,2765617,2769166,3549,3.5,"0"
"144",6,1,28,2771159,2774119,2960,3,"20"
"163",6,3,30,2778751,2782204,3453,3.5,"20"
"183",6,8,43,2785818,2787821,2003,2,"0"
"195",6,5,64,2791091,2794586,3495,3.5,"20"
"203",6,2,21,2797008,2800212,3204,3.2,"0"
"223",6,1,44,2804189,2807066,2877,2.9,"20"
"234",6,7,50,2810693,2813226,2533,2.5,"20"
"244",6,8,51,2815757,2818396,2639,2.6,"0"
"253",6,6,41,2820040,2822285,2245,2.2,"0"
"264",6,5,80,2825997,2828747,2750,2.8,"20"
"274",6,2,77,2831519,2833992,2473,2.5,"0"
"281",6,6,33,2835343,2838008,2665,2.7,"0"
"295",6,5,8,2841022,2844294,3272,3.3,"20"
"315",6,1,36,2849851,2853193,3342,3.3,"20"
"323",6,3,70,2854562,2858647,4085,4.1,"20"
"334",6,5,40,2862449,2865060,2611,2.6,"20"
"344",6,7,2,2868203,2870739,2536,2.5,"20"
"364",6,5,48,2876226,2880500,4274,4.3,"20"
"372",6,7,42,2882557,2885945,3388,3.4,"20"
"384",6,6,65,2890139,2893050,2911,2.9,"0"
"393",6,3,22,2894835,2899697,4862,4.9,"20"
"414",6,2,5,2905727,2908335,2608,2.6,"0"
"434",6,3,62,2914766,2918664,3898,3.9,"20"
"443",6,8,27,2920679,2923892,3213,3.2,"0"
"465",6,1,60,2928189,2930973,2784,2.8,"20"
"473",6,2,37,2933960,2937521,3561,3.6,"0"
"484",6,5,24,2939767,2942893,3126,3.1,"20"
"504",6,2,61,2949012,2952072,3060,3.1,"0"
"513",6,5,56,2953961,2955866,1905,1.9,"20"
"525",6,4,39,2960748,2963696,2948,2.9,"0"
"533",6,3,46,2965385,2968917,3532,3.5,"20"
"544",6,2,13,2971965,2975301,3336,3.3,"0"
"562",6,2,53,2981115,2985503,4388,4.4,"0"
"573",6,8,3,2988722,2991428,2706,2.7,"0"
"593",6,4,55,2995436,2998423,2987,3,"0"
"605",6,8,59,3000702,3004254,3552,3.6,"0"
"614",6,1,52,3006802,3010363,3561,3.6,"20"
"622",6,3,54,3012595,3016031,3436,3.4,"20"
"633",6,1,12,3019225,3023324,4099,4.1,"20"
"653",6,8,19,3029851,3033811,3960,4,"0"
"674",6,4,23,3043495,3045787,2292,2.3,"0"
"695",6,1,68,3051546,3055671,4125,4.1,"20"
"704",6,6,9,3059419,3062068,2649,2.6,"0"
"724",6,6,49,3067268,3069239,1971,2,"0"
"735",6,5,16,3070504,3072599,2095,2.1,"20"
"754",6,1,4,3079617,3083297,3680,3.7,"20"
"774",6,3,38,3087994,3092062,4068,4.1,"20"
"785",6,8,35,3096960,3099884,2924,2.9,"0"
"793",6,4,31,3101262,3104612,3350,3.4,"0"
"813",6,3,78,3109565,3113389,3824,3.8,"20"
"823",6,3,14,3116480,3121946,5466,5.5,"20"
"844",6,8,75,3126256,3130115,3859,3.9,"0"
"853",6,7,18,3132236,3135385,3149,3.1,"20"
"873",6,6,1,3140292,3142564,2272,2.3,"0"
"894",6,8,67,3146824,3149435,2611,2.6,"0"
"903",6,7,10,3151359,3154386,3027,3,"20"
"923",6,4,15,3160961,3163946,2985,3,"0"
"943",6,2,29,3167564,3170474,2910,2.9,"0"
"964",6,7,66,3175097,3178231,3134,3.1,"20"
"975",6,4,7,3179710,3182321,2611,2.6,"0"
"995",6,8,11,3188467,3190766,2299,2.3,"0"
"1018",6,6,25,3194958,3197752,2794,2.8,"0"
"1033",6,7,26,3203892,3207378,3486,3.5,"20"
"1054",6,6,17,3212784,3216775,3991,4,"0"
"1074",6,3,6,3220433,3224442,4009,4,"20"
"1093",6,1,76,3230561,3234732,4171,4.2,"20"
"1104",6,7,74,3236044,3238841,2797,2.8,"20"
"1114",6,4,47,3241398,3243349,1951,2,"0"
"1124",6,1,20,3244757,3247447,2690,2.7,"20"
"1144",6,2,45,3252872,3254783,1911,1.9,"0"
"1153",6,6,73,3256470,3259217,2747,2.7,"0"
"1162",6,5,72,3263359,3265933,2574,2.6,"20"
"1174",6,7,34,3267304,3269756,2452,2.5,"20"
"1183",6,7,58,3271197,3273727,2530,2.5,"20"
"1195",6,4,71,3276601,3279131,2530,2.5,"0"
"1204",6,6,57,3282863,3285815,2952,3,"0"
"1212",6,2,69,3287233,3289380,2147,2.1,"0"
"1019",7,6,72,3026056,3031827,5771,5.8,"0"
"1115",7,1,35,3033551,3036552,3001,3,"20"
"125",7,1,51,3041893,3047800,5907,5.9,"20"
"136",7,2,52,3049698,3053905,4207,4.2,"0"
"145",7,8,42,3055597,3058534,2937,2.9,"0"
"153",7,3,13,3061422,3065291,3869,3.9,"20"
"175",7,2,36,3071388,3075948,4560,4.6,"0"
"184",7,2,60,3077650,3082165,4515,4.5,"0"
"196",7,2,4,3083557,3086079,2522,2.5,"0"
"214",7,2,68,3091969,3095556,3587,3.6,"0"
"224",7,4,30,3099383,3102968,3585,3.6,"0"
"245",7,3,29,3107869,3113851,5982,6,"20"
"265",7,4,38,3120454,3123168,2714,2.7,"0"
"275",7,6,56,3124892,3127649,2757,2.8,"0"
"282",7,4,46,3130305,3133343,3038,3,"0"
"296",7,3,37,3135586,3138200,2614,2.6,"20"
"303",7,6,16,3139819,3141854,2035,2,"0"
"324",7,2,44,3146684,3148440,1756,1.8,"0"
"335",7,8,26,3149972,3152737,2765,2.8,"0"
"354",7,2,76,3157081,3159364,2283,2.3,"0"
"365",7,2,28,3161982,3165506,3524,3.5,"0"
"385",7,8,18,3169879,3172070,2191,2.2,"0"
"402",7,3,53,3177302,3180945,3643,3.6,"20"
"415",7,8,10,3183149,3186743,3594,3.6,"0"
"435",7,5,23,3190904,3192730,1826,1.8,"20"
"454",7,1,3,3196641,3198745,2104,2.1,"20"
"474",7,5,63,3204188,3208788,4600,4.6,"20"
"485",7,3,5,3210940,3213062,2122,2.1,"20"
"505",7,5,55,3217826,3219905,2079,2.1,"20"
"514",7,1,27,3222455,3224583,2128,2.1,"20"
"534",7,1,75,3230878,3233123,2245,2.2,"20"
"545",7,7,49,3234980,3237323,2343,2.3,"20"
"554",7,7,73,3239370,3241737,2367,2.4,"20"
"563",7,2,20,3245119,3246360,1241,1.2,"0"
"584",7,5,71,3250937,3255935,4998,5,"20"
"594",7,4,14,3257735,3260197,2462,2.5,"0"
"615",7,3,45,3265599,3268588,2989,3,"20"
"623",7,7,33,3271331,3273166,1835,1.8,"20"
"634",7,3,69,3275186,3276833,1647,1.6,"20"
"642",7,7,65,3279247,3281898,2651,2.7,"20"
"654",7,3,21,3285407,3288199,2792,2.8,"20"
"675",7,6,64,3295866,3299390,3524,3.5,"0"
"684",7,8,2,3301420,3303836,2416,2.4,"0"
"705",7,6,24,3311830,3314056,2226,2.2,"0"
"725",7,4,62,3320322,3325262,4940,4.9,"0"
"736",7,7,57,3327186,3331634,4448,4.4,"20"
"742",7,5,39,3335425,3338535,3110,3.1,"20"
"755",7,7,1,3340637,3342315,1678,1.7,"20"
"775",7,6,8,3346302,3350155,3853,3.9,"0"
"794",7,6,40,3353778,3355039,1261,1.3,"0"
"804",7,5,31,3357967,3364406,6439,6.4,"20"
"824",7,8,74,3371328,3373441,2113,2.1,"0"
"833",7,1,59,3375425,3377981,2556,2.6,"20"
"845",7,1,19,3381056,3384579,3523,3.5,"20"
"865",7,7,9,3391089,3394528,3439,3.4,"20"
"884",7,7,25,3398860,3401785,2925,2.9,"20"
"904",7,2,12,3407662,3409381,1719,1.7,"0"
"924",7,4,22,3414278,3416626,2348,2.3,"0"
"944",7,8,66,3422733,3426028,3295,3.3,"0"
"954",7,8,58,3466632,3469894,3262,3.3,"0"
"965",7,4,6,3473058,3475316,2258,2.3,"0"
"984",7,6,48,3480256,3482275,2019,2,"0"
"996",7,1,11,3485043,3486852,1809,1.8,"20"
"10110",7,4,78,3490718,3493404,2686,2.7,"0"
"1024",7,1,67,3495649,3500038,4389,4.4,"20"
"1034",7,5,15,3501974,3503512,1538,1.5,"20"
"1055",7,8,50,3507997,3510024,2027,2,"0"
"1064",7,8,34,3513129,3520961,7832,7.8,"0"
"1075",7,4,54,3523049,3525212,2163,2.2,"0"
"1083",7,5,79,3526919,3528927,2008,2,"20"
"1094",7,5,7,3531566,3535948,4382,4.4,"20"
"1116",7,6,32,3543177,3546483,3306,3.3,"0"
"1133",7,4,70,3553035,3555569,2534,2.5,"0"
"1145",7,5,47,3557448,3559208,1760,1.8,"20"
"1154",7,1,43,3560852,3563506,2654,2.7,"20"
"1163",7,6,80,3566608,3568196,1588,1.6,"0"
"1175",7,7,41,3569786,3572095,2309,2.3,"20"
"1184",7,3,61,3574084,3576865,2781,2.8,"20"
"1196",7,3,77,3580084,3582222,2138,2.1,"20"
"1205",7,7,17,3584554,3587964,3410,3.4,"20"
"1020",8,4,53,1780552,1786738,6186,6.2,"0"
"1117",8,4,69,1791821,1794838,3017,3,"0"
"126",8,2,59,1798897,1803921,5024,5,"0"
"137",8,7,16,1806734,1809703,2969,3,"20"
"154",8,4,29,1816388,1821135,4747,4.7,"0"
"176",8,5,38,1827707,1832178,4471,4.5,"20"
"185",8,7,24,1835101,1839161,4060,4.1,"20"
"204",8,7,8,1845696,1849367,3671,3.7,"20"
"225",8,2,67,1855529,1860394,4865,4.9,"0"
"235",8,6,79,1863495,1868270,4775,4.8,"0"
"246",8,2,19,1871959,1875686,3727,3.7,"0"
"266",8,7,32,1882995,1887029,4034,4,"20"
"283",8,3,44,1892894,1895420,2526,2.5,"20"
"297",8,6,31,1897613,1901530,3917,3.9,"0"
"316",8,3,12,1909504,1914470,4966,5,"20"
"336",8,2,11,1919674,1922945,3271,3.3,"0"
"355",8,5,14,1928308,1931931,3623,3.6,"20"
"373",8,8,1,1936644,1939526,2882,2.9,"0"
"394",8,1,2,1945287,1948902,3615,3.6,"20"
"416",8,7,48,1955708,1963986,8278,8.3,"20"
"423",8,4,37,1967346,1970428,3082,3.1,"0"
"436",8,6,71,1976146,1979639,3493,3.5,"0"
"444",8,5,54,1983673,1986821,3148,3.1,"20"
"455",8,1,66,1993577,1997066,3489,3.5,"20"
"466",8,4,77,2001013,2006227,5214,5.2,"0"
"475",8,6,15,2009327,2011965,2638,2.6,"0"
"491",8,2,35,2018195,2021558,3363,3.4,"0"
"506",8,1,34,2025305,2028543,3238,3.2,"20"
"515",8,2,75,2032863,2035794,2931,2.9,"0"
"526",8,2,27,2039258,2043417,4159,4.2,"0"
"546",8,6,55,2049029,2051788,2759,2.8,"0"
"555",8,5,78,2054883,2057981,3098,3.1,"20"
"564",8,1,74,2061868,2065237,3369,3.4,"20"
"574",8,1,10,2067757,2070822,3065,3.1,"20"
"595",8,3,52,2076564,2079517,2953,3,"20"
"606",8,5,30,2090522,2093650,3128,3.1,"20"
"624",8,7,64,2127556,2131946,4390,4.4,"20"
"635",8,1,26,2136023,2139896,3873,3.9,"20"
"655",8,3,36,2144819,2148009,3190,3.2,"20"
"663",8,7,80,2149796,2152071,2275,2.3,"20"
"676",8,8,17,2154611,2158134,3523,3.5,"0"
"696",8,6,23,2163255,2166301,3046,3,"0"
"713",8,1,50,2171243,2174578,3335,3.3,"20"
"726",8,2,3,2177859,2180467,2608,2.6,"0"
"743",8,6,47,2184264,2187568,3304,3.3,"0"
"756",8,8,9,2191496,2195439,3943,3.9,"0"
"776",8,5,46,2200411,2205016,4605,4.6,"20"
"786",8,3,28,2206483,2210139,3656,3.7,"20"
"805",8,4,5,2218915,2222453,3538,3.5,"0"
"825",8,4,61,2228040,2233064,5024,5,"0"
"834",8,2,43,2234868,2238780,3912,3.9,"0"
"846",8,7,40,2240258,2242820,2562,2.6,"20"
"854",8,5,70,2245006,2248775,3769,3.8,"20"
"866",8,1,18,2250390,2253938,3548,3.5,"20"
"885",8,7,72,2260039,2263503,3464,3.5,"20"
"895",8,8,25,2265254,2268723,3469,3.5,"0"
"914",8,8,33,2274969,2278974,4005,4,"0"
"925",8,6,39,2281088,2284275,3187,3.2,"0"
"933",8,3,20,2286315,2289953,3638,3.6,"20"
"955",8,3,68,2294146,2296623,2477,2.5,"20"
"966",8,8,57,2298711,2301872,3161,3.2,"0"
"976",8,3,60,2303971,2306848,2877,2.9,"20"
"985",8,8,73,2310018,2313650,3632,3.6,"0"
"997",8,8,49,2315570,2318726,3156,3.2,"0"
"1003",8,4,21,2321365,2323886,2521,2.5,"0"
"1025",8,6,63,2328075,2331331,3256,3.3,"0"
"1035",8,3,4,2333049,2336433,3384,3.4,"20"
"1056",8,3,76,2342279,2346173,3894,3.9,"20"
"1065",8,5,22,2349514,2354304,4790,4.8,"20"
"1084",8,2,51,2360473,2363770,3297,3.3,"0"
"1095",8,7,56,2366211,2368323,2112,2.1,"20"
"1105",8,1,42,2370571,2373499,2928,2.9,"20"
"1118",8,5,62,2375478,2378673,3195,3.2,"20"
"1125",8,5,6,2380767,2384939,4172,4.2,"20"
"1146",8,6,7,2390713,2393421,2708,2.7,"0"
"1164",8,8,65,2399449,2402605,3156,3.2,"0"
"1176",8,8,41,2405120,2407687,2567,2.6,"0"
"1185",8,4,45,2410900,2414051,3151,3.2,"0"
"1197",8,1,58,2415950,2418842,2892,2.9,"20"
"1206",8,4,13,2420408,2423008,2600,2.6,"0"
"1026",9,4,52,9066560,9069696,3136,3.1,"0"
"1119",9,6,30,9072234,9076040,3806,3.8,"0"
"138",9,6,70,9079635,9083579,3944,3.9,"0"
"146",9,3,27,9085932,9089931,3999,4,"20"
"164",9,5,53,9095445,9101195,5750,5.8,"20"
"177",9,2,26,9102758,9106449,3691,3.7,"0"
"197",9,4,44,9110537,9114062,3525,3.5,"0"
"205",9,1,73,9115589,9119948,4359,4.4,"20"
"215",9,1,25,9121601,9125540,3939,3.9,"20"
"236",9,3,19,9129135,9132850,3715,3.7,"20"
"254",9,2,50,9139398,9143058,3660,3.7,"0"
"267",9,8,16,9144552,9147877,3325,3.3,"0"
"284",9,6,54,9152741,9156360,3619,3.6,"0"
"298",9,3,67,9157706,9162104,4398,4.4,"20"
"304",9,7,47,9163739,9167891,4152,4.2,"20"
"317",9,8,80,9169673,9172915,3242,3.2,"0"
"325",9,1,49,9174972,9179024,4052,4.1,"20"
"337",9,8,56,9181206,9185028,3822,3.8,"0"
"345",9,5,37,9188152,9192154,4002,4,"20"
"356",9,1,41,9193496,9199013,5517,5.5,"20"
"366",9,2,42,9200711,9204664,3953,4,"0"
"374",9,2,34,9207197,9212106,4909,4.9,"0"
"386",9,2,58,9213493,9216740,3247,3.2,"0"
"395",9,1,57,9218313,9221322,3009,3,"20"
"403",9,7,31,9222567,9226646,4079,4.1,"20"
"424",9,7,71,9232815,9237377,4562,4.6,"20"
"437",9,7,79,9238792,9243050,4258,4.3,"20"
"445",9,3,43,9244346,9247318,2972,3,"20"
"456",9,7,55,9250630,9254436,3806,3.8,"20"
"467",9,4,28,9257208,9261178,3970,4,"0"
"486",9,6,14,9265153,9269276,4123,4.1,"0"
"507",9,2,66,9274451,9278152,3701,3.7,"0"
"516",9,8,72,9279682,9282848,3166,3.2,"0"
"527",9,4,60,9285560,9288856,3296,3.3,"0"
"535",9,1,17,9291063,9295573,4510,4.5,"20"
"556",9,2,10,9300677,9305555,4878,4.9,"0"
"575",9,5,13,9310481,9315718,5237,5.2,"20"
"596",9,1,65,9319621,9324052,4431,4.4,"20"
"607",9,5,69,9326527,9331231,4704,4.7,"20"
"616",9,4,36,9335382,9341722,6340,6.3,"0"
"625",9,8,48,9344224,9349016,4792,4.8,"0"
"636",9,2,2,9350445,9353463,3018,3,"0"
"656",9,6,78,9360333,9363700,3367,3.4,"0"
"664",9,6,62,9365043,9367629,2586,2.6,"0"
"677",9,3,59,9370321,9373846,3525,3.5,"20"
"685",9,3,11,9375643,9379333,3690,3.7,"20"
"706",9,6,46,9383409,9386631,3222,3.2,"0"
"714",9,7,39,9390525,9394289,3764,3.8,"20"
"727",9,3,3,9395636,9398712,3076,3.1,"20"
"744",9,4,20,9403989,9408482,4493,4.5,"0"
"764",9,7,23,9413543,9417448,3905,3.9,"20"
"787",9,3,51,9422284,9424980,2696,2.7,"20"
"795",9,6,6,9427170,9430033,2863,2.9,"0"
"814",9,4,68,9435011,9438228,3217,3.2,"0"
"826",9,8,24,9441492,9444965,3473,3.5,"0"
"847",9,8,8,9450749,9454464,3715,3.7,"0"
"867",9,8,32,9458634,9462040,3406,3.4,"0"
"886",9,1,33,9468612,9471019,2407,2.4,"20"
"896",9,7,7,9472442,9475924,3482,3.5,"20"
"915",9,4,76,9480743,9484504,3761,3.8,"0"
"926",9,5,5,9486125,9490286,4161,4.2,"20"
"945",9,8,40,9495144,9499117,3973,4,"0"
"956",9,5,61,9500522,9504103,3581,3.6,"20"
"967",9,2,74,9506452,9509718,3266,3.3,"0"
"977",9,5,77,9511825,9515562,3737,3.7,"20"
"986",9,8,64,9517861,9521106,3245,3.2,"0"
"998",9,3,75,9523293,9528184,4891,4.9,"20"
"1004",9,1,1,9530192,9532900,2708,2.7,"20"
"1027",9,7,63,9536796,9540039,3243,3.2,"20"
"1036",9,4,12,9541650,9545501,3851,3.9,"0"
"1057",9,2,18,9550013,9552911,2898,2.9,"0"
"1076",9,5,45,9558418,9562025,3607,3.6,"20"
"1085",9,3,35,9565068,9568381,3313,3.3,"20"
"1096",9,6,38,9573149,9579204,6055,6.1,"0"
"1106",9,7,15,9582802,9585486,2684,2.7,"20"
"1126",9,6,22,9589902,9595207,5305,5.3,"0"
"1147",9,5,21,9599556,9602657,3101,3.1,"20"
"1165",9,5,29,9608156,9611817,3661,3.7,"20"
"1186",9,1,9,9618433,9623398,4965,5,"20"
"1207",9,4,4,9628906,9632172,3266,3.3,"0"
"1028",10,7,38,14155526,14166586,11060,11.1,"20"
"1120",10,1,24,14168414,14176335,7921,7.9,"20"
"139",10,4,43,14182314,14186532,4218,4.2,"0"
"147",10,1,56,14189281,14193641,4360,4.4,"20"
"155",10,2,65,14196390,14200734,4344,4.3,"0"
"165",10,4,19,14203006,14206808,3802,3.8,"0"
"186",10,5,60,14218799,14224797,5998,6,"20"
"198",10,1,8,14227278,14231316,4038,4,"20"
"216",10,5,36,14235634,14241095,5461,5.5,"20"
"226",10,8,23,14243490,14246074,2584,2.6,"0"
"247",10,3,66,14250904,14260678,9774,9.8,"20"
"255",10,8,63,14263968,14268871,4903,4.9,"0"
"268",10,4,27,14274257,14277364,3107,3.1,"0"
"285",10,3,42,14286396,14295269,8873,8.9,"20"
"299",10,1,40,14297594,14305723,8129,8.1,"20"
"305",10,3,10,14311883,14321152,9269,9.3,"20"
"326",10,7,22,14325650,14333692,8042,8,"20"
"346",10,2,25,14337978,14341412,3434,3.4,"0"
"367",10,8,15,14345668,14347727,2059,2.1,"0"
"387",10,6,37,14352649,14356721,4072,4.1,"0"
"396",10,4,67,14358965,14363049,4084,4.1,"0"
"404",10,3,58,14366102,14373225,7123,7.1,"20"
"417",10,2,41,14375314,14378687,3373,3.4,"0"
"425",10,5,20,14380695,14383527,2832,2.8,"20"
"446",10,8,55,14390111,14393468,3357,3.4,"0"
"457",10,7,14,14395778,14402193,6415,6.4,"20"
"476",10,5,68,14409408,14412957,3549,3.5,"20"
"487",10,3,2,14415935,14420880,4945,4.9,"20"
"508",10,5,28,14425489,14433083,7594,7.6,"20"
"528",10,5,76,14438368,14444947,6579,6.6,"20"
"536",10,2,49,14447676,14450409,2733,2.7,"0"
"547",10,8,7,14453034,14456240,3206,3.2,"0"
"565",10,7,54,14464819,14471427,6608,6.6,"20"
"576",10,4,51,14474268,14477205,2937,2.9,"0"
"585",10,5,52,14480052,14486176,6124,6.1,"20"
"597",10,4,11,14488499,14490752,2253,2.3,"0"
"617",10,6,77,14496642,14499483,2841,2.8,"0"
"626",10,4,59,14501733,14505221,3488,3.5,"0"
"637",10,7,62,14508855,14516797,7942,7.9,"20"
"643",10,2,57,14518860,14522547,3687,3.7,"0"
"657",10,1,32,14525171,14532534,7363,7.4,"20"
"678",10,6,29,14544399,14548295,3896,3.9,"0"
"697",10,8,79,14553651,14557828,4177,4.2,"0"
"707",10,5,12,14560280,14564089,3809,3.8,"20"
"728",10,3,26,14569554,14574667,5113,5.1,"20"
"745",10,2,17,14582151,14585313,3162,3.2,"0"
"765",10,6,53,14592129,14598095,5966,6,"0"
"777",10,7,6,14600966,14607382,6416,6.4,"20"
"796",10,8,39,14613360,14616131,2771,2.8,"0"
"806",10,7,78,14621845,14627445,5600,5.6,"20"
"815",10,4,75,14629808,14632364,2556,2.6,"0"
"827",10,4,3,14635114,14638875,3761,3.8,"0"
"848",10,1,64,14643541,14647539,3998,4,"20"
"855",10,2,9,14650681,14654427,3746,3.7,"0"
"874",10,2,73,14659286,14662689,3403,3.4,"0"
"887",10,6,21,14664939,14668017,3078,3.1,"0"
"905",10,3,18,14674392,14680685,6293,6.3,"20"
"927",10,7,70,14686136,14694741,8605,8.6,"20"
"934",10,7,30,14697828,14701630,3802,3.8,"20"
"957",10,5,44,14706456,14713063,6607,6.6,"20"
"968",10,1,16,14716671,14720425,3754,3.8,"20"
"987",10,3,74,14726257,14731133,4876,4.9,"20"
"999",10,6,61,14733274,14736636,3362,3.4,"0"
"1005",10,1,48,14738873,14745090,6217,6.2,"20"
"10111",10,1,80,14746891,14750919,4028,4,"20"
"1029",10,7,46,14755241,14759918,4677,4.7,"20"
"1037",10,3,34,14763998,14769978,5980,6,"20"
"1042",10,4,35,14774452,14777372,2920,2.9,"0"
"1058",10,2,33,14780250,14783168,2918,2.9,"0"
"1066",10,2,1,14785972,14788232,2260,2.3,"0"
"1086",10,8,71,14793010,14795064,2054,2.1,"0"
"1097",10,3,50,14798032,14801461,3429,3.4,"20"
"1107",10,1,72,14804821,14809994,5173,5.2,"20"
"11110",10,6,13,14813522,14816350,2828,2.8,"0"
"1134",10,6,5,14821582,14825739,4157,4.2,"0"
"1155",10,8,47,14831183,14833386,2203,2.2,"0"
"1166",10,6,69,14835663,14838567,2904,2.9,"0"
"1177",10,5,4,14840280,14844890,4610,4.6,"20"
"1198",10,8,31,14850025,14853992,3967,4,"0"
"1213",10,6,45,14859524,14861845,2321,2.3,"0"
"1030",11,7,13,16516393,16522135,5742,5.7,"20"
"127",11,1,55,16526061,16530561,4500,4.5,"20"
"1310",11,7,53,16533830,16539007,5177,5.2,"20"
"148",11,6,28,16540669,16545104,4435,4.4,"0"
"166",11,7,61,16550584,16556796,6212,6.2,"20"
"178",11,8,70,16558609,16562145,3536,3.5,"0"
"187",11,3,17,16564337,16567956,3619,3.6,"20"
"206",11,3,1,16572088,16575164,3076,3.1,"20"
"227",11,6,60,16579092,16584072,4980,5,"0"
"237",11,4,26,16585903,16588912,3009,3,"0"
"256",11,3,49,16593318,16596239,2921,2.9,"20"
"269",11,6,44,16598982,16602955,3973,4,"0"
"276",11,8,22,16607291,16611797,4506,4.5,"0"
"2910",11,6,76,16615911,16622116,6205,6.2,"0"
"306",11,2,16,16628817,16632123,3306,3.3,"0"
"327",11,5,51,16638682,16642067,3385,3.4,"20"
"338",11,4,2,16645819,16649781,3962,4,"0"
"357",11,7,29,16654678,16657898,3220,3.2,"20"
"375",11,8,30,16662467,16664976,2509,2.5,"0"
"397",11,1,31,16669880,16673648,3768,3.8,"20"
"418",11,8,62,16677865,16682463,4598,4.6,"0"
"426",11,3,25,16686100,16688734,2634,2.6,"20"
"447",11,3,57,16692766,16695881,3115,3.1,"20"
"458",11,6,12,16697508,16700393,2885,2.9,"0"
"477",11,2,72,16705462,16708901,3439,3.4,"0"
"488",11,5,19,16711404,16713537,2133,2.1,"20"
"509",11,8,38,16720935,16724102,3167,3.2,"0"
"517",11,8,6,16736885,16742335,5450,5.5,"0"
"537",11,1,23,16749217,16751134,1917,1.9,"20"
"557",11,5,35,16754454,16759989,5535,5.5,"20"
"566",11,4,66,16766262,16769085,2823,2.8,"0"
"577",11,4,74,16771267,16775031,3764,3.8,"0"
"586",11,4,34,16777296,16780838,3542,3.5,"0"
"598",11,7,77,16782518,16785518,3000,3,"20"
"608",11,2,48,16788726,16792720,3994,4,"0"
"618",11,5,27,16794619,16797814,3195,3.2,"20"
"638",11,3,73,16803394,16806314,2920,2.9,"20"
"644",11,4,10,16811507,16814944,3437,3.4,"0"
"665",11,2,32,16820113,16822921,2808,2.8,"0"
"686",11,1,47,16826445,16829043,2598,2.6,"20"
"698",11,1,39,16831630,16834617,2987,3,"20"
"708",11,2,8,16839401,16843641,4240,4.2,"0"
"729",11,8,46,16849903,16853067,3164,3.2,"0"
"737",11,1,15,16859526,16861458,1932,1.9,"20"
"757",11,2,64,16866376,16869211,2835,2.8,"0"
"766",11,5,3,16892287,16894937,2650,2.6,"20"
"788",11,4,58,16900820,16903440,2620,2.6,"0"
"797",11,8,14,16905310,16908825,3515,3.5,"0"
"816",11,1,79,16913184,16917002,3818,3.8,"20"
"828",11,1,63,16918500,16921896,3396,3.4,"20"
"835",11,4,42,16923983,16926801,2818,2.8,"0"
"849",11,7,5,16928348,16931604,3256,3.3,"20"
"868",11,5,67,16935679,16940183,4504,4.5,"20"
"875",11,1,7,16941829,16944527,2698,2.7,"20"
"897",11,6,4,16949259,16951592,2333,2.3,"0"
"916",11,3,33,16954771,16957604,2833,2.8,"20"
"928",11,3,9,16962767,16967317,4550,4.5,"20"
"946",11,7,69,16970872,16973454,2582,2.6,"20"
"958",11,2,40,16975622,16978120,2498,2.5,"0"
"969",11,8,54,16979415,16982731,3316,3.3,"0"
"978",11,6,68,16983963,16986768,2805,2.8,"0"
"988",11,2,24,16989161,16992481,3320,3.3,"0"
"1006",11,3,65,16997370,17000841,3471,3.5,"20"
"10112",11,2,56,17002030,17004330,2300,2.3,"0"
"10210",11,8,78,17005676,17008189,2513,2.5,"0"
"1038",11,5,75,17009536,17011776,2240,2.2,"20"
"1043",11,2,80,17013926,17016497,2571,2.6,"0"
"1059",11,1,71,17017995,17020582,2587,2.6,"20"
"1067",11,4,50,17022368,17024455,2087,2.1,"0"
"1077",11,5,11,17026329,17028997,2668,2.7,"20"
"1098",11,6,52,17032794,17036435,3641,3.6,"0"
"1108",11,5,43,17037697,17039988,2291,2.3,"20"
"11111",11,6,36,17041393,17045193,3800,3.8,"0"
"1127",11,3,41,17047256,17052202,4946,4.9,"20"
"1135",11,6,20,17053738,17056644,2906,2.9,"0"
"1156",11,5,59,17060097,17063787,3690,3.7,"20"
"1167",11,4,18,17066243,17070590,4347,4.3,"0"
"1187",11,7,37,17074367,17077488,3121,3.1,"20"
"1199",11,7,45,17079176,17081496,2320,2.3,"20"
"1208",11,7,21,17083579,17086422,2843,2.8,"20"
"1039",12,4,33,27990378,27993713,3335,3.3,"0"
"1128",12,7,4,27995666,27999733,4067,4.1,"20"
"1311",12,1,30,28003757,28006741,2984,3,"20"
"156",12,4,9,28011407,28014949,3542,3.5,"0"
"179",12,8,69,28019537,28023919,4382,4.4,"0"
"188",12,3,16,28025881,28029842,3961,4,"20"
"207",12,3,40,28034272,28037628,3356,3.4,"20"
"217",12,4,73,28039146,28043128,3982,4,"0"
"228",12,5,10,28045186,28048832,3646,3.6,"20"
"248",12,2,63,28053683,28057037,3354,3.4,"0"
"257",12,5,18,28058644,28061516,2872,2.9,"20"
"277",12,8,5,28064945,28068839,3894,3.9,"0"
"2911",12,1,54,28075032,28078989,3957,4,"20"
"307",12,6,35,28080499,28084105,3606,3.6,"0"
"318",12,2,15,28085703,28088104,2401,2.4,"0"
"339",12,4,41,28093841,28097079,3238,3.2,"0"
"347",12,6,19,28098666,28101554,2888,2.9,"0"
"368",12,8,53,28107238,28111594,4356,4.4,"0"
"376",12,6,75,28113052,28116488,3436,3.4,"0"
"388",12,7,76,28117846,28121352,3506,3.5,"20"
"398",12,6,51,28124312,28127303,2991,3,"0"
"405",12,5,2,28128929,28131962,3033,3,"20"
"427",12,3,48,28137652,28141379,3727,3.7,"20"
"438",12,7,68,28144318,28147350,3032,3,"20"
"448",12,3,72,28148687,28152530,3843,3.8,"20"
"459",12,1,14,28154291,28157731,3440,3.4,"20"
"478",12,3,24,28162591,28166717,4126,4.1,"20"
"492",12,6,27,28171436,28174390,2954,3,"0"
"518",12,8,37,28178311,28181459,3148,3.1,"0"
"529",12,7,12,28182796,28185942,3146,3.1,"20"
"548",12,1,22,28190110,28193150,3040,3,"20"
"567",12,5,26,28197606,28201080,3474,3.5,"20"
"587",12,1,46,28206139,28210437,4298,4.3,"20"
"599",12,2,7,28211859,28215051,3192,3.2,"0"
"619",12,5,66,28220295,28223512,3217,3.2,"20"
"627",12,1,78,28225018,28228127,3109,3.1,"20"
"639",12,4,65,28229639,28232750,3111,3.1,"0"
"645",12,8,77,28234382,28237189,2807,2.8,"0"
"658",12,2,79,28238745,28241470,2725,2.7,"0"
"666",12,5,74,28242824,28246310,3486,3.5,"20"
"679",12,1,38,28248882,28252920,4038,4,"20"
"687",12,1,62,28254845,28259181,4336,4.3,"20"
"699",12,3,8,28260626,28264108,3482,3.5,"20"
"715",12,4,49,28267937,28270632,2695,2.7,"0"
"7210",12,2,39,28272147,28275124,2977,3,"0"
"738",12,7,28,28276472,28279808,3336,3.3,"20"
"758",12,4,1,28283757,28286616,2859,2.9,"0"
"778",12,4,17,28290492,28294258,3766,3.8,"0"
"798",12,4,57,28298104,28301912,3808,3.8,"0"
"807",12,2,23,28303455,28305622,2167,2.2,"0"
"829",12,8,45,28309578,28312384,2806,2.8,"0"
"836",12,8,21,28314228,28317728,3500,3.5,"0"
"856",12,7,20,28322825,28325740,2915,2.9,"20"
"876",12,2,47,28330102,28333111,3009,3,"0"
"888",12,8,29,28334393,28337292,2899,2.9,"0"
"906",12,2,31,28341018,28345197,4179,4.2,"0"
"929",12,6,59,28348958,28352004,3046,3,"0"
"935",12,5,34,28354553,28358348,3795,3.8,"20"
"947",12,1,70,28359782,28362979,3197,3.2,"20"
"959",12,1,6,28364345,28368594,4249,4.2,"20"
"979",12,3,56,28372292,28375130,2838,2.8,"20"
"989",12,6,3,28376457,28379355,2898,2.9,"0"
"1007",12,8,61,28383533,28386901,3368,3.4,"0"
"10113",12,7,36,28388399,28391267,2868,2.9,"20"
"10211",12,3,80,28392668,28395121,2453,2.5,"20"
"10310",12,6,11,28396803,28399706,2903,2.9,"0"
"10510",12,5,58,28404449,28407169,2720,2.7,"20"
"1068",12,3,32,28408756,28412095,3339,3.3,"20"
"1087",12,6,43,28416589,28419045,2456,2.5,"0"
"1099",12,7,52,28420555,28422996,2441,2.4,"20"
"1109",12,5,50,28424567,28427303,2736,2.7,"20"
"11112",12,7,44,28428549,28431782,3233,3.2,"20"
"1129",12,5,42,28433320,28436693,3373,3.4,"20"
"1136",12,2,55,28438770,28441983,3213,3.2,"0"
"1148",12,6,67,28443312,28446621,3309,3.3,"0"
"1157",12,2,71,28447997,28451162,3165,3.2,"0"
"1168",12,7,60,28453606,28456576,2970,3,"20"
"1178",12,4,25,28458174,28461058,2884,2.9,"0"
"11910",12,3,64,28464857,28468468,3611,3.6,"20"
"1209",12,8,13,28469758,28473427,3669,3.7,"0"
"1040",13,5,33,1812336,1816171,3835,3.8,"20"
"1130",13,5,17,1817846,1823162,5316,5.3,"20"
"1312",13,2,6,1826955,1833135,6180,6.2,"0"
"157",13,5,25,1837376,1840965,3589,3.6,"20"
"1710",13,1,5,1845352,1850144,4792,4.8,"20"
"199",13,5,41,1854834,1860056,5222,5.2,"20"
"208",13,7,51,1861516,1865051,3535,3.5,"20"
"218",13,7,19,1867333,1870004,2671,2.7,"20"
"238",13,6,2,1876193,1880486,4293,4.3,"0"
"258",13,1,45,1885774,1888887,3113,3.1,"20"
"2610",13,8,20,1890623,1893667,3044,3,"0"
"286",13,6,58,1897760,1900572,2812,2.8,"0"
"2912",13,8,4,1903973,1907718,3745,3.7,"0"
"319",13,3,31,1912179,1917307,5128,5.1,"20"
"3310",13,2,62,1924598,1929550,4952,5,"0"
"348",13,6,10,1931243,1935429,4186,4.2,"0"
"369",13,4,40,1939768,1943130,3362,3.4,"0"
"377",13,4,48,1946850,1951653,4803,4.8,"0"
"389",13,2,70,1953864,1958306,4442,4.4,"0"
"399",13,8,76,1962972,1967087,4115,4.1,"0"
"406",13,4,56,1970328,1973394,3066,3.1,"0"
"419",13,8,36,1975780,1979573,3793,3.8,"0"
"428",13,1,69,1983375,1987612,4237,4.2,"20"
"439",13,1,53,1992550,1998864,6314,6.3,"20"
"449",13,5,49,2001914,2005380,3466,3.5,"20"
"4510",13,1,13,2006931,2011317,4386,4.4,"20"
"479",13,3,23,2015709,2019853,4144,4.1,"20"
"493",13,2,22,2023790,2028809,5019,5,"0"
"519",13,3,7,2032846,2036275,3429,3.4,"20"
"538",13,4,72,2040569,2045039,4470,4.5,"0"
"549",13,7,43,2047647,2050887,3240,3.2,"20"
"558",13,3,71,2052571,2055300,2729,2.7,"20"
"568",13,3,15,2057718,2061029,3311,3.3,"20"
"588",13,1,29,2065498,2071282,5784,5.8,"20"
"609",13,2,38,2075625,2079144,3519,3.5,"0"
"6110",13,8,52,2083795,2087347,3552,3.6,"0"
"628",13,2,30,2089811,2092760,2949,2.9,"0"
"646",13,4,8,2097037,2099902,2865,2.9,"0"
"667",13,5,57,2105446,2108912,3466,3.5,"20"
"6710",13,8,12,2110718,2113518,2800,2.8,"0"
"6910",13,3,55,2118016,2122172,4156,4.2,"20"
"709",13,2,54,2124589,2128724,4135,4.1,"0"
"716",13,3,39,2131567,2135932,4365,4.4,"20"
"7211",13,7,75,2137412,2141423,4011,4,"20"
"739",13,8,44,2145350,2149678,4328,4.3,"0"
"746",13,4,24,2151210,2155751,4541,4.5,"0"
"767",13,5,1,2162139,2167733,5594,5.6,"20"
"789",13,4,80,2174197,2177470,3273,3.3,"0"
"799",13,7,11,2179078,2183066,3988,4,"20"
"817",13,3,47,2187817,2190733,2916,2.9,"20"
"8210",13,6,42,2193073,2197183,4110,4.1,"0"
"837",13,8,28,2200477,2204362,3885,3.9,"0"
"857",13,3,63,2208864,2212246,3382,3.4,"20"
"869",13,4,32,2215110,2218597,3487,3.5,"0"
"889",13,7,59,2223107,2228226,5119,5.1,"20"
"898",13,7,67,2230628,2234578,3950,4,"20"
"907",13,6,34,2236323,2240101,3778,3.8,"0"
"917",13,5,65,2241706,2245784,4078,4.1,"20"
"9210",13,4,64,2248389,2252382,3993,4,"0"
"936",13,5,9,2257848,2262705,4857,4.9,"20"
"9510",13,7,27,2268352,2272600,4248,4.2,"20"
"9710",13,2,78,2280680,2284093,3413,3.4,"0"
"9810",13,6,74,2286174,2290245,4071,4.1,"0"
"9910",13,6,18,2292032,2294784,2752,2.8,"0"
"10114",13,1,21,2299493,2302846,3353,3.4,"20"
"10311",13,8,68,2307559,2311196,3637,3.6,"0"
"1044",13,6,66,2313290,2316571,3281,3.3,"0"
"10511",13,1,77,2320493,2325184,4691,4.7,"20"
"1069",13,2,14,2327004,2330462,3458,3.5,"0"
"1088",13,3,79,2334950,2338899,3949,3.9,"20"
"10910",13,4,16,2340641,2344398,3757,3.8,"0"
"11113",13,5,73,2350696,2354892,4196,4.2,"20"
"11210",13,8,60,2358073,2362670,4597,4.6,"0"
"1137",13,2,46,2365137,2369172,4035,4,"0"
"1149",13,6,50,2372665,2374840,2175,2.2,"0"
"1158",13,7,3,2376773,2380211,3438,3.4,"20"
"1179",13,6,26,2384525,2387902,3377,3.4,"0"
"11911",13,1,61,2392408,2396823,4415,4.4,"20"
"12010",13,7,35,2399646,2403089,3443,3.4,"20"
"1214",13,1,37,2406326,2411063,4737,4.7,"20"
"1045",14,1,76,4222420,4228408,5988,6,"20"
"1138",14,6,25,4230454,4234685,4231,4.2,"0"
"1313",14,6,49,4239684,4243890,4206,4.2,"0"
"149",14,2,61,4246284,4253458,7174,7.2,"0"
"158",14,6,9,4255296,4260506,5210,5.2,"0"
"1711",14,5,32,4264508,4268767,4259,4.3,"20"
"1910",14,6,33,4273490,4278200,4710,4.7,"0"
"209",14,3,22,4280200,4288695,8495,8.5,"20"
"229",14,3,54,4292563,4297607,5044,5,"20"
"239",14,7,18,4299896,4304103,4207,4.2,"20"
"259",14,2,69,4308438,4311540,3102,3.1,"0"
"2611",14,5,40,4313231,4318274,5043,5,"20"
"278",14,1,12,4320372,4323576,3204,3.2,"20"
"2913",14,5,16,4328542,4331931,3389,3.4,"20"
"3110",14,2,29,4336357,4340818,4461,4.5,"0"
"3311",14,8,43,4346228,4350519,4291,4.3,"0"
"349",14,7,58,4352718,4356662,3944,3.9,"20"
"358",14,8,75,4358759,4361935,3176,3.2,"0"
"3610",14,7,50,4364141,4370094,5953,6,"20"
"378",14,3,78,4372585,4376811,4226,4.2,"20"
"3810",14,8,11,4378444,4383212,4768,4.8,"0"
"407",14,8,59,4387369,4392625,5256,5.3,"0"
"4110",14,4,55,4395032,4399272,4240,4.2,"0"
"429",14,6,41,4401273,4404702,3429,3.4,"0"
"4310",14,7,42,4406338,4412927,6589,6.6,"20"
"4410",14,3,62,4415670,4422155,6485,6.5,"20"
"4511",14,3,30,4424748,4428539,3791,3.8,"20"
"4710",14,4,7,4432445,4436861,4416,4.4,"0"
"494",14,3,14,4441594,4446688,5094,5.1,"20"
"5110",14,7,66,4451846,4457150,5304,5.3,"20"
"5210",14,2,37,4461524,4465002,3478,3.5,"0"
"539",14,1,44,4470111,4475124,5013,5,"20"
"5410",14,7,74,4534561,4539592,5031,5,"20"
"559",14,7,34,4541790,4547665,5875,5.9,"20"
"569",14,8,19,4549487,4552750,3263,3.3,"0"
"589",14,3,38,4557418,4562238,4820,4.8,"20"
"5910",14,5,24,4563905,4570308,6403,6.4,"20"
"6111",14,2,5,4574302,4577884,3582,3.6,"0"
"6310",14,5,72,4581896,4586146,4250,4.2,"20"
"647",14,6,17,4588292,4591958,3666,3.7,"0"
"668",14,4,47,4596224,4600525,4301,4.3,"0"
"6711",14,2,13,4603680,4607980,4300,4.3,"0"
"6911",14,4,23,4611853,4615279,3426,3.4,"0"
"717",14,5,80,4619330,4623132,3802,3.8,"20"
"7212",14,2,21,4624886,4628889,4003,4,"0"
"747",14,8,27,4632825,4637425,4600,4.6,"0"
"768",14,4,79,4641539,4644454,2915,2.9,"0"
"779",14,2,53,4646358,4650199,3841,3.8,"0"
"7810",14,1,68,4653310,4657724,4414,4.4,"20"
"7910",14,2,77,4659599,4663198,3599,3.6,"0"
"808",14,5,64,4664830,4668882,4052,4.1,"20"
"818",14,5,48,4670910,4675316,4406,4.4,"20"
"8211",14,3,46,4679783,4683558,3775,3.8,"20"
"838",14,7,10,4685649,4691327,5678,5.7,"20"
"858",14,7,26,4698041,4702371,4330,4.3,"20"
"877",14,3,70,4707269,4711413,4144,4.1,"20"
"8810",14,6,57,4741745,4746095,4350,4.3,"0"
"899",14,1,52,4747774,4751434,3660,3.7,"20"
"908",14,4,31,4753054,4757138,4084,4.1,"0"
"9211",14,6,73,4760413,4763963,3550,3.5,"0"
"937",14,1,28,4767229,4772856,5627,5.6,"20"
"9511",14,1,60,4777700,4781072,3372,3.4,"20"
"9610",14,8,3,4782924,4788076,5152,5.2,"0"
"9811",14,4,63,4792831,4796861,4030,4,"0"
"9911",14,2,45,4798807,4801751,2944,2.9,"0"
"1008",14,3,6,4805609,4810772,5163,5.2,"20"
"10212",14,4,71,4815085,4818307,3222,3.2,"0"
"10312",14,8,51,4820012,4823775,3763,3.8,"0"
"1046",14,5,56,4826849,4830282,3433,3.4,"20"
"10512",14,6,1,4832163,4836659,4496,4.5,"0"
"1078",14,1,20,4840712,4843958,3246,3.2,"20"
"10911",14,1,4,4848526,4853211,4685,4.7,"20"
"11114",14,1,36,4858070,4863588,5518,5.5,"20"
"11211",14,8,67,4865489,4868834,3345,3.3,"0"
"1139",14,5,8,4871948,4877552,5604,5.6,"20"
"1159",14,6,65,4882916,4887022,4106,4.1,"0"
"1169",14,8,35,4889000,4892727,3727,3.7,"0"
"11710",14,4,15,4894774,4897818,3044,3,"0"
"11912",14,7,2,4901883,4906064,4181,4.2,"20"
"1215",14,4,39,4910264,4915304,5040,5,"0"
"1047",15,6,72,9036130,9039117,2987,3,"0"
"1140",15,5,55,9041872,9044579,2707,2.7,"20"
"128",15,8,42,9046271,9049415,3144,3.1,"0"
"1314",15,4,70,9052204,9055177,2973,3,"0"
"1410",15,8,2,9056873,9060004,3131,3.1,"0"
"167",15,6,8,9070351,9073381,3030,3,"0"
"189",15,8,58,9078159,9080606,2447,2.4,"0"
"1911",15,4,78,9082435,9085881,3446,3.4,"0"
"2010",15,6,40,9087342,9089418,2076,2.1,"0"
"219",15,3,29,9092471,9094749,2278,2.3,"20"
"2310",15,5,79,9099538,9102475,2937,2.9,"20"
"249",15,1,35,9104381,9107684,3303,3.3,"20"
"2510",15,3,37,9109595,9114131,4536,4.5,"20"
"2612",15,2,28,9115642,9118626,2984,3,"0"
"287",15,5,23,9123025,9125134,2109,2.1,"20"
"308",15,1,3,9129012,9131733,2721,2.7,"20"
"328",15,3,45,9137556,9139699,2143,2.1,"20"
"3312",15,2,4,9141949,9144212,2263,2.3,"0"
"359",15,8,50,9150621,9152789,2168,2.2,"0"
"3611",15,7,9,9154682,9156958,2276,2.3,"20"
"3811",15,6,32,9161743,9164232,2489,2.5,"0"
"408",15,4,54,9168584,9170633,2049,2,"0"
"4111",15,8,74,9172182,9174375,2193,2.2,"0"
"4210",15,1,27,9176648,9179891,3243,3.2,"20"
"4411",15,4,30,9184833,9187125,2292,2.3,"0"
"468",15,4,6,9191395,9196350,4955,5,"0"
"489",15,1,19,9201417,9204113,2696,2.7,"20"
"5010",15,2,44,9213181,9216460,3279,3.3,"0"
"5111",15,5,47,9219582,9221584,2002,2,"20"
"5211",15,2,68,9228713,9231580,2867,2.9,"0"
"5310",15,3,13,9233711,9237035,3324,3.3,"20"
"5510",15,4,62,9241749,9244469,2720,2.7,"0"
"5610",15,4,38,9248028,9250907,2879,2.9,"0"
"578",15,2,12,9254040,9256628,2588,2.6,"0"
"5911",15,3,53,9261396,9264599,3203,3.2,"20"
"6010",15,2,76,9266219,9270055,3836,3.8,"0"
"6112",15,2,36,9272215,9275968,3753,3.8,"0"
"629",15,2,20,9279060,9281644,2584,2.6,"0"
"648",15,8,10,9286770,9289215,2445,2.4,"0"
"669",15,6,56,9293023,9294579,1556,1.6,"0"
"6712",15,6,80,9298392,9300734,2342,2.3,"0"
"688",15,1,43,9303827,9306063,2236,2.2,"20"
"6912",15,3,21,9308377,9311251,2874,2.9,"20"
"718",15,2,52,9315723,9318256,2533,2.5,"0"
"7213",15,4,46,9320371,9323272,2901,2.9,"0"
"7310",15,1,75,9328127,9330394,2267,2.3,"20"
"748",15,6,48,9332448,9334996,2548,2.5,"0"
"759",15,5,39,9336908,9340673,3765,3.8,"20"
"769",15,7,33,9342667,9345241,2574,2.6,"20"
"7710",15,5,63,9347290,9351283,3993,4,"20"
"7811",15,7,49,9354229,9356808,2579,2.6,"20"
"7911",15,7,65,9361874,9364332,2458,2.5,"20"
"809",15,5,7,9365901,9368783,2882,2.9,"20"
"8212",15,6,16,9376139,9379323,3184,3.2,"0"
"8410",15,8,26,9383424,9386070,2646,2.6,"0"
"8610",15,1,51,9390274,9393405,3131,3.1,"20"
"878",15,5,71,9398579,9400688,2109,2.1,"20"
"8811",15,7,73,9403046,9405195,2149,2.1,"20"
"8910",15,6,64,9409765,9411306,1541,1.5,"0"
"909",15,8,34,9414683,9417298,2615,2.6,"0"
"918",15,8,18,9419409,9422282,2873,2.9,"0"
"938",15,7,57,9426804,9428446,1642,1.6,"20"
"948",15,1,11,9430954,9433442,2488,2.5,"20"
"9611",15,3,5,9439187,9445327,6140,6.1,"20"
"9812",15,4,22,9449153,9451847,2694,2.7,"0"
"1009",15,6,24,9456610,9459293,2683,2.7,"0"
"10213",15,5,31,9463280,9465871,2591,2.6,"20"
"1048",15,2,60,9470255,9474544,4289,4.3,"0"
"10513",15,1,67,9476381,9478993,2612,2.6,"20"
"10610",15,8,66,9481253,9483473,2220,2.2,"0"
"1079",15,1,59,9486690,9488912,2222,2.2,"20"
"1089",15,3,69,9490671,9492592,1921,1.9,"20"
"10912",15,3,61,9494474,9498448,3974,4,"20"
"11010",15,3,77,9501670,9504043,2373,2.4,"20"
"11115",15,7,17,9507093,9510014,2921,2.9,"20"
"11310",15,7,1,9513992,9516797,2805,2.8,"20"
"11510",15,7,25,9523720,9526137,2417,2.4,"20"
"11711",15,7,41,9531509,9534256,2747,2.7,"20"
"1188",15,4,14,9535723,9537977,2254,2.3,"0"
"12011",15,5,15,9544558,9546604,2046,2,"20"
"1049",16,6,47,7040928,7046953,6025,6,"0"
"1150",16,4,53,7049187,7057038,7851,7.9,"0"
"129",16,4,5,7061772,7069842,8070,8.1,"0"
"1411",16,5,6,7076830,7083593,6763,6.8,"20"
"168",16,7,80,7090202,7096866,6664,6.7,"20"
"1712",16,2,35,7100679,7106348,5669,5.7,"0"
"1810",16,4,69,7109381,7117291,7910,7.9,"0"
"1912",16,3,36,7121698,7130712,9014,9,"20"
"2011",16,7,16,7134831,7141600,6769,6.8,"20"
"2210",16,5,22,7149478,7166755,17277,17.3,"20"
"2410",16,2,3,7177094,7185799,8705,8.7,"0"
"2613",16,2,11,7193004,7198794,5790,5.8,"0"
"288",16,6,63,7204597,7211962,7365,7.4,"0"
"2914",16,6,71,7215445,7219417,3972,4,"0"
"309",16,8,25,7222726,7228568,5842,5.8,"0"
"329",16,4,77,7234791,7241703,6912,6.9,"0"
"3313",16,3,12,7244281,7250390,6109,6.1,"20"
"3510",16,3,4,7257705,7267258,9553,9.6,"20"
"379",16,5,46,7273530,7284672,11142,11.1,"20"
"3812",16,5,70,7287797,7295275,7478,7.5,"20"
"3910",16,1,74,7299746,7310880,11134,11.1,"20"
"409",16,6,15,7312380,7317416,5036,5,"0"
"4211",16,7,8,7326100,7338675,12575,12.6,"20"
"4412",16,5,30,7345042,7350248,5206,5.2,"20"
"469",16,7,48,7356632,7366514,9882,9.9,"20"
"4711",16,1,58,7370515,7383120,12605,12.6,"20"
"4810",16,6,55,7388949,7393853,4904,4.9,"0"
"495",16,5,38,7396967,7401767,4800,4.8,"20"
"5011",16,6,7,7405179,7412335,7156,7.2,"0"
"5212",16,1,18,7419057,7423348,4291,4.3,"20"
"5411",16,1,66,7430976,7440822,9846,9.8,"20"
"5511",16,8,9,7444537,7454346,9809,9.8,"0"
"579",16,8,73,7461208,7471275,10067,10.1,"0"
"5810",16,2,51,7476838,7489901,13063,13.1,"0"
"5912",16,5,62,7491914,7501202,9288,9.3,"20"
"6011",16,8,1,7505113,7508766,3653,3.7,"0"
"6210",16,3,20,7517737,7524301,6564,6.6,"20"
"649",16,4,13,7547069,7556138,9069,9.1,"0"
"6610",16,1,42,7562169,7569034,6865,6.9,"20"
"6713",16,4,61,7572588,7578039,5451,5.5,"0"
"689",16,7,72,7583897,7593480,9583,9.6,"20"
"6913",16,4,21,7597632,7603599,5967,6,"0"
"719",16,2,67,7612175,7619762,7587,7.6,"0"
"7214",16,5,14,7625286,7635869,10583,10.6,"20"
"749",16,3,44,7645658,7650959,5301,5.3,"20"
"7510",16,6,39,7654269,7659943,5674,5.7,"0"
"7610",16,7,64,7667014,7671644,4630,4.6,"20"
"7711",16,1,2,7677430,7681947,4517,4.5,"20"
"7912",16,2,19,7689250,7692849,3599,3.6,"0"
"819",16,1,34,7701242,7708824,7582,7.6,"20"
"8213",16,3,52,7715243,7721631,6388,6.4,"20"
"839",16,3,28,7727273,7737349,10076,10.1,"20"
"859",16,7,40,7743430,7747602,4172,4.2,"20"
"8611",16,2,59,7752462,7759582,7120,7.1,"0"
"879",16,6,23,7763203,7767279,4076,4.1,"0"
"8911",16,4,37,7776062,7780377,4315,4.3,"0"
"9010",16,8,33,7785052,7791807,6755,6.8,"0"
"919",16,6,31,7797223,7806696,9473,9.5,"0"
"939",16,1,26,7813903,7817788,3885,3.9,"20"
"9512",16,2,75,7823398,7827385,3987,4,"0"
"9612",16,5,54,7830485,7835128,4643,4.6,"20"
"9711",16,5,78,7838674,7845267,6593,6.6,"20"
"9813",16,7,32,7851228,7856419,5191,5.2,"20"
"10010",16,2,27,7862654,7867923,5269,5.3,"0"
"10214",16,1,50,7874321,7881473,7152,7.2,"20"
"10313",16,4,29,7885371,7890244,4873,4.9,"0"
"10514",16,3,68,7897994,7902796,4802,4.8,"20"
"10611",16,2,43,7908529,7916560,8031,8,"0"
"10710",16,7,24,7921445,7928794,7349,7.3,"20"
"10913",16,3,60,7934414,7939756,5342,5.3,"20"
"11011",16,8,49,7944403,7952138,7735,7.7,"0"
"11116",16,6,79,7957709,7962360,4651,4.7,"0"
"11212",16,8,65,7965747,7974040,8293,8.3,"0"
"11311",16,1,10,7975816,7980795,4979,5,"20"
"11511",16,3,76,7985938,7994712,8774,8.8,"20"
"11610",16,7,56,7997652,8002865,5213,5.2,"20"
"11712",16,4,45,8004904,8009636,4732,4.7,"0"
"1189",16,8,17,8013690,8022699,9009,9,"0"
"12012",16,8,41,8028858,8033568,4710,4.7,"0"
"1216",16,8,57,8037012,8044426,7414,7.4,"0"
"1050",17,1,73,2027593,2031270,3677,3.7,"20"
"1160",17,8,16,2033135,2036412,3277,3.3,"0"
"1315",17,8,24,2041148,2045234,4086,4.1,"0"
"159",17,5,37,2050555,2054274,3719,3.7,"20"
"169",17,2,74,2055897,2059297,3400,3.4,"0"
"1713",17,4,20,2061167,2064176,3009,3,"0"
"1913",17,6,14,2069264,2072515,3251,3.3,"0"
"2110",17,1,33,2077371,2081973,4602,4.6,"20"
"2211",17,4,60,2084155,2086927,2772,2.8,"0"
"2311",17,4,4,2089253,2093663,4410,4.4,"0"
"2511",17,8,48,2098397,2103407,5010,5,"0"
"2614",17,2,42,2105290,2109230,3940,3.9,"0"
"279",17,3,75,2111264,2116257,4993,5,"20"
"289",17,8,80,2118094,2121011,2917,2.9,"0"
"2915",17,5,5,2123193,2127407,4214,4.2,"20"
"3111",17,7,79,2134384,2138359,3975,4,"20"
"3210",17,6,46,2141141,2145498,4357,4.4,"0"
"3314",17,4,36,2149072,2152658,3586,3.6,"0"
"3410",17,8,40,2155280,2158431,3151,3.2,"0"
"3511",17,4,28,2160416,2165195,4779,4.8,"0"
"3710",17,4,52,2169765,2174378,4613,4.6,"0"
"3813",17,8,8,2176056,2178636,2580,2.6,"0"
"4010",17,5,13,2184724,2188638,3914,3.9,"20"
"4212",17,4,76,2193319,2197062,3743,3.7,"0"
"4311",17,6,38,2200443,2204401,3958,4,"0"
"4413",17,5,69,2206811,2209978,3167,3.2,"20"
"4512",17,7,39,2212823,2217157,4334,4.3,"20"
"4610",17,2,34,2220445,2224106,3661,3.7,"0"
"4712",17,6,30,2227930,2230535,2605,2.6,"0"
"496",17,6,54,2236636,2240386,3750,3.8,"0"
"5012",17,6,22,2242679,2246296,3617,3.6,"0"
"5213",17,6,70,2255000,2258465,3465,3.5,"0"
"5311",17,7,55,2261711,2265430,3719,3.7,"20"
"5412",17,3,3,2274888,2278392,3504,3.5,"20"
"5611",17,7,31,2303337,2307592,4255,4.3,"20"
"5811",17,3,27,2311765,2314834,3069,3.1,"20"
"6012",17,3,11,2318467,2320705,2238,2.2,"20"
"6211",17,1,65,2324692,2328221,3529,3.5,"20"
"6311",17,3,67,2329957,2333460,3503,3.5,"20"
"6410",17,3,35,2336933,2340351,3418,3.4,"20"
"659",17,5,77,2342246,2345439,3193,3.2,"20"
"6611",17,1,41,2347285,2350263,2978,3,"20"
"6714",17,4,44,2352163,2354786,2623,2.6,"0"
"6810",17,3,51,2356844,2360011,3167,3.2,"20"
"6914",17,8,64,2363700,2366488,2788,2.8,"0"
"7010",17,1,57,2368746,2372222,3476,3.5,"20"
"7110",17,8,56,2376164,2379027,2863,2.9,"0"
"7215",17,3,19,2383294,2387061,3767,3.8,"20"
"7410",17,2,50,2395254,2397958,2704,2.7,"0"
"7511",17,4,68,2400266,2403129,2863,2.9,"0"
"7611",17,1,9,2404631,2408317,3686,3.7,"20"
"7812",17,1,49,2412518,2415385,2867,2.9,"20"
"7913",17,2,18,2417677,2420523,2846,2.8,"0"
"8110",17,3,43,2425406,2428973,3567,3.6,"20"
"8214",17,3,59,2430764,2434735,3971,4,"20"
"8310",17,7,71,2436516,2439026,2510,2.5,"20"
"8411",17,2,10,2440667,2443825,3158,3.2,"0"
"8612",17,5,45,2449845,2454039,4194,4.2,"20"
"8710",17,4,12,2455968,2458692,2724,2.7,"0"
"8912",17,8,72,2463435,2467038,3603,3.6,"0"
"9011",17,6,78,2468832,2472173,3341,3.3,"0"
"9110",17,2,26,2473773,2477336,3563,3.6,"0"
"9310",17,5,21,2481493,2485224,3731,3.7,"20"
"9513",17,2,58,2490163,2494142,3979,4,"0"
"9613",17,5,29,2496106,2498846,2740,2.7,"20"
"9814",17,5,53,2503949,2507953,4004,4,"20"
"9912",17,2,66,2510008,2513427,3419,3.4,"0"
"10011",17,1,1,2515190,2517849,2659,2.7,"20"
"10215",17,7,23,2523445,2526103,2658,2.7,"20"
"10410",17,5,61,2530039,2533852,3813,3.8,"20"
"10515",17,8,32,2536393,2538893,2500,2.5,"0"
"10711",17,7,7,2542999,2545999,3000,3,"20"
"10914",17,2,2,2551468,2554310,2842,2.8,"0"
"11117",17,1,17,2559291,2562596,3305,3.3,"20"
"11312",17,6,6,2567394,2570763,3369,3.4,"0"
"11512",17,7,63,2577759,2582588,4829,4.8,"20"
"11611",17,7,47,2585384,2587877,2493,2.5,"20"
"11713",17,7,15,2590156,2592980,2824,2.8,"20"
"11913",17,6,62,2596905,2600866,3961,4,"0"
"12013",17,1,25,2602845,2607082,4237,4.2,"20"
"1060",18,5,76,11670684,11673206,2522,2.5,"20"
"1170",18,6,13,11679194,11681952,2758,2.8,"0"
"1316",18,3,74,11688029,11692955,4926,4.9,"20"
"1412",18,1,32,11697418,11699913,2495,2.5,"20"
"1610",18,7,6,11703673,11705947,2274,2.3,"20"
"1811",18,8,55,11711272,11713516,2244,2.2,"0"
"1914",18,2,17,11715762,11719692,3930,3.9,"0"
"2111",18,6,77,11723774,11725445,1671,1.7,"0"
"2212",18,5,44,11731108,11733269,2161,2.2,"20"
"2312",18,8,39,11736640,11738961,2321,2.3,"0"
"2411",18,1,8,11745710,11748058,2348,2.3,"20"
"2615",18,7,38,11752102,11754383,2281,2.3,"20"
"2710",18,2,49,11758780,11761148,2368,2.4,"0"
"2810",18,2,73,11765134,11769177,4043,4,"0"
"2916",18,3,34,11771039,11773501,2462,2.5,"20"
"3010",18,5,12,11782099,11783827,1728,1.7,"20"
"3211",18,7,46,11803543,11806040,2497,2.5,"20"
"3315",18,2,1,11807994,11809765,1771,1.8,"0"
"3512",18,4,35,11814597,11816461,1864,1.9,"0"
"3612",18,1,56,11819097,11820950,1853,1.9,"20"
"3711",18,4,59,11823794,11826490,2696,2.7,"0"
"3814",18,5,52,11828488,11831440,2952,3,"20"
"3911",18,2,57,11833877,11836403,2526,2.5,"0"
"4011",18,2,9,11838235,11840665,2430,2.4,"0"
"4213",18,5,4,11845975,11848195,2220,2.2,"20"
"4414",18,4,3,11858480,11860714,2234,2.2,"0"
"4611",18,5,36,11864435,11867325,2890,2.9,"20"
"4713",18,4,43,11871155,11873240,2085,2.1,"0"
"4811",18,1,40,11875534,11877260,1726,1.7,"20"
"497",18,6,61,11882086,11885029,2943,2.9,"0"
"5013",18,4,51,11888655,11891497,2842,2.8,"0"
"5112",18,3,18,11893867,11895853,1986,2,"20"
"5312",18,1,24,11899629,11901964,2335,2.3,"20"
"5512",18,2,65,11908716,11911271,2555,2.6,"0"
"5612",18,3,10,11913817,11916751,2934,2.9,"20"
"5812",18,8,15,11920513,11922058,1545,1.5,"0"
"6013",18,4,75,11929354,11931660,2306,2.3,"0"
"6113",18,1,72,11933254,11935619,2365,2.4,"20"
"6212",18,5,28,11937320,11939193,1873,1.9,"20"
"6411",18,4,11,11944337,11945877,1540,1.5,"0"
"6612",18,4,27,11951445,11953405,1960,2,"0"
"6811",18,2,33,11960442,11962906,2464,2.5,"0"
"6915",18,2,41,11966147,11968688,2541,2.5,"0"
"7011",18,7,54,11970203,11973516,3313,3.3,"20"
"7111",18,6,69,11975849,11978019,2170,2.2,"0"
"7216",18,8,79,11980465,11982721,2256,2.3,"0"
"7311",18,6,5,11984425,11986659,2234,2.2,"0"
"7512",18,3,2,11992091,11994725,2634,2.6,"20"
"7712",18,8,7,11999467,12001638,2171,2.2,"0"
"7914",18,2,25,12010233,12011881,1648,1.6,"0"
"8111",18,7,14,12018558,12021085,2527,2.5,"20"
"8311",18,5,20,12027148,12029123,1975,2,"20"
"8510",18,7,70,12036486,12039033,2547,2.5,"20"
"8613",18,6,53,12041506,12044291,2785,2.8,"0"
"8711",18,7,78,12045819,12048188,2369,2.4,"20"
"8812",18,6,45,12050259,12051873,1614,1.6,"0"
"8913",18,1,64,12054098,12055828,1730,1.7,"20"
"9012",18,3,26,12059703,12061652,1949,1.9,"20"
"9212",18,7,62,12067730,12070612,2882,2.9,"20"
"9311",18,6,37,12072249,12074538,2289,2.3,"0"
"949",18,4,19,12078260,12081104,2844,2.8,"0"
"9614",18,5,60,12087847,12090149,2302,2.3,"20"
"9712",18,1,80,12095585,12097203,1618,1.6,"20"
"9815",18,3,50,12099459,12101736,2277,2.3,"20"
"9913",18,7,22,12103723,12106072,2349,2.3,"20"
"10115",18,8,63,12109979,12112244,2265,2.3,"0"
"10216",18,8,47,12113884,12116585,2701,2.7,"0"
"10314",18,6,21,12121145,12123593,2448,2.4,"0"
"10516",18,8,23,12128763,12130179,1416,1.4,"0"
"10712",18,5,68,12134904,12139152,4248,4.2,"20"
"10810",18,3,66,12142074,12144285,2211,2.2,"20"
"10915",18,8,71,12145970,12149120,3150,3.1,"0"
"11012",18,8,31,12151342,12153640,2298,2.3,"0"
"11213",18,1,48,12158593,12161161,2568,2.6,"20"
"11313",18,6,29,12163850,12165571,1721,1.7,"0"
"11513",18,1,16,12170180,12172046,1866,1.9,"20"
"11714",18,4,67,12176584,12180018,3434,3.4,"0"
"11810",18,3,42,12182037,12184158,2121,2.1,"20"
"11914",18,7,30,12185772,12188277,2505,2.5,"20"
"1217",18,3,58,12193298,12195273,1975,2,"20"
"1070",19,2,8,7717259,7720917,3658,3.7,"0"
"1210",19,2,80,7725833,7729145,3312,3.3,"0"
"1317",19,1,63,7732800,7737786,4986,5,"20"
"1413",19,8,62,7743872,7750337,6465,6.5,"0"
"1510",19,8,70,7754489,7761652,7163,7.2,"0"
"1611",19,3,49,7765548,7769798,4250,4.2,"20"
"1714",19,4,42,7772141,7776128,3987,4,"0"
"1812",19,3,41,7779788,7784660,4872,4.9,"20"
"1915",19,4,34,7787500,7792109,4609,4.6,"0"
"2012",19,6,44,7796095,7798945,2850,2.8,"0"
"2112",19,2,56,7801369,7804340,2971,3,"0"
"2213",19,6,12,7810410,7814073,3663,3.7,"0"
"2412",19,3,73,7819702,7826347,6645,6.6,"20"
"2512",19,8,22,7833792,7838483,4691,4.7,"0"
"2711",19,4,2,7844098,7850252,6154,6.2,"0"
"2917",19,5,27,7855335,7859425,4090,4.1,"20"
"3112",19,7,21,7864076,7869759,5683,5.7,"20"
"3316",19,6,4,7874264,7879598,5334,5.3,"0"
"3513",19,7,69,7884200,7888420,4220,4.2,"20"
"3613",19,6,36,7890128,7894829,4701,4.7,"0"
"3712",19,2,48,7899064,7902496,3432,3.4,"0"
"3815",19,4,74,7904293,7908101,3808,3.8,"0"
"3912",19,5,19,7910083,7914325,4242,4.2,"20"
"4112",19,3,25,7924125,7929134,5009,5,"20"
"4312",19,2,64,7950105,7952675,2570,2.6,"0"
"4415",19,1,31,7956539,7960978,4439,4.4,"20"
"4612",19,8,46,7974156,7977684,3528,3.5,"0"
"4714",19,5,51,7980096,7985651,5555,5.6,"20"
"4812",19,5,59,7994962,7999626,4664,4.7,"20"
"498",19,5,35,8002715,8006191,3476,3.5,"20"
"5014",19,8,54,8008691,8013521,4830,4.8,"0"
"5113",19,1,15,8016646,8020722,4076,4.1,"20"
"5313",19,7,53,8028773,8034616,5843,5.8,"20"
"5413",19,7,45,8046714,8051199,4485,4.5,"20"
"5513",19,1,23,8054159,8058804,4645,4.6,"20"
"5710",19,2,40,8065238,8068029,2791,2.8,"0"
"5813",19,4,58,8081338,8084301,2963,3,"0"
"5913",19,7,13,8086826,8091676,4850,4.8,"20"
"6114",19,2,24,8102358,8106543,4185,4.2,"0"
"6312",19,8,38,8114716,8118275,3559,3.6,"0"
"6412",19,6,68,8120000,8122505,2505,2.5,"0"
"6510",19,6,76,8124909,8129373,4464,4.5,"0"
"6613",19,6,60,8131283,8135434,4151,4.2,"0"
"6715",19,8,6,8137590,8144313,6723,6.7,"0"
"6916",19,5,75,8152338,8157316,4978,5,"20"
"7012",19,7,37,8159497,8164299,4802,4.8,"20"
"7112",19,6,52,8166048,8169063,3015,3,"0"
"7217",19,8,14,8170809,8175962,5153,5.2,"0"
"7411",19,7,29,8181590,8185845,4255,4.3,"20"
"7612",19,3,65,8189773,8193746,3973,4,"20"
"7713",19,4,50,8195808,8197930,2122,2.1,"0"
"7813",19,5,11,8199617,8202725,3108,3.1,"20"
"8010",19,1,79,8206206,8209892,3686,3.7,"20"
"8112",19,1,71,8212461,8215756,3295,3.3,"20"
"8215",19,4,66,8217543,8220432,2889,2.9,"0"
"8312",19,2,32,8222016,8226718,4702,4.7,"0"
"8511",19,3,9,8230874,8234885,4011,4,"20"
"8712",19,7,77,8238987,8242409,3422,3.4,"20"
"8813",19,4,18,8244965,8247838,2873,2.9,"0"
"9013",19,7,5,8254945,8261713,6768,6.8,"20"
"9213",19,8,30,8267071,8269688,2617,2.6,"0"
"9410",19,3,33,8273862,8277150,3288,3.3,"20"
"9514",19,1,47,8279054,8282515,3461,3.5,"20"
"9615",19,2,16,8284665,8289292,4627,4.6,"0"
"9816",19,4,10,8293564,8295932,2368,2.4,"0"
"10012",19,5,67,8300896,8304624,3728,3.7,"20"
"10116",19,7,61,8308327,8314237,5910,5.9,"20"
"10217",19,4,26,8316334,8319019,2685,2.7,"0"
"10411",19,2,72,8324207,8327937,3730,3.7,"0"
"10517",19,3,17,8329935,8334821,4886,4.9,"20"
"10713",19,3,1,8338917,8343366,4449,4.4,"20"
"10916",19,3,57,8349203,8355037,5834,5.8,"20"
"11013",19,1,39,8357423,8361649,4226,4.2,"20"
"11118",19,1,7,8363497,8370103,6606,6.6,"20"
"11314",19,1,55,8375823,8379759,3936,3.9,"20"
"11410",19,5,43,8381557,8385410,3853,3.9,"20"
"11514",19,8,78,8387071,8392189,5118,5.1,"0"
"11612",19,6,28,8394218,8399909,5691,5.7,"0"
"11811",19,5,3,8404632,8408442,3810,3.8,"20"
"12014",19,6,20,8412355,8414860,2505,2.5,"0"
"1080",20,8,53,3093380,3097142,3762,3.8,"0"
"1180",20,3,40,3099750,3105001,5251,5.3,"20"
"1218",20,3,72,3106888,3111742,4854,4.9,"20"
"1318",20,3,24,3113801,3118961,5160,5.2,"20"
"1511",20,3,64,3124417,3130337,5920,5.9,"20"
"1612",20,4,17,3132052,3135741,3689,3.7,"0"
"1813",20,4,57,3141380,3145328,3948,3.9,"0"
"1916",20,3,80,3147472,3151445,3973,4,"20"
"2013",20,4,41,3153440,3157156,3716,3.7,"0"
"2113",20,5,34,3160668,3165714,5046,5,"20"
"2214",20,7,76,3168712,3171505,2793,2.8,"20"
"2313",20,1,46,3175046,3178656,3610,3.6,"20"
"2413",20,8,5,3180414,3185068,4654,4.7,"0"
"2616",20,1,54,3191234,3195432,4198,4.2,"20"
"2712",20,5,74,3198465,3201275,2810,2.8,"20"
"2811",20,6,43,3203500,3206106,2606,2.6,"0"
"2918",20,6,11,3209036,3213363,4327,4.3,"0"
"3113",20,1,30,3217643,3220825,3182,3.2,"20"
"3317",20,2,31,3227051,3230458,3407,3.4,"0"
"3514",20,5,58,3236608,3240937,4329,4.3,"20"
"3614",20,5,26,3243666,3248193,4527,4.5,"20"
"3816",20,6,27,3253284,3256273,2989,3,"0"
"4012",20,4,33,3260711,3263485,2774,2.8,"0"
"4113",20,6,35,3265927,3269116,3189,3.2,"0"
"4214",20,3,48,3272348,3276258,3910,3.9,"20"
"4313",20,1,22,3279284,3283146,3862,3.9,"20"
"4513",20,2,47,3286952,3290461,3509,3.5,"0"
"4613",20,8,69,3292111,3295284,3173,3.2,"0"
"4715",20,7,36,3297983,3301905,3922,3.9,"20"
"4813",20,5,2,3303903,3307437,3534,3.5,"20"
"5015",20,2,7,3312539,3315596,3057,3.1,"0"
"5214",20,2,71,3320783,3323177,2394,2.4,"0"
"5314",20,2,63,3324911,3327876,2965,3,"0"
"5414",20,7,68,3329771,3335421,5650,5.7,"20"
"5514",20,7,28,3337760,3341125,3365,3.4,"20"
"5711",20,2,55,3346493,3350832,4339,4.3,"0"
"5814",20,7,12,3352340,3355058,2718,2.7,"20"
"6014",20,1,38,3360202,3364515,4313,4.3,"20"
"6115",20,8,61,3366308,3370264,3956,4,"0"
"6213",20,2,15,3371731,3375230,3499,3.5,"0"
"6413",20,4,25,3379633,3382902,3269,3.3,"0"
"6614",20,5,42,3386678,3390970,4292,4.3,"20"
"6716",20,6,3,3393532,3397162,3630,3.6,"0"
"6917",20,8,45,3401423,3404689,3266,3.3,"0"
"7013",20,8,77,3406343,3409623,3280,3.3,"0"
"7113",20,5,66,3411855,3415003,3148,3.1,"20"
"7218",20,5,18,3418196,3422728,4532,4.5,"20"
"7412",20,6,59,3427793,3431091,3298,3.3,"0"
"7513",20,7,44,3432938,3435389,2451,2.5,"20"
"7613",20,8,37,3437117,3440717,3600,3.6,"0"
"7714",20,4,73,3442532,3445876,3344,3.3,"0"
"7814",20,8,21,3447784,3452029,4245,4.2,"0"
"8011",20,2,23,3456031,3457894,1863,1.9,"0"
"8216",20,3,32,3461759,3464164,2405,2.4,"20"
"8412",20,8,29,3467979,3471667,3688,3.7,"0"
"8614",20,5,50,3475496,3478341,2845,2.8,"20"
"8713",20,6,75,3480267,3483558,3291,3.3,"0"
"8814",20,6,19,3486774,3489405,2631,2.6,"0"
"9014",20,7,60,3496192,3499470,3278,3.3,"20"
"9111",20,8,13,3501113,3503670,2557,2.6,"0"
"9312",20,1,6,3507096,3509774,2678,2.7,"20"
"9515",20,1,78,3513848,3517028,3180,3.2,"20"
"9616",20,3,56,3518780,3520818,2038,2,"20"
"9713",20,7,20,3523286,3525666,2380,2.4,"20"
"9914",20,2,79,3531279,3534206,2927,2.9,"0"
"10013",20,4,65,3536862,3539952,3090,3.1,"0"
"10117",20,3,16,3541553,3543827,2274,2.3,"20"
"10315",20,5,10,3549173,3555072,5899,5.9,"20"
"10518",20,6,67,3559120,3562126,3006,3,"0"
"10612",20,4,49,3563562,3566222,2660,2.7,"0"
"10714",20,3,8,3568638,3571840,3202,3.2,"20"
"10917",20,7,52,3575543,3578637,3094,3.1,"20"
"11014",20,1,14,3581521,3585286,3765,3.8,"20"
"11214",20,2,39,3590107,3593475,3368,3.4,"0"
"11315",20,4,9,3595982,3598581,2599,2.6,"0"
"11515",20,7,4,3602844,3606047,3203,3.2,"20"
"11715",20,1,62,3609977,3612853,2876,2.9,"20"
"11812",20,4,1,3616348,3620339,3991,4,"0"
"12015",20,6,51,3624595,3628838,4243,4.2,"0"
"1219",20,1,70,3630675,3635149,4474,4.5,"20"
"1090",21,3,23,2182015,2184127,2112,2.1,"20"
"1220",21,5,49,2187719,2189911,2192,2.2,"20"
"1319",21,2,30,2192427,2194386,1959,2,"0"
"1512",21,1,21,2200895,2203354,2459,2.5,"20"
"1715",21,4,56,2213457,2215214,1757,1.8,"0"
"1814",21,5,1,2218955,2221130,2175,2.2,"20"
"2014",21,5,9,2224958,2227376,2418,2.4,"20"
"2215",21,7,19,2236655,2239051,2396,2.4,"20"
"2414",21,1,13,2246861,2250258,3397,3.4,"20"
"2617",21,8,44,2260542,2263105,2563,2.6,"0"
"2713",21,3,47,2269657,2271630,1973,2,"20"
"2812",21,6,34,2279003,2281989,2986,3,"0"
"2919",21,7,35,2285138,2287307,2169,2.2,"20"
"3011",21,3,79,2299164,2301524,2360,2.4,"20"
"3114",21,8,52,2320793,2323021,2228,2.2,"0"
"3212",21,3,55,2325920,2328520,2600,2.6,"20"
"3318",21,3,15,2330652,2332408,1756,1.8,"20"
"3515",21,8,36,2336296,2338220,1924,1.9,"0"
"3615",21,8,4,2344788,2347334,2546,2.5,"0"
"3817",21,7,51,2350993,2353875,2882,2.9,"20"
"3913",21,5,33,2360651,2362465,1814,1.8,"20"
"4013",21,3,7,2366769,2369250,2481,2.5,"20"
"4215",21,2,6,2374357,2377131,2774,2.8,"0"
"4416",21,4,64,2381504,2384463,2959,3,"0"
"4514",21,1,61,2389965,2392888,2923,2.9,"20"
"4614",21,6,18,2395351,2398023,2672,2.7,"0"
"4814",21,4,8,2402830,2405656,2826,2.8,"0"
"5016",21,4,16,2414453,2416656,2203,2.2,"0"
"5215",21,7,67,2425992,2428559,2567,2.6,"20"
"5315",21,8,12,2438230,2440399,2169,2.2,"0"
"5515",21,1,29,2446172,2449012,2840,2.8,"20"
"5712",21,7,27,2454508,2456876,2368,2.4,"20"
"5914",21,2,54,2460810,2463261,2451,2.5,"0"
"6015",21,7,3,2469427,2471903,2476,2.5,"20"
"6214",21,4,24,2480824,2484243,3419,3.4,"0"
"6414",21,6,42,2489216,2492750,3534,3.5,"0"
"6511",21,5,57,2497653,2500060,2407,2.4,"20"
"6615",21,1,77,2501735,2504393,2658,2.7,"20"
"6717",21,7,11,2508922,2511244,2322,2.3,"20"
"6918",21,6,58,2515248,2518720,3472,3.5,"0"
"7014",21,8,60,2520708,2523227,2519,2.5,"0"
"7114",21,5,25,2525327,2528258,2931,2.9,"20"
"7312",21,1,37,2532295,2534726,2431,2.4,"20"
"7413",21,2,38,2536456,2539438,2982,3,"0"
"7514",21,7,75,2542583,2545142,2559,2.6,"20"
"7614",21,5,41,2560349,2563293,2944,2.9,"20"
"7715",21,2,22,2565243,2568022,2779,2.8,"0"
"7915",21,1,53,2573185,2577059,3874,3.9,"20"
"8012",21,8,76,2582177,2584571,2394,2.4,"0"
"8113",21,8,28,2589748,2592844,3096,3.1,"0"
"8313",21,4,48,2599356,2602811,3455,3.5,"0"
"8413",21,6,66,2606761,2609187,2426,2.4,"0"
"8512",21,3,31,2614320,2617355,3035,3,"20"
"8714",21,3,39,2621304,2624240,2936,2.9,"20"
"8815",21,6,50,2625850,2627842,1992,2,"0"
"8914",21,6,2,2630857,2632555,1698,1.7,"0"
"9112",21,2,62,2636775,2639327,2552,2.6,"0"
"9214",21,1,45,2644179,2646611,2432,2.4,"20"
"9313",21,6,10,2649606,2651925,2319,2.3,"0"
"9516",21,7,43,2656770,2659511,2741,2.7,"20"
"9617",21,7,59,2661343,2664573,3230,3.2,"20"
"9714",21,6,74,2666832,2669023,2191,2.2,"0"
"9817",21,5,17,2673409,2675174,1765,1.8,"20"
"10014",21,4,40,2679144,2680886,1742,1.7,"0"
"10118",21,4,80,2682906,2684922,2016,2,"0"
"10218",21,8,68,2686981,2688981,2000,2,"0"
"10316",21,5,65,2691081,2693249,2168,2.2,"20"
"10412",21,8,20,2695163,2697237,2074,2.1,"0"
"10613",21,1,69,2700876,2702823,1947,1.9,"20"
"10715",21,5,73,2704579,2706945,2366,2.4,"20"
"10811",21,3,71,2709201,2710875,1674,1.7,"20"
"10918",21,2,70,2714658,2717277,2619,2.6,"0"
"11015",21,2,46,2719388,2721113,1725,1.7,"0"
"11119",21,4,72,2722985,2725833,2848,2.8,"0"
"11215",21,3,63,2727541,2729703,2162,2.2,"20"
"11316",21,4,32,2733176,2734989,1813,1.8,"0"
"11516",21,2,78,2739034,2741328,2294,2.3,"0"
"11613",21,2,14,2743506,2745581,2075,2.1,"0"
"11813",21,6,26,2751248,2753560,2312,2.3,"0"
"12016",21,1,5,2757414,2759932,2518,2.5,"20"
"10100",22,4,79,4550183,4554016,3833,3.8,"0"
"1190",22,1,68,4555398,4558918,3520,3.5,"20"
"1221",22,2,29,4560888,4564565,3677,3.7,"0"
"1414",22,5,8,4568575,4572641,4066,4.1,"20"
"1613",22,2,5,4577763,4581436,3673,3.7,"0"
"1815",22,1,36,4585732,4589414,3682,3.7,"20"
"1917",22,7,10,4591348,4595844,4496,4.5,"20"
"2114",22,3,38,4599880,4604004,4124,4.1,"20"
"2216",22,3,78,4606852,4610409,3557,3.6,"20"
"2314",22,5,56,4612711,4615806,3095,3.1,"20"
"2415",22,8,11,4617747,4621407,3660,3.7,"0"
"2618",22,8,3,4626164,4630755,4591,4.6,"0"
"2813",22,1,12,4635163,4638095,2932,2.9,"20"
"3012",22,1,4,4643653,4647192,3539,3.5,"20"
"3213",22,4,23,4651895,4654450,2555,2.6,"0"
"3411",22,4,7,4658791,4663337,4546,4.5,"0"
"3616",22,6,57,4669073,4672131,3058,3.1,"0"
"3713",22,8,59,4675524,4678853,3329,3.3,"0"
"3818",22,8,19,4681453,4684504,3051,3.1,"0"
"4014",22,1,20,4689809,4692920,3111,3.1,"20"
"4216",22,7,50,4697262,4700023,2761,2.8,"20"
"4314",22,6,65,4702636,4706665,4029,4,"0"
"4417",22,5,24,4708943,4712106,3163,3.2,"20"
"4615",22,4,71,4716264,4719151,2887,2.9,"0"
"4716",22,4,55,4721942,4725138,3196,3.2,"0"
"4815",22,3,30,4726948,4729629,2681,2.7,"20"
"5017",22,3,62,4732887,4736305,3418,3.4,"20"
"5114",22,6,49,4739003,4742112,3109,3.1,"0"
"5216",22,8,67,4745502,4748362,2860,2.9,"0"
"5316",22,6,73,4750737,4754669,3932,3.9,"0"
"5415",22,5,80,4756953,4759869,2916,2.9,"20"
"5516",22,5,16,4762040,4764926,2886,2.9,"20"
"5713",22,8,43,4768942,4771409,2467,2.5,"0"
"5815",22,7,42,4773051,4776188,3137,3.1,"20"
"5915",22,4,15,4778244,4780933,2689,2.7,"0"
"6116",22,2,37,4784264,4786936,2672,2.7,"0"
"6215",22,7,2,4789070,4791935,2865,2.9,"20"
"6415",22,8,35,4796217,4799665,3448,3.4,"0"
"6512",22,1,44,4802440,4805426,2986,3,"20"
"6616",22,5,64,4807403,4810099,2696,2.7,"20"
"6718",22,7,66,4812232,4815209,2977,3,"20"
"6812",22,3,70,4817477,4820369,2892,2.9,"20"
"6919",22,1,60,4822143,4824425,2282,2.3,"20"
"7015",22,6,9,4826047,4828862,2815,2.8,"0"
"7219",22,3,22,4833457,4836235,2778,2.8,"20"
"7414",22,5,40,4840637,4843786,3149,3.1,"20"
"7515",22,7,34,4845455,4848880,3425,3.4,"20"
"7615",22,5,32,4850799,4853704,2905,2.9,"20"
"7815",22,7,58,4857875,4860572,2697,2.7,"20"
"7916",22,1,28,4862521,4866662,4141,4.1,"20"
"8114",22,8,51,4871485,4874915,3430,3.4,"0"
"8217",22,5,72,4877236,4880587,3351,3.4,"20"
"8314",22,6,17,4883727,4887009,3282,3.3,"0"
"8513",22,7,26,4891540,4894779,3239,3.2,"20"
"8715",22,4,39,4900031,4904385,4354,4.4,"0"
"8816",22,8,75,4905897,4909051,3154,3.2,"0"
"8915",22,7,74,4911967,4915630,3663,3.7,"20"
"9015",22,3,46,4917789,4920944,3155,3.2,"20"
"9113",22,1,52,4922890,4926771,3881,3.9,"20"
"9215",22,1,76,4929559,4932464,2905,2.9,"20"
"9314",22,7,18,4934959,4937255,2296,2.3,"20"
"9517",22,3,14,4940890,4943765,2875,2.9,"20"
"9715",22,2,69,4947799,4950191,2392,2.4,"0"
"9818",22,6,41,4951714,4954265,2551,2.6,"0"
"9915",22,4,31,4957893,4960764,2871,2.9,"0"
"10119",22,2,13,4965741,4968472,2731,2.7,"0"
"10317",22,2,61,4972086,4975041,2955,3,"0"
"10413",22,6,1,4977093,4980024,2931,2.9,"0"
"10614",22,6,25,4986313,4988840,2527,2.5,"0"
"10812",22,3,6,4992713,4995702,2989,3,"20"
"11016",22,2,45,5000282,5003030,2748,2.7,"0"
"11120",22,2,21,5004580,5007870,3290,3.3,"0"
"11317",22,4,63,5011400,5014160,2760,2.8,"0"
"11411",22,6,33,5016159,5018382,2223,2.2,"0"
"11517",22,4,47,5020905,5023197,2292,2.3,"0"
"11614",22,2,77,5024899,5027477,2578,2.6,"0"
"11716",22,2,53,5028932,5031947,3015,3,"0"
"11814",22,5,48,5033631,5036852,3221,3.2,"20"
"11915",22,3,54,5039309,5042024,2715,2.7,"20"
"12017",22,8,27,5044007,5047438,3431,3.4,"0"
"10101",23,4,46,21408659,21411716,3057,3.1,"0"
"11100",23,5,39,21413835,21420802,6967,7,"20"
"1222",23,3,45,21423557,21429916,6359,6.4,"20"
"1320",23,2,52,21432319,21435564,3245,3.2,"0"
"1415",23,5,63,21437982,21441940,3958,4,"20"
"1513",23,2,68,21445744,21449761,4017,4,"0"
"1614",23,1,19,21451397,21454863,3466,3.5,"20"
"1816",23,2,28,21459458,21463079,3621,3.6,"0"
"2015",23,2,4,21469027,21472498,3471,3.5,"0"
"2217",23,8,74,21476067,21480619,4552,4.6,"0"
"2315",23,4,70,21482888,21490328,7440,7.4,"0"
"2416",23,4,54,21491713,21496635,4922,4.9,"0"
"2513",23,3,5,21499053,21501902,2849,2.8,"20"
"2714",23,8,42,21506702,21510520,3818,3.8,"0"
"2814",23,7,1,21511754,21514344,2590,2.6,"20"
"3013",23,1,11,21519056,21521364,2308,2.3,"20"
"3214",23,7,9,21528613,21536504,7891,7.9,"20"
"3412",23,5,47,21547008,21549802,2794,2.8,"20"
"3516",23,6,32,21554550,21557408,2858,2.9,"0"
"3714",23,1,51,21561502,21564442,2940,2.9,"20"
"3819",23,6,72,21566360,21569983,3623,3.6,"0"
"3914",23,8,18,21576204,21580269,4065,4.1,"0"
"4114",23,3,21,21602524,21607515,4991,5,"20"
"4315",23,3,37,21613056,21615700,2644,2.6,"20"
"4418",23,8,58,21617725,21620933,3208,3.2,"0"
"4515",23,3,29,21622404,21626911,4507,4.5,"20"
"4717",23,3,13,21630507,21634558,4051,4.1,"20"
"499",23,1,27,21638256,21640818,2562,2.6,"20"
"5115",23,8,26,21644420,21647564,3144,3.1,"0"
"5317",23,6,64,21652699,21655040,2341,2.3,"0"
"5416",23,2,60,21656657,21658425,1768,1.8,"0"
"5517",23,1,43,21659949,21662404,2455,2.5,"20"
"5613",23,2,76,21663857,21672671,8814,8.8,"0"
"5714",23,8,66,21674267,21677260,2993,3,"0"
"5816",23,5,71,21680023,21682876,2853,2.9,"20"
"5916",23,7,33,21684702,21687523,2821,2.8,"20"
"6016",23,3,53,21689193,21692769,3576,3.6,"20"
"6117",23,4,14,21694161,21697556,3395,3.4,"0"
"6313",23,5,23,21702117,21705768,3651,3.7,"20"
"6513",23,7,25,21709509,21714445,4936,4.9,"20"
"6719",23,3,61,21717815,21722069,4254,4.3,"20"
"6813",23,4,30,21723982,21726429,2447,2.4,"0"
"7016",23,7,65,21731017,21736897,5880,5.9,"20"
"7115",23,2,44,21738267,21740323,2056,2.1,"0"
"7220",23,4,78,21741845,21745982,4137,4.1,"0"
"7313",23,5,55,21747479,21752295,4816,4.8,"20"
"7415",23,1,3,21754250,21756543,2293,2.3,"20"
"7616",23,6,24,21761611,21766220,4609,4.6,"0"
"7816",23,5,31,21771484,21779215,7731,7.7,"20"
"8013",23,3,77,21785841,21788699,2858,2.9,"20"
"8115",23,4,6,21790052,21793666,3614,3.6,"0"
"8315",23,4,38,21799592,21801977,2385,2.4,"0"
"8414",23,4,22,21803493,21809764,6271,6.3,"0"
"8615",23,6,8,21814879,21817760,2881,2.9,"0"
"8817",23,2,20,21822742,21827302,4560,4.6,"0"
"9016",23,8,50,21831612,21835170,3558,3.6,"0"
"9114",23,7,41,21836852,21840597,3745,3.7,"20"
"9216",23,7,49,21842211,21846038,3827,3.8,"20"
"9315",23,1,35,21847518,21854778,7260,7.3,"20"
"9411",23,5,7,21856380,21858757,2377,2.4,"20"
"9618",23,2,36,21865449,21867720,2271,2.3,"0"
"9716",23,8,2,21869596,21871557,1961,2,"0"
"9916",23,8,10,21875922,21880556,4634,4.6,"0"
"10120",23,1,59,21886412,21891429,5017,5,"20"
"10219",23,8,34,21893664,21901900,8236,8.2,"0"
"10318",23,4,62,21903255,21906565,3310,3.3,"0"
"10414",23,6,16,21908151,21912545,4394,4.4,"0"
"10615",23,6,80,21916160,21918041,1881,1.9,"0"
"10716",23,7,73,21920838,21924110,3272,3.3,"20"
"10813",23,6,48,21925428,21927851,2423,2.4,"0"
"10919",23,2,12,21929407,21935647,6240,6.2,"0"
"11121",23,6,40,21939159,21945561,6402,6.4,"0"
"11216",23,1,67,21946864,21954124,7260,7.3,"20"
"11318",23,6,56,21955632,21958217,2585,2.6,"0"
"11412",23,5,79,21959539,21961915,2376,2.4,"20"
"11518",23,7,57,21963361,21967284,3923,3.9,"20"
"11615",23,3,69,21969981,21973416,3435,3.4,"20"
"11717",23,7,17,21975646,21979230,3584,3.6,"20"
"11916",23,1,75,21982683,21990214,7531,7.5,"20"
"12018",23,5,15,21992988,21995344,2356,2.4,"20"
"10102",24,5,6,23891157,23897701,6544,6.5,"20"
"1223",24,3,52,23908234,23913045,4811,4.8,"20"
"1321",24,8,17,23919149,23923009,3860,3.9,"0"
"1514",24,6,7,23935389,23942627,7238,7.2,"0"
"1716",24,6,79,23950159,23955693,5534,5.5,"0"
"1817",24,8,57,23958063,23964542,6479,6.5,"0"
"1918",24,4,53,23967091,23971603,4512,4.5,"0"
"2016",24,3,28,23974688,23979270,4582,4.6,"20"
"2218",24,6,55,23986743,23991771,5028,5,"0"
"2316",24,7,32,23993944,23999254,5310,5.3,"20"
"2514",24,6,47,24008012,24012095,4083,4.1,"0"
"2619",24,7,48,24020902,24028864,7962,8,"20"
"2715",24,4,13,24032387,24036672,4285,4.3,"0"
"2920",24,3,4,24042070,24046603,4533,4.5,"20"
"3115",24,3,44,24050773,24056537,5764,5.8,"20"
"3215",24,6,31,24060159,24065115,4956,5,"0"
"3413",24,6,63,24073158,24080045,6887,6.9,"0"
"3517",24,5,78,24085022,24089742,4720,4.7,"20"
"3617",24,1,74,24093831,24099393,5562,5.6,"20"
"3715",24,6,15,24105530,24110146,4616,4.6,"0"
"3915",24,2,59,24117618,24121892,4274,4.3,"0"
"4015",24,2,3,24125929,24129885,3956,4,"0"
"4217",24,3,12,24136553,24143732,7179,7.2,"20"
"4419",24,2,67,24149635,24156499,6864,6.9,"0"
"4516",24,7,80,24160761,24166162,5401,5.4,"20"
"4616",24,4,37,24172492,24176696,4204,4.2,"0"
"4718",24,1,26,24183464,24190072,6608,6.6,"20"
"4910",24,7,56,24195948,24200814,4866,4.9,"20"
"5018",24,5,46,24203113,24212534,9421,9.4,"20"
"5116",24,1,18,24215525,24222264,6739,6.7,"20"
"5318",24,5,14,24233439,24241829,8390,8.4,"20"
"5518",24,5,54,24252470,24258358,5888,5.9,"20"
"5614",24,7,64,24263557,24267846,4289,4.3,"20"
"5715",24,2,11,24270159,24273025,2866,2.9,"0"
"5917",24,7,72,24285475,24293470,7995,8,"20"
"6017",24,1,34,24295732,24301208,5476,5.5,"20"
"6118",24,1,10,24309104,24316213,7109,7.1,"20"
"6314",24,7,40,24323434,24328523,5089,5.1,"20"
"6416",24,1,58,24331985,24338030,6045,6,"20"
"6514",24,6,71,24340124,24344871,4747,4.7,"0"
"6617",24,1,42,24346447,24353269,6822,6.8,"20"
"6720",24,2,51,24354619,24359572,4953,5,"0"
"6814",24,4,69,24362161,24369404,7243,7.2,"0"
"6920",24,7,8,24371509,24379149,7640,7.6,"20"
"7116",24,4,5,24386264,24392144,5880,5.9,"0"
"7314",24,5,62,24398529,24404190,5661,5.7,"20"
"7416",24,4,77,24405905,24412579,6674,6.7,"0"
"7516",24,5,30,24414148,24419071,4923,4.9,"20"
"7716",24,3,36,24425541,24431418,5877,5.9,"20"
"7817",24,8,33,24433723,24437353,3630,3.6,"0"
"7917",24,4,45,24438950,24443111,4161,4.2,"0"
"8014",24,7,24,24445204,24450729,5525,5.5,"20"
"8218",24,8,41,24456913,24462618,5705,5.7,"0"
"8316",24,2,35,24469489,24474904,5415,5.4,"0"
"8415",24,6,39,24477023,24483142,6119,6.1,"0"
"8514",24,7,16,24486048,24490531,4483,4.5,"20"
"8716",24,8,73,24495880,24501942,6062,6.1,"0"
"8818",24,1,2,24504080,24511461,7381,7.4,"20"
"9017",24,2,19,24516846,24521416,4570,4.6,"0"
"9217",24,4,21,24532826,24537657,4831,4.8,"0"
"9412",24,3,76,24542090,24547838,5748,5.7,"20"
"9518",24,8,65,24551564,24559484,7920,7.9,"0"
"9619",24,8,1,24561109,24564845,3736,3.7,"0"
"9819",24,5,22,24570022,24575365,5343,5.3,"20"
"10015",24,2,75,24584437,24591211,6774,6.8,"0"
"10121",24,3,60,24593171,24598541,5370,5.4,"20"
"10220",24,8,25,24602082,24606456,4374,4.4,"0"
"10415",24,2,27,24612987,24618385,5398,5.4,"0"
"10616",24,2,43,24625699,24630562,4863,4.9,"0"
"10717",24,8,49,24636908,24640012,3104,3.1,"0"
"10814",24,3,20,24644293,24649143,4850,4.8,"20"
"11017",24,3,68,24656508,24661246,4738,4.7,"20"
"11122",24,1,66,24662741,24670099,7358,7.4,"20"
"11217",24,6,23,24672229,24680016,7787,7.8,"0"
"11413",24,4,29,24688524,24695758,7234,7.2,"0"
"11616",24,4,61,24703054,24711951,8897,8.9,"0"
"11718",24,5,70,24715505,24725275,9770,9.8,"20"
"11815",24,1,50,24726907,24731361,4454,4.5,"20"
"11917",24,8,9,24736351,24742256,5905,5.9,"0"
"12110",24,5,38,24749912,24755632,5720,5.7,"20"
"10103",25,4,20,2252770,2259114,6344,6.3,"0"
"1224",25,5,29,2268896,2276025,7129,7.1,"20"
"1416",25,5,53,2288014,2295383,7369,7.4,"20"
"1515",25,1,1,2313580,2318308,4728,4.7,"20"
"1717",25,4,4,2356640,2362745,6105,6.1,"0"
"1919",25,2,10,2368172,2373802,5630,5.6,"0"
"2115",25,2,34,2379876,2386431,6555,6.6,"0"
"2219",25,7,15,2388939,2393791,4852,4.9,"20"
"2417",25,5,13,2401053,2406130,5077,5.1,"20"
"2620",25,2,74,2411026,2416429,5403,5.4,"0"
"2716",25,1,41,2418918,2424567,5649,5.6,"20"
"2815",25,3,43,2427404,2432045,4641,4.6,"20"
"2921",25,4,28,2433654,2441337,7683,7.7,"0"
"3116",25,1,49,2451413,2457400,5987,6,"20"
"3216",25,8,80,2458970,2463342,4372,4.4,"0"
"3319",25,8,8,2464882,2469735,4853,4.9,"0"
"3518",25,7,71,2476406,2481347,4941,4.9,"20"
"3618",25,4,60,2484550,2488850,4300,4.3,"0"
"3716",25,6,70,2490506,2495956,5450,5.5,"0"
"3820",25,5,61,2497593,2504447,6854,6.9,"20"
"3916",25,8,40,2506666,2511516,4850,4.8,"0"
"4016",25,4,36,2515003,2520170,5167,5.2,"0"
"4115",25,6,30,2522919,2527387,4468,4.5,"0"
"4316",25,3,51,2533753,2539218,5465,5.5,"20"
"4420",25,4,52,2541235,2546889,5654,5.7,"0"
"4517",25,2,58,2549285,2556820,7535,7.5,"0"
"4617",25,1,57,2558829,2563694,4865,4.9,"20"
"4719",25,3,67,2565479,2570751,5272,5.3,"20"
"4816",25,3,11,2572456,2576414,3958,4,"20"
"5019",25,7,79,2583913,2588921,5008,5,"20"
"5117",25,6,6,2592648,2599604,6956,7,"0"
"5319",25,8,24,2608142,2615290,7148,7.1,"0"
"5519",25,7,31,2622902,2628010,5108,5.1,"20"
"5716",25,3,35,2636489,2641254,4765,4.8,"20"
"5817",25,1,33,2644420,2648212,3792,3.8,"20"
"5918",25,2,26,2650338,2654637,4299,4.3,"0"
"6119",25,8,72,2660666,2666571,5905,5.9,"0"
"6216",25,5,77,2671742,2676606,4864,4.9,"20"
"6315",25,7,63,2680541,2686379,5838,5.8,"20"
"6417",25,1,25,2690284,2695006,4722,4.7,"20"
"6618",25,4,76,2702486,2708378,5892,5.9,"0"
"6721",25,1,73,2710682,2716004,5322,5.3,"20"
"6815",25,3,3,2719071,2723539,4468,4.5,"20"
"7017",25,3,75,2734331,2739763,5432,5.4,"20"
"7117",25,4,44,2744540,2749234,4694,4.7,"0"
"7221",25,2,50,2753066,2758738,5672,5.7,"0"
"7315",25,4,68,2760588,2765724,5136,5.1,"0"
"7417",25,2,2,2768987,2773937,4950,5,"0"
"7617",25,2,18,2783041,2786736,3695,3.7,"0"
"7818",25,4,12,2792685,2796206,3521,3.5,"0"
"8015",25,2,66,2806363,2811171,4808,4.8,"0"
"8116",25,1,65,2813336,2819131,5795,5.8,"20"
"8219",25,5,45,2822468,2826716,4248,4.2,"20"
"8317",25,6,62,2831569,2837449,5880,5.9,"0"
"8416",25,6,22,2879900,2884902,5002,5,"0"
"8616",25,1,9,2889817,2894724,4907,4.9,"20"
"8819",25,6,14,2899883,2904147,4264,4.3,"0"
"9018",25,7,7,2910495,2917086,6591,6.6,"20"
"9218",25,5,21,2925801,2931432,5631,5.6,"20"
"9413",25,7,23,2936901,2943846,6945,6.9,"20"
"9620",25,5,69,2950163,2954906,4743,4.7,"20"
"9717",25,1,17,2957434,2962815,5381,5.4,"20"
"9917",25,7,39,2970115,2975069,4954,5,"20"
"10016",25,8,56,2976988,2980642,3654,3.7,"0"
"10122",25,6,54,2985105,2992220,7115,7.1,"0"
"10221",25,6,46,2994354,2999252,4898,4.9,"0"
"10319",25,5,37,3001300,3006702,5402,5.4,"20"
"10416",25,8,64,3008486,3013071,4585,4.6,"0"
"10519",25,2,42,3014900,3019591,4691,4.7,"0"
"10617",25,8,48,3021849,3025632,3783,3.8,"0"
"10718",25,8,16,3027523,3030858,3335,3.3,"0"
"10920",25,6,38,3037146,3042296,5150,5.2,"0"
"11018",25,3,19,3043966,3047598,3632,3.6,"20"
"11218",25,7,55,3057146,3061941,4795,4.8,"20"
"11319",25,7,47,3064570,3067818,3248,3.2,"20"
"11414",25,5,5,3071177,3075764,4587,4.6,"20"
"11617",25,8,32,3083396,3088479,5083,5.1,"0"
"11816",25,3,27,3095697,3102262,6565,6.6,"20"
"12019",25,3,59,3111413,3116244,4831,4.8,"20"
"12111",25,6,78,3118069,3121322,3253,3.3,"0"
"10104",26,5,4,5189259,5196572,7313,7.3,"20"
"1225",26,7,6,5203485,5209698,6213,6.2,"20"
"1417",26,4,35,5222304,5227488,5184,5.2,"0"
"1516",26,5,20,5231044,5238282,7238,7.2,"20"
"1718",26,6,69,5252356,5257208,4852,4.9,"0"
"1818",26,3,26,5260913,5272895,11982,12,"20"
"2017",26,4,67,5279654,5286059,6405,6.4,"0"
"2116",26,6,29,5328343,5336639,8296,8.3,"0"
"2317",26,4,11,5341035,5344871,3836,3.8,"0"
"2515",26,4,19,5349581,5351998,2417,2.4,"0"
"2717",26,4,51,5362227,5367165,4938,4.9,"0"
"2816",26,6,77,5371063,5374501,3438,3.4,"0"
"2922",26,2,1,5377328,5382820,5492,5.5,"0"
"3117",26,7,70,5388224,5402919,14695,14.7,"20"
"3217",26,5,60,5404266,5413057,8791,8.8,"20"
"3320",26,6,53,5416455,5421404,4949,4.9,"0"
"3414",26,3,50,5423595,5426503,2908,2.9,"20"
"3519",26,1,80,5428601,5434043,5442,5.4,"20"
"3619",26,8,79,5437347,5443720,6373,6.4,"0"
"3717",26,7,14,5445983,5456206,10223,10.2,"20"
"3917",26,3,34,5462655,5468747,6092,6.1,"20"
"4017",26,2,33,5470111,5474939,4828,4.8,"0"
"4116",26,4,27,5476521,5483217,6696,6.7,"0"
"4317",26,8,31,5489729,5502291,12562,12.6,"0"
"4518",26,6,21,5508349,5513447,5098,5.1,"0"
"4720",26,1,40,5519191,5529621,10430,10.4,"20"
"4817",26,7,46,5533380,5537774,4394,4.4,"20"
"4911",26,1,64,5539111,5542535,3424,3.4,"20"
"5020",26,2,65,5544552,5547969,3417,3.4,"0"
"5118",26,7,78,5549704,5557440,7736,7.7,"20"
"5217",26,1,16,5560619,5563144,2525,2.5,"20"
"5417",26,1,72,5568116,5572834,4718,4.7,"20"
"5520",26,2,41,5574452,5579861,5409,5.4,"0"
"5615",26,5,68,5582054,5588013,5959,6,"20"
"5717",26,8,15,5591262,5598197,6935,6.9,"0"
"5919",26,2,57,5602622,5607410,4788,4.8,"0"
"6018",26,2,49,5610712,5621422,10710,10.7,"0"
"6120",26,4,43,5623376,5632672,9296,9.3,"0"
"6217",26,8,63,5634176,5638980,4804,4.8,"0"
"6316",26,7,54,5641472,5655027,13555,13.6,"20"
"6418",26,1,56,5656319,5659982,3663,3.7,"20"
"6515",26,5,76,5661359,5667404,6045,6,"20"
"6619",26,2,9,5669405,5673437,4032,4,"0"
"6816",26,3,74,5677640,5683666,6026,6,"20"
"6921",26,8,47,5685101,5689371,4270,4.3,"0"
"7018",26,6,5,5692129,5699899,7770,7.8,"0"
"7222",26,7,30,5703706,5711780,8074,8.1,"20"
"7418",26,5,28,5717400,5721350,3950,4,"20"
"7618",26,3,18,5725448,5729410,3962,4,"20"
"7819",26,2,73,5733075,5744164,11089,11.1,"0"
"7918",26,5,36,5746428,5754077,7649,7.6,"20"
"8016",26,8,7,5755460,5760946,5486,5.5,"0"
"8220",26,7,22,5768417,5774794,6377,6.4,"20"
"8417",26,3,66,5779950,5786905,6955,7,"20"
"8515",26,4,75,5788650,5793064,4414,4.4,"0"
"8617",26,5,52,5795360,5800719,5359,5.4,"20"
"8717",26,4,3,5802269,5810313,8044,8,"0"
"8916",26,4,59,5815821,5820186,4365,4.4,"0"
"9019",26,1,8,5824240,5827260,3020,3,"20"
"9219",26,3,42,5831012,5837678,6666,6.7,"20"
"9316",26,3,10,5839164,5843227,4063,4.1,"20"
"9519",26,6,61,5847336,5855137,7801,7.8,"0"
"9621",26,7,62,5856888,5863804,6916,6.9,"20"
"9718",26,3,2,5865694,5868644,2950,3,"20"
"9918",26,6,45,5873248,5876288,3040,3,"0"
"10017",26,1,32,5878064,5881391,3327,3.3,"20"
"10222",26,1,24,5885750,5892709,6959,7,"20"
"10417",26,2,17,5896315,5901771,5456,5.5,"0"
"10618",26,8,71,5905701,5910878,5177,5.2,"0"
"10719",26,5,44,5912149,5917592,5443,5.4,"20"
"10815",26,7,38,5919261,5928792,9531,9.5,"20"
"10921",26,6,13,5930251,5939004,8753,8.8,"0"
"11123",26,3,58,5942410,5945877,3467,3.5,"20"
"11219",26,2,25,5947220,5952595,5375,5.4,"0"
"11415",26,1,48,5957123,5964747,7624,7.6,"20"
"11519",26,5,12,5967382,5970902,3520,3.5,"20"
"11719",26,8,39,5975867,5981188,5321,5.3,"0"
"11817",26,8,55,5983936,5987787,3851,3.9,"0"
"11918",26,8,23,5989097,5993189,4092,4.1,"0"
"12112",26,6,37,5996515,6002441,5926,5.9,"0"
"10105",27,2,40,18997560,19002123,4563,4.6,"0"
"11101",27,2,24,19003598,19010240,6642,6.6,"0"
"1322",27,5,11,19017478,19022750,5272,5.3,"20"
"1517",27,8,30,19029061,19034886,5825,5.8,"0"
"1719",27,1,23,19039422,19048278,8856,8.9,"20"
"1920",27,5,75,19052532,19058356,5824,5.8,"20"
"2018",27,3,9,19059764,19066843,7079,7.1,"20"
"2220",27,4,34,19072837,19078922,6085,6.1,"0"
"2318",27,4,18,19081380,19086091,4711,4.7,"0"
"2516",27,5,35,19096376,19101833,5457,5.5,"20"
"2621",27,3,73,19104950,19112362,7412,7.4,"20"
"2718",27,2,16,19115393,19119514,4121,4.1,"0"
"2923",27,2,64,19124477,19128518,4041,4,"0"
"3014",27,3,25,19131633,19136090,4457,4.5,"20"
"3218",27,1,63,19141294,19147086,5792,5.8,"20"
"3321",27,5,43,19148649,19155993,7344,7.3,"20"
"3415",27,7,13,19157686,19164341,6655,6.7,"20"
"3620",27,5,59,19168681,19175325,6644,6.6,"20"
"3718",27,1,7,19177136,19181421,4285,4.3,"20"
"3918",27,4,26,19186703,19191576,4873,4.9,"0"
"4117",27,7,37,19197531,19203673,6142,6.1,"20"
"4218",27,1,31,19205031,19209598,4567,4.6,"20"
"4421",27,2,56,19213899,19218513,4614,4.6,"0"
"4519",27,6,44,19220879,19227439,6560,6.6,"0"
"4618",27,3,57,19229472,19235802,6330,6.3,"20"
"4721",27,8,14,19237185,19241863,4678,4.7,"0"
"4912",27,8,38,19247404,19253487,6083,6.1,"0"
"5021",27,7,69,19256227,19260968,4741,4.7,"20"
"5119",27,8,78,19265936,19270551,4615,4.6,"0"
"5218",27,7,5,19272539,19278141,5602,5.6,"20"
"5418",27,7,29,19283670,19289039,5369,5.4,"20"
"5616",27,3,49,19293561,19296487,2926,2.9,"20"
"5718",27,1,71,19298414,19302057,3643,3.6,"20"
"5818",27,1,79,19305957,19309365,3408,3.4,"20"
"5920",27,5,27,19312393,19316225,3832,3.8,"20"
"6121",27,4,10,19319710,19325226,5516,5.5,"0"
"6317",27,8,54,19329941,19335080,5139,5.1,"0"
"6419",27,2,48,19336856,19340597,3741,3.7,"0"
"6516",27,7,45,19342088,19345457,3369,3.4,"20"
"6620",27,6,12,19346907,19350686,3779,3.8,"0"
"6817",27,2,80,19355708,19358819,3111,3.1,"0"
"6922",27,4,2,19360414,19364299,3885,3.9,"0"
"7118",27,8,70,19368450,19372813,4363,4.4,"0"
"7223",27,6,28,19374343,19377997,3654,3.7,"0"
"7419",27,3,17,19385416,19392133,6717,6.7,"20"
"7619",27,8,6,19396548,19404912,8364,8.4,"0"
"7820",27,4,66,19409539,19413558,4019,4,"0"
"7919",27,1,15,19415582,19419046,3464,3.5,"20"
"8117",27,8,62,19423436,19429783,6347,6.3,"0"
"8221",27,2,32,19431524,19435886,4362,4.4,"0"
"8418",27,6,52,19441238,19446108,4870,4.9,"0"
"8516",27,8,22,19447698,19452954,5256,5.3,"0"
"8718",27,6,4,19459233,19463654,4421,4.4,"0"
"8917",27,5,67,19468042,19474066,6024,6,"20"
"9020",27,1,39,19476828,19481554,4726,4.7,"20"
"9115",27,1,55,19483543,19487832,4289,4.3,"20"
"9220",27,6,60,19491561,19495300,3739,3.7,"0"
"9317",27,2,72,19497079,19503682,6603,6.6,"0"
"9414",27,4,58,19505940,19509875,3935,3.9,"0"
"9520",27,4,42,19511914,19516720,4806,4.8,"0"
"9622",27,7,21,19519736,19523633,3897,3.9,"20"
"9820",27,7,77,19528418,19532184,3766,3.8,"20"
"9919",27,6,20,19534712,19537278,2566,2.6,"0"
"10123",27,4,74,19541506,19555613,14107,14.1,"0"
"10223",27,3,33,19557578,19560940,3362,3.4,"20"
"10320",27,2,8,19562621,19565663,3042,3,"0"
"10520",27,6,68,19570400,19575196,4796,4.8,"0"
"10619",27,5,3,19577062,19584197,7135,7.1,"20"
"10816",27,7,53,19588579,19595799,7220,7.2,"20"
"10922",27,5,19,19597592,19600072,2480,2.5,"20"
"11124",27,7,61,19605575,19609502,3927,3.9,"20"
"11220",27,3,65,19611565,19615672,4107,4.1,"20"
"11320",27,3,1,19618428,19624220,5792,5.8,"20"
"11520",27,4,50,19628568,19633168,4600,4.6,"0"
"11618",27,8,46,19634741,19639849,5108,5.1,"0"
"11720",27,6,36,19642965,19649306,6341,6.3,"0"
"11818",27,3,41,19651386,19656858,5472,5.5,"20"
"11919",27,1,47,19659461,19662769,3308,3.3,"20"
"12020",27,6,76,19664642,19668453,3811,3.8,"0"
"12113",27,5,51,19670803,19677815,7012,7,"20"
"10106",28,2,39,20966772,20970369,3597,3.6,"0"
"11102",28,7,44,20972942,20977348,4406,4.4,"20"
"1226",28,4,65,20979066,20982868,3802,3.8,"0"
"1323",28,8,13,20984290,20988131,3841,3.8,"0"
"1518",28,5,66,20992153,21001566,9413,9.4,"20"
"1615",28,4,9,21003794,21007271,3477,3.5,"0"
"1819",28,2,47,21010617,21012942,2325,2.3,"0"
"1921",28,5,26,21014879,21019335,4456,4.5,"20"
"2117",28,6,11,21023800,21026247,2447,2.4,"0"
"2319",28,8,5,21030266,21034386,4120,4.1,"0"
"2517",28,4,17,21038467,21043471,5004,5,"0"
"2719",28,1,46,21047056,21051618,4562,4.6,"20"
"2817",28,4,49,21053161,21055745,2584,2.6,"0"
"2924",28,6,75,21057579,21060119,2540,2.5,"0"
"3015",28,6,27,21062209,21065906,3697,3.7,"0"
"3219",28,1,62,21069426,21073513,4087,4.1,"20"
"3322",28,1,78,21075398,21079239,3841,3.8,"20"
"3416",28,3,32,21080710,21083776,3066,3.1,"20"
"3621",28,7,36,21087451,21091564,4113,4.1,"20"
"3719",28,1,22,21092981,21096235,3254,3.3,"20"
"3919",28,7,60,21099685,21103265,3580,3.6,"20"
"4018",28,2,55,21104816,21108053,3237,3.2,"0"
"4118",28,4,1,21111009,21114080,3071,3.1,"0"
"4318",28,5,74,21117572,21121421,3849,3.8,"20"
"4422",28,7,52,21122970,21128372,5402,5.4,"20"
"4520",28,3,16,21129928,21132595,2667,2.7,"20"
"4722",28,4,41,21136237,21139046,2809,2.8,"0"
"4818",28,1,6,21140314,21145599,5285,5.3,"20"
"5022",28,8,69,21150421,21153731,3310,3.3,"0"
"5120",28,8,21,21155144,21158465,3321,3.3,"0"
"5320",28,5,2,21161932,21164625,2693,2.7,"20"
"5521",28,2,23,21168535,21172535,4000,4,"0"
"5719",28,7,20,21175837,21179190,3353,3.4,"20"
"5921",28,6,51,21182751,21185913,3162,3.2,"0"
"6019",28,2,71,21187344,21189798,2454,2.5,"0"
"6122",28,4,57,21194034,21198004,3970,4,"0"
"6218",28,4,73,21199604,21203287,3683,3.7,"0"
"6318",28,7,4,21204811,21209897,5086,5.1,"20"
"6517",28,7,68,21213104,21217295,4191,4.2,"20"
"6621",28,5,58,21218735,21223448,4713,4.7,"20"
"6722",28,3,64,21225480,21232149,6669,6.7,"20"
"6818",28,3,80,21233545,21236232,2687,2.7,"20"
"6923",28,4,33,21239369,21241966,2597,2.6,"0"
"7019",28,6,59,21243338,21248039,4701,4.7,"0"
"7119",28,8,53,21249505,21253466,3961,4,"0"
"7224",28,2,15,21254838,21257843,3005,3,"0"
"7420",28,7,28,21261132,21266480,5348,5.3,"20"
"7620",28,1,54,21271063,21276074,5011,5,"20"
"7717",28,3,72,21277453,21283782,6329,6.3,"20"
"7821",28,3,40,21285211,21288595,3384,3.4,"20"
"7920",28,5,34,21289852,21295254,5402,5.4,"20"
"8017",28,7,76,21296697,21302250,5553,5.6,"20"
"8118",28,6,67,21303849,21308420,4571,4.6,"0"
"8222",28,3,8,21309998,21315320,5322,5.3,"20"
"8419",28,5,42,21318816,21322690,3874,3.9,"20"
"8517",28,2,7,21324433,21330838,6405,6.4,"0"
"8719",28,4,25,21335410,21338294,2884,2.9,"0"
"8918",28,3,48,21341610,21346626,5016,5,"20"
"9021",28,6,35,21348078,21350631,2553,2.6,"0"
"9116",28,6,3,21352081,21355335,3254,3.3,"0"
"9318",28,3,56,21359730,21363886,4156,4.2,"20"
"9415",28,8,29,21365585,21368406,2821,2.8,"0"
"9623",28,1,14,21371860,21375305,3445,3.4,"20"
"9821",28,8,37,21378694,21383231,4537,4.5,"0"
"9920",28,5,10,21384785,21389063,4278,4.3,"20"
"10124",28,3,24,21393336,21400065,6729,6.7,"20"
"10321",28,8,61,21403752,21408815,5063,5.1,"0"
"10418",28,8,77,21414267,21417967,3700,3.7,"0"
"10521",28,6,19,21419390,21421984,2594,2.6,"0"
"10720",28,2,63,21425320,21431033,5713,5.7,"0"
"10817",28,2,79,21432578,21435088,2510,2.5,"0"
"10923",28,5,18,21436625,21440043,3418,3.4,"20"
"11125",28,1,70,21443783,21449317,5534,5.5,"20"
"11221",28,8,45,21450950,21453334,2384,2.4,"0"
"11321",28,6,43,21455205,21457675,2470,2.5,"0"
"11416",28,5,50,21458996,21462171,3175,3.2,"20"
"11521",28,1,38,21464828,21469180,4352,4.4,"20"
"11619",28,2,31,21470755,21474054,3299,3.3,"0"
"11819",28,1,30,21477162,21480126,2964,3,"20"
"12021",28,7,12,21484560,21487574,3014,3,"20"
"10107",29,2,62,9391027,9398696,7669,7.7,"0"
"11103",29,3,31,9401425,9406634,5209,5.2,"20"
"1324",29,4,32,9412473,9417335,4862,4.9,"0"
"1519",29,2,22,9421798,9426074,4276,4.3,"0"
"1720",29,2,38,9431740,9438648,6908,6.9,"0"
"1820",29,2,30,9440802,9444029,3227,3.2,"0"
"2019",29,5,17,9448369,9454550,6181,6.2,"20"
"2221",29,3,15,9459516,9463237,3721,3.7,"20"
"2418",29,6,18,9467314,9472066,4752,4.8,"0"
"2622",29,8,60,9478454,9482492,4038,4,"0"
"2720",29,3,71,9484927,9488684,3757,3.8,"20"
"2818",29,6,50,9492344,9497441,5097,5.1,"0"
"2925",29,6,2,9498873,9502555,3682,3.7,"0"
"3118",29,5,9,9507892,9512727,4835,4.8,"20"
"3323",29,3,39,9517907,9523838,5931,5.9,"20"
"3417",29,6,66,9526608,9531234,4626,4.6,"0"
"3520",29,6,74,9534126,9538100,3974,4,"0"
"3622",29,1,53,9540467,9546873,6406,6.4,"20"
"3720",29,6,10,9549248,9553246,3998,4,"0"
"3920",29,1,61,9558156,9567503,9347,9.3,"20"
"4019",29,8,76,9569436,9575487,6051,6.1,"0"
"4119",29,3,47,9577048,9580478,3430,3.4,"20"
"4219",29,3,23,9583209,9586868,3659,3.7,"20"
"4423",29,5,49,9591959,9595088,3129,3.1,"20"
"4521",29,7,59,9598435,9604378,5943,5.9,"20"
"4619",29,5,1,9608060,9611476,3416,3.4,"20"
"4819",29,8,52,9616493,9622460,5967,6,"0"
"4913",29,7,43,9626418,9632581,6163,6.2,"20"
"5023",29,1,37,9634249,9639819,5570,5.6,"20"
"5121",29,4,16,9642180,9646331,4151,4.2,"0"
"5321",29,6,42,9651648,9656367,4719,4.7,"0"
"5419",29,4,72,9658003,9663100,5097,5.1,"0"
"5522",29,7,75,9665722,9670690,4968,5,"20"
"5617",29,1,69,9672572,9678334,5762,5.8,"20"
"5720",29,6,34,9681157,9685625,4468,4.5,"0"
"5819",29,5,33,9687862,9691182,3320,3.3,"20"
"5922",29,3,7,9694835,9701742,6907,6.9,"20"
"6123",29,3,63,9707548,9711291,3743,3.7,"20"
"6219",29,7,19,9713187,9716353,3166,3.2,"20"
"6420",29,5,41,9723226,9727286,4060,4.1,"20"
"6518",29,8,12,9728959,9732525,3566,3.6,"0"
"6723",29,1,77,9738735,9742414,3679,3.7,"20"
"6819",29,3,79,9744118,9748012,3894,3.9,"20"
"6924",29,5,57,9749382,9753694,4312,4.3,"20"
"7020",29,2,78,9755121,9758507,3386,3.4,"0"
"7120",29,8,68,9759895,9763860,3965,4,"0"
"7225",29,4,24,9765525,9769048,3523,3.5,"0"
"7421",29,1,5,9773888,9779929,6041,6,"20"
"7621",29,4,40,9784287,9788614,4327,4.3,"0"
"7718",29,4,8,9791813,9797044,5231,5.2,"0"
"7921",29,7,35,9802923,9807573,4650,4.7,"20"
"8018",29,2,54,9809502,9814657,5155,5.2,"0"
"8119",29,4,56,9816405,9819643,3238,3.2,"0"
"8223",29,4,64,9822402,9827249,4847,4.8,"0"
"8318",29,2,46,9829597,9833105,3508,3.5,"0"
"8420",29,8,20,9834492,9837445,2953,3,"0"
"8618",29,2,6,9843498,9848912,5414,5.4,"0"
"8820",29,5,73,9853158,9857210,4052,4.1,"20"
"8919",29,2,70,9859607,9863793,4186,4.2,"0"
"9022",29,4,80,9867751,9871056,3305,3.3,"0"
"9117",29,6,26,9872644,9877252,4608,4.6,"0"
"9319",29,6,58,9882954,9887653,4699,4.7,"0"
"9416",29,8,44,9890438,9893953,3515,3.5,"0"
"9521",29,8,28,9897775,9901788,4013,4,"0"
"9719",29,8,4,9908194,9913812,5618,5.6,"0"
"9921",29,1,45,9918496,9922428,3932,3.9,"20"
"10018",29,1,13,9923809,9927551,3742,3.7,"20"
"10224",29,3,55,9931890,9935657,3767,3.8,"20"
"10322",29,1,21,9937619,9940596,2977,3,"20"
"10522",29,7,3,9945162,9951170,6008,6,"20"
"10721",29,5,25,9955162,9959367,4205,4.2,"20"
"10924",29,4,48,9964734,9968072,3338,3.3,"0"
"11019",29,7,11,9970654,9974753,4099,4.1,"20"
"11222",29,2,14,9979758,9985741,5983,6,"0"
"11417",29,7,67,9991837,9999258,7421,7.4,"20"
"11522",29,5,65,10002703,10006327,3624,3.6,"20"
"11620",29,8,36,10008194,10011233,3039,3,"0"
"11721",29,1,29,10012961,10016562,3601,3.6,"20"
"11920",29,7,27,10023174,10026997,3823,3.8,"20"
"12114",29,7,51,10031734,10035075,3341,3.3,"20"
"10108",30,6,49,3598041,3605271,7230,7.2,"0"
"11104",30,4,15,3665908,3671173,5265,5.3,"0"
"1325",30,3,22,3678000,3684581,6581,6.6,"20"
"1520",30,6,17,3689244,3694677,5433,5.4,"0"
"1721",30,7,34,3699795,3706917,7122,7.1,"20"
"1821",30,2,45,3708864,3716937,8073,8.1,"0"
"1922",30,8,11,3719526,3725222,5696,5.7,"0"
"2118",30,6,33,3729326,3733804,4478,4.5,"0"
"2222",30,3,14,3737861,3745541,7680,7.7,"20"
"2419",30,2,61,3753138,3758760,5622,5.6,"0"
"2518",30,8,51,3779736,3784454,4718,4.7,"0"
"2623",30,7,66,3788791,3796064,7273,7.3,"20"
"2721",30,4,47,3799290,3802333,3043,3,"0"
"2819",30,4,23,3805012,3808932,3920,3.9,"0"
"3016",30,5,32,3819087,3823040,3953,4,"20"
"3220",30,5,64,3832600,3837409,4809,4.8,"20"
"3324",30,5,16,3840286,3845039,4753,4.8,"20"
"3521",30,2,69,3850936,3851005,69,0.1,"0"
"3623",30,2,37,3856323,3863080,6757,6.8,"0"
"3721",30,6,25,3866138,3872443,6305,6.3,"0"
"3921",30,1,4,3878596,3883658,5062,5.1,"20"
"4120",30,3,78,3889869,3897108,7239,7.2,"20"
"4220",30,4,7,3900700,3906344,5644,5.6,"0"
"4424",30,1,68,3914660,3919270,4610,4.6,"20"
"4522",30,4,71,3924659,3929100,4441,4.4,"0"
"4620",30,1,12,3933045,3938767,5722,5.7,"20"
"4820",30,5,24,3945075,3950811,5736,5.7,"20"
"5024",30,2,77,3956246,3961458,5212,5.2,"0"
"5122",30,7,26,3965347,3971965,6618,6.6,"20"
"5322",30,4,63,4002857,4009633,6776,6.8,"0"
"5420",30,6,57,4011845,4014825,2980,3,"0"
"5523",30,7,18,4018135,4018199,64,0.1,"20"
"5721",30,1,44,4028672,4033516,4844,4.8,"20"
"5820",30,1,36,4035696,4039627,3931,3.9,"20"
"5923",30,7,50,4041930,4051363,9433,9.4,"20"
"6020",30,3,38,4054403,4059613,5210,5.2,"20"
"6124",30,8,19,4062347,4070706,8359,8.4,"0"
"6319",30,8,27,4082388,4086372,3984,4,"0"
"6519",30,6,73,4091467,4096577,5110,5.1,"0"
"6622",30,3,62,4099301,4104642,5341,5.3,"20"
"6724",30,2,5,4107800,4111144,3344,3.3,"0"
"6925",30,8,75,4117954,4121341,3387,3.4,"0"
"7021",30,3,46,4123741,4127905,4164,4.2,"20"
"7121",30,7,2,4131203,4135082,3879,3.9,"20"
"7316",30,5,56,4143670,4149200,5530,5.5,"20"
"7422",30,4,39,4152958,4158289,5331,5.3,"0"
"7517",30,5,48,4160867,4164825,3958,4,"20"
"7622",30,8,43,4167470,4171620,4150,4.2,"0"
"7719",30,3,30,4174669,4178238,3569,3.6,"20"
"7922",30,8,35,4182428,4188988,6560,6.6,"0"
"8019",30,8,67,4191326,4194396,3070,3.1,"0"
"8120",30,7,58,4197886,4201634,3748,3.7,"20"
"8224",30,8,3,4203479,4207220,3741,3.7,"0"
"8421",30,1,60,4212976,4219634,6658,6.7,"20"
"8518",30,6,41,4223309,4226920,3611,3.6,"0"
"8619",30,1,52,4228954,4235179,6225,6.2,"20"
"8720",30,6,65,4237345,4242645,5300,5.3,"0"
"8821",30,1,76,4245461,4245478,17,0,"20"
"8920",30,7,42,4249411,4259744,10333,10.3,"20"
"9023",30,1,20,4261344,4265583,4239,4.2,"20"
"9221",30,2,13,4270775,4274883,4108,4.1,"0"
"9417",30,5,80,4279243,4283374,4131,4.1,"20"
"9522",30,4,55,4285748,4290435,4687,4.7,"0"
"9624",30,3,6,4293269,4298661,5392,5.4,"20"
"9822",30,5,40,4304594,4308038,3444,3.4,"20"
"9922",30,2,29,4309556,4314203,4647,4.6,"0"
"10125",30,2,53,4318349,4323530,5181,5.2,"0"
"10225",30,7,10,4325604,4329361,3757,3.8,"20"
"10419",30,6,1,4336241,4339923,3682,3.7,"0"
"10620",30,3,70,4345321,4352714,7393,7.4,"20"
"10722",30,6,9,4354685,4359657,4972,5,"0"
"10925",30,5,72,4365721,4372050,6329,6.3,"20"
"11020",30,4,79,4375840,4380272,4432,4.4,"0"
"11126",30,8,59,4382247,4385383,3136,3.1,"0"
"11223",30,2,21,4387341,4389967,2626,2.6,"0"
"11418",30,1,28,4394738,4401230,6492,6.5,"20"
"11621",30,4,31,4407690,4412345,4655,4.7,"0"
"11820",30,3,54,4416259,4426554,10295,10.3,"20"
"11921",30,5,8,4429598,4433911,4313,4.3,"20"
"12115",30,7,74,4438606,4442660,4054,4.1,"20"
"10109",31,2,12,4017074,4019528,2454,2.5,"0"
"1227",31,4,38,4023298,4026658,3360,3.4,"0"
"1326",31,6,64,4028914,4031543,2629,2.6,"0"
"1418",31,2,4,4033806,4036957,3151,3.2,"0"
"1616",31,7,33,4040574,4043167,2593,2.6,"20"
"1722",31,1,19,4044513,4047340,2827,2.8,"20"
"1923",31,4,22,4052648,4056014,3366,3.4,"0"
"2119",31,7,65,4059729,4063046,3317,3.3,"20"
"2223",31,8,66,4065256,4067476,2220,2.2,"0"
"2320",31,2,36,4069274,4074941,5667,5.7,"0"
"2420",31,2,20,4077576,4080031,2455,2.5,"0"
"2624",31,5,31,4083624,4086219,2595,2.6,"20"
"2820",31,6,40,4090207,4093082,2875,2.9,"0"
"2926",31,3,69,4094531,4096899,2368,2.4,"20"
"3017",31,8,58,4098670,4100979,2309,2.3,"0"
"3119",31,2,52,4103000,4106483,3483,3.5,"0"
"3221",31,8,26,4108197,4111260,3063,3.1,"0"
"3418",31,6,24,4115926,4118891,2965,3,"0"
"3624",31,7,1,4123044,4125214,2170,2.2,"20"
"3821",31,7,25,4129052,4131352,2300,2.3,"20"
"4020",31,8,2,4135404,4138348,2944,2.9,"0"
"4221",31,1,35,4142080,4144106,2026,2,"20"
"4319",31,4,14,4145885,4149042,3157,3.2,"0"
"4523",31,6,72,4152659,4156183,3524,3.5,"0"
"4621",31,2,60,4158023,4160136,2113,2.1,"0"
"4723",31,7,57,4161567,4163938,2371,2.4,"20"
"4821",31,2,28,4165736,4168488,2752,2.8,"0"
"5025",31,6,80,4172662,4175127,2465,2.5,"0"
"5123",31,4,54,4176728,4179540,2812,2.8,"0"
"5219",31,6,48,4181046,4183969,2923,2.9,"0"
"5323",31,3,77,4185487,4187440,1953,2,"20"
"5421",31,3,45,4189127,4191461,2334,2.3,"20"
"5524",31,5,79,4193413,4195653,2240,2.2,"20"
"5618",31,5,71,4197456,4199661,2205,2.2,"20"
"5722",31,7,73,4201387,4203771,2384,2.4,"20"
"5821",31,6,8,4205227,4207693,2466,2.5,"0"
"6021",31,1,75,4212618,4214975,2357,2.4,"20"
"6125",31,3,21,4216457,4218925,2468,2.5,"20"
"6320",31,7,41,4223534,4226125,2591,2.6,"20"
"6421",31,1,59,4227776,4230601,2825,2.8,"20"
"6520",31,1,51,4231923,4234395,2472,2.5,"20"
"6623",31,1,11,4237106,4239301,2195,2.2,"20"
"6820",31,2,44,4242907,4245358,2451,2.5,"0"
"6926",31,7,9,4246865,4249562,2697,2.7,"20"
"7122",31,3,29,4253708,4256065,2357,2.4,"20"
"7317",31,3,53,4259421,4262426,3005,3,"20"
"7423",31,7,49,4264711,4266642,1931,1.9,"20"
"7518",31,4,78,4268232,4271047,2815,2.8,"0"
"7623",31,2,68,4272630,4275309,2679,2.7,"0"
"7720",31,7,17,4277093,4280186,3093,3.1,"20"
"7923",31,5,55,4283657,4286263,2606,2.6,"20"
"8020",31,4,46,4287723,4290564,2841,2.8,"0"
"8121",31,3,61,4291899,4294648,2749,2.7,"20"
"8225",31,6,56,4296796,4299114,2318,2.3,"0"
"8319",31,4,30,4301470,4303778,2308,2.3,"0"
"8519",31,6,16,4307446,4309790,2344,2.3,"0"
"8721",31,1,3,4314096,4316441,2345,2.3,"20"
"8921",31,3,5,4319962,4322608,2646,2.6,"20"
"9118",31,5,47,4326388,4329969,3581,3.6,"20"
"9222",31,4,70,4331608,4334583,2975,3,"0"
"9320",31,2,76,4336622,4340008,3386,3.4,"0"
"9418",31,8,10,4342050,4344619,2569,2.6,"0"
"9625",31,8,34,4348332,4351393,3061,3.1,"0"
"9720",31,1,67,4353126,4355347,2221,2.2,"20"
"9823",31,3,13,4357066,4359753,2687,2.7,"20"
"10019",31,5,39,4364006,4366987,2981,3,"20"
"10126",31,1,27,4368873,4372023,3150,3.1,"20"
"10323",31,1,43,4376228,4378165,1937,1.9,"20"
"10420",31,8,74,4379933,4382255,2322,2.3,"0"
"10523",31,5,7,4384052,4387026,2974,3,"20"
"10723",31,5,15,4390837,4393095,2258,2.3,"20"
"10926",31,3,37,4396416,4398641,2225,2.2,"20"
"11021",31,4,62,4400310,4404254,3944,3.9,"0"
"11127",31,5,63,4407091,4409715,2624,2.6,"20"
"11224",31,8,18,4411348,4414007,2659,2.7,"0"
"11419",31,6,32,4418908,4421354,2446,2.4,"0"
"11622",31,8,50,4426485,4429803,3318,3.3,"0"
"11722",31,4,6,4431491,4434507,3016,3,"0"
"11922",31,8,42,4438555,4441121,2566,2.6,"0"
"12022",31,5,23,4443272,4444867,1595,1.6,"20"
"10127",32,7,8,9774772,9779073,4301,4.3,"20"
"1228",32,8,65,9783449,9787767,4318,4.3,"0"
"1327",32,8,9,9789265,9794418,5153,5.2,"0"
"1521",32,7,48,9799931,9805425,5494,5.5,"20"
"1617",32,5,78,9807627,9811465,3838,3.8,"20"
"1723",32,4,29,9813439,9818514,5075,5.1,"0"
"1924",32,8,73,9822408,9827687,5279,5.3,"0"
"2020",32,8,33,9830350,9836304,5954,6,"0"
"2120",32,1,18,9838087,9842419,4332,4.3,"20"
"2321",32,2,27,9846575,9851017,4442,4.4,"0"
"2519",32,3,36,9854651,9858231,3580,3.6,"20"
"2625",32,3,60,9859788,9863015,3227,3.2,"20"
"2722",32,3,44,9864665,9868060,3395,3.4,"20"
"2821",32,6,31,9870795,9874621,3826,3.8,"0"
"3018",32,4,61,9878146,9881970,3824,3.8,"0"
"3120",32,3,12,9883703,9886497,2794,2.8,"20"
"3325",32,6,15,9890556,9893506,2950,3,"0"
"3522",32,8,41,9897678,9900501,2823,2.8,"0"
"3625",32,7,72,9902070,9906095,4025,4,"20"
"3722",32,6,55,9908149,9913143,4994,5,"0"
"3822",32,6,71,9914799,9919639,4840,4.8,"0"
"3922",32,8,1,9921771,9925250,3479,3.5,"0"
"4121",32,1,74,9930124,9934679,4555,4.6,"20"
"4222",32,4,5,9937201,9942042,4841,4.8,"0"
"4425",32,8,49,9946050,9952305,6255,6.3,"0"
"4524",32,5,62,9953831,9960032,6201,6.2,"20"
"4622",32,7,80,9961557,9965529,3972,4,"20"
"4724",32,1,50,9967071,9970091,3020,3,"20"
"4822",32,3,68,9972358,9976209,3851,3.9,"20"
"4914",32,8,25,9977978,9981708,3730,3.7,"0"
"5124",32,2,11,9985098,9988208,3110,3.1,"0"
"5324",32,6,7,9992535,9995876,3341,3.3,"0"
"5525",32,1,66,10000888,10005653,4765,4.8,"20"
"5619",32,1,2,10007097,10011084,3987,4,"20"
"5822",32,3,20,10014832,10019965,5133,5.1,"20"
"6022",32,4,77,10024437,10028460,4023,4,"0"
"6126",32,7,24,10031030,10034505,3475,3.5,"20"
"6321",32,2,19,10040241,10044578,4337,4.3,"0"
"6521",32,1,26,10048922,10053119,4197,4.2,"20"
"6725",32,4,53,10056825,10061389,4564,4.6,"0"
"6821",32,4,13,10063875,10067901,4026,4,"0"
"7022",32,1,42,10074407,10077803,3396,3.4,"20"
"7123",32,7,32,10079725,10082934,3209,3.2,"20"
"7318",32,5,30,10086335,10090384,4049,4,"20"
"7519",32,3,76,10094690,10099126,4436,4.4,"20"
"7624",32,3,52,10100669,10104314,3645,3.6,"20"
"7721",32,2,51,10106054,10109471,3417,3.4,"0"
"7822",32,6,39,10112641,10116290,3649,3.6,"0"
"7924",32,1,10,10118227,10123064,4837,4.8,"20"
"8122",32,5,6,10128961,10132383,3422,3.4,"20"
"8320",32,5,14,10136972,10142019,5047,5,"20"
"8520",32,4,69,10145817,10148744,2927,2.9,"0"
"8620",32,7,64,10150804,10154277,3473,3.5,"20"
"8722",32,5,38,10156237,10160527,4290,4.3,"20"
"8822",32,6,79,10162309,10164745,2436,2.4,"0"
"8922",32,2,75,10166893,10169679,2786,2.8,"0"
"9024",32,6,47,10171655,10174880,3225,3.2,"0"
"9119",32,7,40,10176884,10179987,3103,3.1,"20"
"9223",32,2,59,10181497,10184781,3284,3.3,"0"
"9321",32,8,57,10186764,10190740,3976,4,"0"
"9419",32,4,21,10192261,10195944,3683,3.7,"0"
"9626",32,6,23,10200093,10202600,2507,2.5,"0"
"9824",32,4,37,10206091,10209662,3571,3.6,"0"
"9923",32,8,17,10211518,10217014,5496,5.5,"0"
"10128",32,5,22,10220741,10223675,2934,2.9,"20"
"10324",32,3,28,10228316,10232453,4137,4.1,"20"
"10524",32,7,16,10238479,10241426,2947,2.9,"20"
"10724",32,5,46,10246762,10250115,3353,3.4,"20"
"10818",32,5,54,10253383,10256721,3338,3.3,"20"
"10927",32,2,35,10258397,10263463,5066,5.1,"0"
"11022",32,2,67,10265024,10271766,6742,6.7,"0"
"11128",32,7,56,10274243,10277259,3016,3,"20"
"11225",32,5,70,10279702,10282865,3163,3.2,"20"
"11322",32,2,43,10284702,10287849,3147,3.1,"0"
"11420",32,2,3,10289618,10294108,4490,4.5,"0"
"11623",32,1,58,10298691,10302915,4224,4.2,"20"
"11723",32,4,45,10306128,10308969,2841,2.8,"0"
"11821",32,3,4,10310958,10313682,2724,2.7,"20"
"12023",32,1,34,10318787,10323211,4424,4.4,"20"
"12116",32,6,63,10326156,10330239,4083,4.1,"0"
"10129",33,2,66,12029413,12033474,4061,4.1,"0"
"11105",33,8,8,12035827,12038946,3119,3.1,"0"
"1328",33,1,1,12042994,12047852,4858,4.9,"20"
"1522",33,3,59,12055549,12060709,5160,5.2,"20"
"1618",33,2,50,12062912,12065283,2371,2.4,"0"
"1724",33,8,80,12066737,12070005,3268,3.3,"0"
"1822",33,5,77,12073109,12078226,5117,5.1,"20"
"1925",33,6,78,12079700,12084107,4407,4.4,"0"
"2021",33,6,6,12086168,12090419,4251,4.3,"0"
"2224",33,6,54,12095219,12099395,4176,4.2,"0"
"2322",33,7,39,12101670,12106546,4876,4.9,"20"
"2421",33,2,2,12108083,12112502,4419,4.4,"0"
"2626",33,3,19,12117509,12122043,4534,4.5,"20"
"2822",33,1,49,12128029,12132282,4253,4.3,"20"
"2927",33,7,31,12133791,12139265,5474,5.5,"20"
"3121",33,8,48,12144202,12147440,3238,3.2,"0"
"3222",33,3,3,12149273,12152962,3689,3.7,"20"
"3419",33,8,16,12157307,12160778,3471,3.5,"0"
"3626",33,7,23,12165681,12170583,4902,4.9,"20"
"3823",33,4,12,12174661,12178272,3611,3.6,"0"
"4021",33,1,57,12182711,12187382,4671,4.7,"20"
"4122",33,2,18,12191382,12194613,3231,3.2,"0"
"4320",33,1,25,12198680,12202818,4138,4.1,"20"
"4525",33,2,42,12206407,12210950,4543,4.5,"0"
"4623",33,3,75,12212616,12216660,4044,4,"20"
"4725",33,5,21,12218065,12222963,4898,4.9,"20"
"4915",33,5,37,12227372,12232750,5378,5.4,"20"
"5026",33,4,4,12234367,12237312,2945,2.9,"0"
"5220",33,6,38,12240706,12244993,4287,4.3,"0"
"5325",33,4,52,12246877,12249698,2821,2.8,"0"
"5422",33,2,58,12251121,12254674,3553,3.6,"0"
"5526",33,7,79,12256074,12260448,4374,4.4,"20"
"5620",33,2,34,12261918,12266203,4285,4.3,"0"
"5723",33,8,32,12267777,12271716,3939,3.9,"0"
"5924",33,7,7,12275731,12279823,4092,4.1,"20"
"6127",33,8,64,12284394,12288361,3967,4,"0"
"6220",33,3,11,12290670,12294615,3945,3.9,"20"
"6422",33,7,71,12299057,12303714,4657,4.7,"20"
"6522",33,4,60,12305148,12308456,3308,3.3,"0"
"6624",33,1,33,12309717,12313308,3591,3.6,"20"
"6726",33,5,29,12314562,12319095,4533,4.5,"20"
"6927",33,2,74,12324066,12327088,3022,3,"0"
"7023",33,5,13,12329987,12334462,4475,4.5,"20"
"7226",33,4,44,12338343,12341982,3639,3.6,"0"
"7319",33,3,67,12343965,12349626,5661,5.7,"20"
"7424",33,4,20,12351258,12354844,3586,3.6,"0"
"7625",33,2,26,12360579,12363866,3287,3.3,"0"
"7823",33,4,36,12368642,12372341,3699,3.7,"0"
"7925",33,4,68,12373959,12377423,3464,3.5,"0"
"8021",33,5,69,12379029,12383817,4788,4.8,"20"
"8123",33,6,30,12386400,12390207,3807,3.8,"0"
"8321",33,7,15,12395012,12398277,3265,3.3,"20"
"8521",33,3,27,12402841,12406826,3985,4,"20"
"8723",33,5,5,12412739,12418171,5432,5.4,"20"
"8923",33,1,41,12422568,12427466,4898,4.9,"20"
"9025",33,3,51,12429472,12433492,4020,4,"20"
"9120",33,8,24,12435328,12439894,4566,4.6,"0"
"9322",33,4,28,12444665,12447850,3185,3.2,"0"
"9523",33,8,40,12452132,12457292,5160,5.2,"0"
"9627",33,6,62,12459990,12464362,4372,4.4,"0"
"9721",33,7,47,12466029,12469076,3047,3,"20"
"9825",33,7,55,12470701,12474510,3809,3.8,"20"
"9924",33,6,46,12475986,12478449,2463,2.5,"0"
"10020",33,5,45,12481173,12484585,3412,3.4,"20"
"10130",33,8,72,12486286,12490774,4488,4.5,"0"
"10226",33,3,43,12492450,12496113,3663,3.7,"20"
"10325",33,6,22,12497482,12501086,3604,3.6,"0"
"10525",33,1,17,12507235,12511164,3929,3.9,"20"
"10725",33,5,61,12515477,12520509,5032,5,"20"
"10819",33,3,35,12521803,12525474,3671,3.7,"20"
"10928",33,1,9,12527204,12531109,3905,3.9,"20"
"11129",33,6,14,12534945,12540425,5480,5.5,"0"
"11323",33,1,65,12545652,12549475,3823,3.8,"20"
"11421",33,6,70,12551030,12555126,4096,4.1,"0"
"11523",33,2,10,12556845,12559733,2888,2.9,"0"
"11724",33,4,76,12564749,12569061,4312,4.3,"0"
"11822",33,5,53,12571066,12576677,5611,5.6,"20"
"11923",33,7,63,12578459,12582788,4329,4.3,"20"
"12024",33,8,56,12584437,12586998,2561,2.6,"0"
"12117",33,1,73,12588763,12593054,4291,4.3,"20"
"10131",34,6,21,17038939,17044181,5242,5.2,"0"
"1229",34,6,29,17048891,17057820,8929,8.9,"0"
"1419",34,1,32,17062199,17069972,7773,7.8,"20"
"1619",34,3,26,17073968,17078927,4959,5,"20"
"1823",34,3,2,17086508,17100912,14404,14.4,"20"
"2022",34,2,41,17106376,17111243,4867,4.9,"0"
"2121",34,5,36,17119585,17127269,7684,7.7,"20"
"2225",34,1,56,17129209,17132003,2794,2.8,"20"
"2323",34,7,14,17134383,17138905,4522,4.5,"20"
"2520",34,1,80,17145770,17150827,5057,5.1,"20"
"2627",34,8,63,17152802,17157610,4808,4.8,"0"
"2723",34,3,42,17160339,17172905,12566,12.6,"20"
"2823",34,5,76,17174928,17179660,4732,4.7,"20"
"2928",34,1,64,17181592,17185070,3478,3.5,"20"
"3019",34,4,43,17187612,17190369,2757,2.8,"0"
"3122",34,8,47,17191974,17194717,2743,2.7,"0"
"3223",34,3,58,17197968,17206145,8177,8.2,"20"
"3326",34,7,46,17208167,17214998,6831,6.8,"20"
"3420",34,7,30,17216858,17225388,8530,8.5,"20"
"3627",34,2,25,17229435,17233319,3884,3.9,"0"
"3824",34,2,49,17237290,17240520,3230,3.2,"0"
"3923",34,5,44,17242836,17247016,4180,4.2,"20"
"4022",34,4,19,17250355,17255890,5535,5.5,"0"
"4223",34,2,57,17261391,17268291,6900,6.9,"0"
"4321",34,7,54,17277252,17290330,13078,13.1,"20"
"4426",34,2,9,17292174,17297098,4924,4.9,"0"
"4624",34,8,39,17301099,17308576,7477,7.5,"0"
"4726",34,7,78,17310355,17316700,6345,6.3,"20"
"4823",34,3,34,17321745,17326950,5205,5.2,"20"
"4916",34,2,65,17328657,17336773,8116,8.1,"0"
"5027",34,6,13,17338654,17342101,3447,3.4,"0"
"5221",34,8,23,17345603,17348250,2647,2.6,"0"
"5423",34,4,75,17352064,17354222,2158,2.2,"0"
"5527",34,5,28,17357588,17360664,3076,3.1,"20"
"5724",34,5,68,17369839,17376496,6657,6.7,"20"
"5823",34,5,60,17378878,17382576,3698,3.7,"20"
"5925",34,8,15,17385143,17387437,2294,2.3,"0"
"6128",34,5,20,17393081,17396773,3692,3.7,"20"
"6322",34,6,5,17401179,17404313,3134,3.1,"0"
"6523",34,4,51,17412754,17416897,4143,4.1,"0"
"6625",34,2,1,17421809,17425143,3334,3.3,"0"
"6822",34,7,38,17430507,17435087,4580,4.6,"20"
"6928",34,4,35,17437054,17443776,6722,6.7,"0"
"7024",34,1,40,17446701,17452633,5932,5.9,"20"
"7124",34,3,66,17455181,17463261,8080,8.1,"20"
"7227",34,3,18,17465092,17471508,6416,6.4,"20"
"7425",34,1,16,17477967,17488549,10582,10.6,"20"
"7626",34,6,53,17492851,17496448,3597,3.6,"0"
"7722",34,4,3,17497950,17502601,4651,4.7,"0"
"7926",34,5,52,17505851,17512486,6635,6.6,"20"
"8022",34,6,37,17513965,17518643,4678,4.7,"0"
"8124",34,4,67,17520194,17529033,8839,8.8,"0"
"8226",34,2,73,17531723,17536355,4632,4.6,"0"
"8322",34,7,70,17537917,17548349,10432,10.4,"20"
"8422",34,7,22,17550076,17553555,3479,3.5,"20"
"8621",34,8,55,17558588,17562809,4221,4.2,"0"
"8724",34,5,12,17565061,17568909,3848,3.8,"20"
"8924",34,4,27,17573542,17578921,5379,5.4,"0"
"9121",34,1,72,17582970,17593446,10476,10.5,"20"
"9224",34,8,31,17595053,17604001,8948,8.9,"0"
"9420",34,5,4,17610012,17613570,3558,3.6,"20"
"9628",34,1,8,17617239,17628109,10870,10.9,"20"
"9826",34,2,17,17631975,17640534,8559,8.6,"0"
"10021",34,6,61,17645186,17650593,5407,5.4,"0"
"10132",34,6,45,17652115,17655529,3414,3.4,"0"
"10227",34,8,7,17658342,17661070,2728,2.7,"0"
"10421",34,1,48,17666954,17671846,4892,4.9,"20"
"10526",34,6,77,17674432,17680233,5801,5.8,"0"
"10621",34,4,59,17682084,17686687,4603,4.6,"0"
"10726",34,3,74,17689197,17696896,7699,7.7,"20"
"10820",34,7,62,17698281,17705765,7484,7.5,"20"
"10929",34,7,6,17707507,17713196,5689,5.7,"20"
"11130",34,2,33,17718268,17721386,3118,3.1,"0"
"11226",34,6,69,17722981,17726275,3294,3.3,"0"
"11324",34,3,50,17728815,17732346,3531,3.5,"20"
"11422",34,8,79,17733666,17736440,2774,2.8,"0"
"11524",34,8,71,17738030,17749564,11534,11.5,"0"
"11624",34,1,24,17751315,17756561,5246,5.2,"20"
"11823",34,4,11,17760396,17763352,2956,3,"0"
"12025",34,3,10,17766974,17772402,5428,5.4,"20"
"10133",35,5,51,28790195,28793445,3250,3.2,"20"
"11106",35,6,12,28795194,28798411,3217,3.2,"0"
"1329",35,5,43,28804129,28808141,4012,4,"20"
"1420",35,5,19,28812458,28815682,3224,3.2,"20"
"1620",35,1,23,28821915,28824732,2817,2.8,"20"
"1824",35,5,27,28828868,28831916,3048,3,"20"
"2023",35,3,17,28835861,28839023,3162,3.2,"20"
"2226",35,8,62,28844198,28848753,4555,4.6,"0"
"2324",35,7,5,28852906,28856154,3248,3.2,"20"
"2521",35,1,31,28860593,28864594,4001,4,"20"
"2724",35,4,74,28868050,28872327,4277,4.3,"0"
"2824",35,6,68,28875779,28879815,4036,4,"0"
"2929",35,3,33,28881756,28885721,3965,4,"20"
"3020",35,6,52,28888507,28893192,4685,4.7,"0"
"3123",35,8,14,28895768,28902868,7100,7.1,"0"
"3327",35,1,39,28909086,28912980,3894,3.9,"20"
"3421",35,3,57,28914661,28918607,3946,3.9,"20"
"3523",35,7,29,28920377,28924890,4513,4.5,"20"
"3723",35,6,76,28929124,28934080,4956,5,"0"
"3825",35,5,75,28936405,28940017,3612,3.6,"20"
"3924",35,8,6,28943219,28949149,5930,5.9,"0"
"4123",35,2,80,28955499,28958957,3458,3.5,"0"
"4224",35,7,61,28960949,28965534,4585,4.6,"20"
"4322",35,2,40,28967157,28970289,3132,3.1,"0"
"4427",35,8,78,28973035,28976068,3033,3,"0"
"4526",35,7,13,28979593,28986099,6506,6.5,"20"
"4727",35,6,4,28989823,28993424,3601,3.6,"0"
"4917",35,4,50,28999022,29001436,2414,2.4,"0"
"5028",35,8,46,29004568,29008518,3950,4,"0"
"5125",35,1,7,29011945,29017702,5757,5.8,"20"
"5326",35,4,2,29023468,29029260,5792,5.8,"0"
"5528",35,2,16,29033492,29036072,2580,2.6,"0"
"5725",35,2,8,29041383,29046301,4918,4.9,"0"
"5926",35,7,77,29050971,29053490,2519,2.5,"20"
"6023",35,1,79,29056262,29059244,2982,3,"20"
"6129",35,5,3,29061751,29064757,3006,3,"20"
"6323",35,6,28,29069977,29074974,4997,5,"0"
"6524",35,8,54,29079351,29084754,5403,5.4,"0"
"6626",35,3,73,29087141,29090127,2986,3,"20"
"6727",35,6,60,29093316,29097229,3913,3.9,"0"
"6823",35,8,38,29098702,29104572,5870,5.9,"0"
"6929",35,8,30,29107474,29110943,3469,3.5,"0"
"7125",35,4,18,29116150,29119481,3331,3.3,"0"
"7320",35,4,42,29123936,29129153,5217,5.2,"0"
"7426",35,4,26,29131464,29135706,4242,4.2,"0"
"7627",35,1,55,29139614,29142620,3006,3,"20"
"7723",35,4,34,29144680,29148129,3449,3.4,"0"
"7824",35,2,72,29150140,29154100,3960,4,"0"
"7927",35,1,63,29157741,29160744,3003,3,"20"
"8023",35,2,24,29162398,29165142,2744,2.7,"0"
"8227",35,4,58,29170037,29172913,2876,2.9,"0"
"8323",35,5,35,29176446,29180606,4160,4.2,"20"
"8423",35,2,56,29182156,29185065,2909,2.9,"0"
"8522",35,3,9,29186448,29190570,4122,4.1,"20"
"8725",35,1,15,29195615,29197946,2331,2.3,"20"
"8925",35,8,22,29202922,29205786,2864,2.9,"0"
"9122",35,2,48,29211278,29216135,4857,4.9,"0"
"9225",35,1,47,29220340,29222356,2016,2,"20"
"9323",35,7,37,29225708,29228837,3129,3.1,"20"
"9421",35,4,10,29230732,29233600,2868,2.9,"0"
"9629",35,6,20,29237808,29242082,4274,4.3,"0"
"9827",35,5,59,29247124,29250379,3255,3.3,"20"
"9925",35,5,67,29252174,29257031,4857,4.9,"20"
"10022",35,7,69,29259540,29262745,3205,3.2,"20"
"10134",35,3,41,29265167,29267809,2642,2.6,"20"
"10228",35,7,53,29272639,29276352,3713,3.7,"20"
"10326",35,3,65,29278651,29283704,5053,5.1,"20"
"10422",35,3,1,29285413,29288319,2906,2.9,"20"
"10622",35,2,64,29292693,29295348,2655,2.7,"0"
"10727",35,7,45,29297661,29299792,2131,2.1,"20"
"10821",35,4,66,29302051,29308648,6597,6.6,"0"
"10930",35,3,25,29310652,29314660,4008,4,"20"
"11131",35,8,70,29318584,29323780,5196,5.2,"0"
"11227",35,6,44,29325569,29328239,2670,2.7,"0"
"11325",35,2,32,29329815,29333003,3188,3.2,"0"
"11525",35,6,36,29338030,29342228,4198,4.2,"0"
"11625",35,5,11,29344238,29346351,2113,2.1,"20"
"11824",35,7,21,29350301,29353928,3627,3.6,"20"
"12026",35,3,49,29359105,29362131,3026,3,"20"
"12118",35,1,71,29365999,29368491,2492,2.5,"20"
"10135",36,4,25,2027501,2031541,4040,4,"0"
"1230",36,7,12,2035381,2040101,4720,4.7,"20"
"1421",36,3,80,2045065,2048850,3785,3.8,"20"
"1523",36,6,59,2050443,2054328,3885,3.9,"0"
"1621",36,5,50,2057470,2060045,2575,2.6,"20"
"1725",36,1,54,2062399,2065696,3297,3.3,"20"
"1825",36,8,37,2069063,2072531,3468,3.5,"0"
"1926",36,2,79,2074143,2077715,3572,3.6,"0"
"2024",36,6,67,2080496,2084106,3610,3.6,"0"
"2122",36,3,40,2085813,2089025,3212,3.2,"20"
"2227",36,5,10,2092063,2096848,4785,4.8,"20"
"2422",36,7,68,2101481,2105816,4335,4.3,"20"
"2522",36,4,9,2109433,2112614,3181,3.2,"0"
"2725",36,6,27,2116939,2120366,3427,3.4,"0"
"2930",36,8,77,2124490,2127722,3232,3.2,"0"
"3021",36,4,41,2130483,2135607,5124,5.1,"0"
"3124",36,3,8,2139106,2144081,4975,5,"20"
"3328",36,5,42,2148182,2153150,4968,5,"20"
"3422",36,2,23,2155052,2158121,3069,3.1,"0"
"3628",36,6,19,2163017,2165505,2488,2.5,"0"
"3826",36,6,51,2171045,2174950,3905,3.9,"0"
"3925",36,3,48,2176695,2179745,3050,3,"20"
"4023",36,8,69,2181771,2185298,3527,3.5,"0"
"4124",36,7,52,2187771,2191084,3313,3.3,"20"
"4225",36,7,20,2192934,2195821,2887,2.9,"20"
"4428",36,4,33,2201029,2203464,2435,2.4,"0"
"4527",36,3,16,2205839,2209090,3251,3.3,"20"
"4728",36,2,71,2213517,2217303,3786,3.8,"0"
"4824",36,1,46,2219030,2223056,4026,4,"20"
"4918",36,1,30,2226087,2228776,2689,2.7,"20"
"5126",36,1,38,2232735,2237254,4519,4.5,"20"
"5222",36,2,31,2239941,2243451,3510,3.5,"0"
"5424",36,7,28,2249758,2253519,3761,3.8,"20"
"5621",36,8,53,2259608,2262617,3009,3,"0"
"5726",36,7,36,2264948,2267944,2996,3,"20"
"5824",36,6,35,2271930,2275930,4000,4,"0"
"5927",36,7,76,2277550,2281757,4207,4.2,"20"
"6024",36,5,74,2283648,2287036,3388,3.4,"20"
"6130",36,5,26,2288591,2292364,3773,3.8,"20"
"6324",36,7,4,2297553,2300866,3313,3.3,"20"
"6525",36,2,39,2306180,2309095,2915,2.9,"0"
"6627",36,5,2,2311672,2314813,3141,3.1,"20"
"6824",36,2,63,2320661,2324544,3883,3.9,"0"
"6930",36,1,14,2326684,2330020,3336,3.3,"20"
"7126",36,6,75,2335333,2338806,3473,3.5,"0"
"7228",36,1,78,2340647,2343442,2795,2.8,"20"
"7321",36,4,57,2345263,2348415,3152,3.2,"0"
"7427",36,8,45,2350168,2352272,2104,2.1,"0"
"7520",36,4,65,2354795,2358024,3229,3.2,"0"
"7628",36,3,72,2359970,2363090,3120,3.1,"20"
"7724",36,8,13,2366867,2369716,2849,2.8,"0"
"7928",36,3,32,2374714,2379085,4371,4.4,"20"
"8125",36,8,29,2384114,2387589,3475,3.5,"0"
"8324",36,3,56,2392423,2395654,3231,3.2,"20"
"8424",36,6,3,2398102,2400850,2748,2.7,"0"
"8622",36,1,6,2405008,2409148,4140,4.1,"20"
"8823",36,2,47,2413028,2416651,3623,3.6,"0"
"8926",36,3,24,2418579,2423901,5322,5.3,"20"
"9123",36,5,66,2431579,2435310,3731,3.7,"20"
"9226",36,4,73,2436888,2439764,2876,2.9,"0"
"9324",36,8,5,2443141,2446297,3156,3.2,"0"
"9524",36,7,60,2451592,2454286,2694,2.7,"20"
"9630",36,1,70,2455946,2459881,3935,3.9,"20"
"9722",36,4,49,2462422,2465441,3019,3,"0"
"9828",36,5,58,2467893,2471862,3969,4,"20"
"9926",36,8,61,2474885,2477883,2998,3,"0"
"10023",36,8,21,2479694,2482356,2662,2.7,"0"
"10229",36,4,1,2487857,2490658,2801,2.8,"0"
"10423",36,5,18,2496047,2498260,2213,2.2,"20"
"10623",36,2,7,2503803,2506908,3105,3.1,"0"
"10822",36,2,55,2512516,2516891,4375,4.4,"0"
"10931",36,4,17,2519930,2523718,3788,3.8,"0"
"11132",36,6,43,2528546,2531922,3376,3.4,"0"
"11228",36,2,15,2535188,2537132,1944,1.9,"0"
"11423",36,1,22,2542599,2547335,4736,4.7,"20"
"11626",36,5,34,2552068,2555691,3623,3.6,"20"
"11725",36,3,64,2559408,2562518,3110,3.1,"20"
"11825",36,1,62,2564626,2568189,3563,3.6,"20"
"11924",36,7,44,2571920,2574374,2454,2.5,"20"
"12027",36,6,11,2577305,2579882,2577,2.6,"0"
"10136",37,1,13,3688409,3693980,5571,5.6,"20"
"1231",37,4,80,3701945,3705974,4029,4,"0"
"1330",37,4,40,3707794,3712789,4995,5,"0"
"1422",37,5,17,3724838,3729889,5051,5.1,"20"
"1622",37,8,28,3740180,3746828,6648,6.6,"0"
"1826",37,8,36,3754774,3760802,6028,6,"0"
"1927",37,5,25,3764384,3769390,5006,5,"20"
"2123",37,7,75,3777399,3781992,4593,4.6,"20"
"2228",37,6,74,3786986,3792059,5073,5.1,"0"
"2325",37,6,10,3794014,3798788,4774,4.8,"0"
"2523",37,8,68,3806644,3810307,3663,3.7,"0"
"2628",37,4,16,3812483,3816170,3687,3.7,"0"
"2825",37,3,47,3823133,3827885,4752,4.8,"20"
"2931",37,1,21,3831443,3836072,4629,4.6,"20"
"3125",37,3,71,3841321,3846742,5421,5.4,"20"
"3224",37,1,61,3848445,3858191,9746,9.7,"20"
"3329",37,6,42,3862668,3870641,7973,8,"0"
"3423",37,1,69,3877241,3881675,4434,4.4,"20"
"3524",37,3,31,3886049,3893698,7649,7.6,"20"
"3724",37,7,59,3898837,3903345,4508,4.5,"20"
"3827",37,5,33,3908961,3912839,3878,3.9,"20"
"3926",37,6,50,3916800,3920899,4099,4.1,"0"
"4024",37,2,30,3925627,3928869,3242,3.2,"0"
"4226",37,2,38,3934248,3940737,6489,6.5,"0"
"4323",37,5,73,3942829,3947273,4444,4.4,"20"
"4429",37,6,58,3953950,3960873,6923,6.9,"0"
"4528",37,1,77,3963734,3968064,4330,4.3,"20"
"4625",37,3,7,3975266,3981207,5941,5.9,"20"
"4825",37,6,34,3991107,3995982,4875,4.9,"0"
"4919",37,4,8,4002119,4006279,4160,4.2,"0"
"5127",37,2,62,4014791,4023388,8597,8.6,"0"
"5223",37,2,14,4025924,4029948,4024,4,"0"
"5425",37,5,41,4041370,4045774,4404,4.4,"20"
"5529",37,1,37,4048390,4052622,4232,4.2,"20"
"5622",37,5,9,4057623,4063373,5750,5.8,"20"
"5825",37,7,19,4070126,4074629,4503,4.5,"20"
"6025",37,7,11,4083098,4086223,3125,3.1,"20"
"6221",37,7,67,4095390,4103435,8045,8,"20"
"6325",37,5,57,4108808,4115005,6197,6.2,"20"
"6423",37,7,3,4121930,4128591,6661,6.7,"20"
"6628",37,6,66,4136701,4140663,3962,4,"0"
"6728",37,2,54,4143281,4146564,3283,3.3,"0"
"6825",37,4,32,4149396,4153279,3883,3.9,"0"
"7025",37,3,63,4160994,4166500,5506,5.5,"20"
"7127",37,1,45,4172250,4175747,3497,3.5,"20"
"7229",37,4,56,4181478,4184574,3096,3.1,"0"
"7322",37,4,64,4190416,4193585,3169,3.2,"0"
"7428",37,1,29,4196640,4200291,3651,3.7,"20"
"7629",37,8,44,4206071,4209881,3810,3.8,"0"
"7725",37,3,79,4214264,4218129,3865,3.9,"20"
"7825",37,3,15,4222673,4226751,4078,4.1,"20"
"8024",37,3,23,4232002,4237280,5278,5.3,"20"
"8228",37,1,5,4243627,4250218,6591,6.6,"20"
"8425",37,1,53,4258068,4264851,6783,6.8,"20"
"8523",37,3,55,4270068,4274206,4138,4.1,"20"
"8623",37,4,48,4281338,4286639,5301,5.3,"0"
"8726",37,2,6,4289492,4293829,4337,4.3,"0"
"8927",37,5,49,4299075,4302599,3524,3.5,"20"
"9026",37,6,2,4309369,4312475,3106,3.1,"0"
"9227",37,4,24,4320482,4327608,7126,7.1,"0"
"9422",37,8,76,4340138,4344683,4545,4.5,"0"
"9525",37,7,43,4349948,4354625,4677,4.7,"20"
"9631",37,5,1,4364579,4370692,6113,6.1,"20"
"9829",37,2,78,4374793,4378387,3594,3.6,"0"
"9927",37,8,12,4383606,4389714,6108,6.1,"0"
"10137",37,8,60,4395184,4399765,4581,4.6,"0"
"10230",37,8,4,4404938,4411209,6271,6.3,"0"
"10424",37,6,18,4420035,4422798,2763,2.8,"0"
"10624",37,8,52,4429040,4433296,4256,4.3,"0"
"10728",37,7,51,4438219,4442324,4105,4.1,"20"
"10823",37,8,20,4444228,4448857,4629,4.6,"0"
"11023",37,7,27,4461299,4467369,6070,6.1,"20"
"11229",37,2,46,4478854,4484158,5304,5.3,"0"
"11326",37,6,26,4491867,4495653,3786,3.8,"0"
"11526",37,4,72,4504596,4509188,4592,4.6,"0"
"11627",37,2,70,4513371,4517420,4049,4,"0"
"11726",37,2,22,4529466,4533664,4198,4.2,"0"
"11925",37,5,65,4541433,4546760,5327,5.3,"20"
"12028",37,7,35,4549512,4553817,4305,4.3,"20"
"12119",37,3,39,4557740,4562095,4355,4.4,"20"
"10138",38,5,48,2170541,2175612,5071,5.1,"20"
"11107",38,1,44,2178164,2181325,3161,3.2,"20"
"1232",38,6,65,2185513,2189519,4006,4,"0"
"1331",38,6,1,2192297,2196092,3795,3.8,"0"
"1524",38,8,43,2201231,2204753,3522,3.5,"0"
"1623",38,4,31,2207584,2210794,3210,3.2,"0"
"1827",38,8,35,2217356,2223107,5751,5.8,"0"
"1928",38,8,11,2228019,2231609,3590,3.6,"0"
"2124",38,6,9,2239199,2243123,3924,3.9,"0"
"2326",38,8,27,2251118,2255215,4097,4.1,"0"
"2524",38,7,26,2264096,2267561,3465,3.5,"20"
"2726",38,4,79,2274307,2278084,3777,3.8,"0"
"2826",38,2,21,2281182,2283894,2712,2.7,"0"
"3022",38,1,4,2288915,2292503,3588,3.6,"20"
"3225",38,2,29,2298141,2305831,7690,7.7,"0"
"3424",38,5,72,2312784,2316633,3849,3.8,"20"
"3525",38,1,36,2320777,2324689,3912,3.9,"20"
"3629",38,5,8,2327374,2331885,4511,4.5,"20"
"3828",38,1,68,2337015,2340124,3109,3.1,"20"
"3927",38,4,23,2343332,2345354,2022,2,"0"
"4125",38,5,40,2351563,2355142,3579,3.6,"20"
"4227",38,2,61,2357842,2362001,4159,4.2,"0"
"4324",38,1,12,2365067,2369488,4421,4.4,"20"
"4529",38,4,47,2376533,2379318,2785,2.8,"0"
"4626",38,8,59,2382724,2391934,9210,9.2,"0"
"4729",38,4,55,2394791,2398052,3261,3.3,"0"
"4826",38,5,16,2401631,2405670,4039,4,"20"
"5029",38,8,75,2410730,2414000,3270,3.3,"0"
"5128",38,3,6,2416859,2421982,5123,5.1,"20"
"5327",38,2,53,2428133,2435607,7474,7.5,"0"
"5426",38,7,58,2438442,2443433,4991,5,"20"
"5530",38,4,63,2448484,2451415,2931,2.9,"0"
"5623",38,1,28,2455831,2460655,4824,4.8,"20"
"5826",38,4,71,2465595,2469051,3456,3.5,"0"
"5928",38,3,54,2472130,2476756,4626,4.6,"20"
"6026",38,5,32,2479616,2483991,4375,4.4,"20"
"6222",38,6,41,2489747,2492317,2570,2.6,"0"
"6326",38,7,10,2495216,2498862,3646,3.6,"20"
"6526",38,2,77,2503977,2508239,4262,4.3,"0"
"6629",38,7,34,2511018,2516198,5180,5.2,"20"
"6729",38,7,42,2519559,2523210,3651,3.7,"20"
"6826",38,7,50,2525872,2528733,2861,2.9,"20"
"6931",38,3,78,2531338,2534544,3206,3.2,"20"
"7026",38,4,7,2537639,2540909,3270,3.3,"0"
"7230",38,5,24,2546576,2550078,3502,3.5,"20"
"7429",38,3,38,2555034,2558962,3928,3.9,"20"
"7521",38,8,51,2561948,2565362,3414,3.4,"0"
"7630",38,7,74,2569070,2575585,6515,6.5,"20"
"7726",38,6,49,2578704,2581028,2324,2.3,"0"
"7826",38,3,70,2583658,2587089,3431,3.4,"20"
"7929",38,3,22,2590633,2594383,3750,3.8,"20"
"8126",38,3,62,2603084,2606970,3886,3.9,"20"
"8229",38,6,73,2609635,2613547,3912,3.9,"0"
"8325",38,4,15,2616312,2618641,2329,2.3,"0"
"8524",38,2,69,2624365,2627407,3042,3,"0"
"8624",38,3,46,2631838,2637011,5173,5.2,"20"
"8727",38,5,80,2639849,2642437,2588,2.6,"20"
"8824",38,1,76,2645505,2650664,5159,5.2,"20"
"8928",38,5,56,2654240,2657151,2911,2.9,"20"
"9027",38,6,25,2660279,2663110,2831,2.8,"0"
"9228",38,3,30,2669664,2672829,3165,3.2,"20"
"9423",38,5,64,2677072,2680951,3879,3.9,"20"
"9526",38,1,52,2684647,2688175,3528,3.5,"20"
"9632",38,7,18,2692556,2696086,3530,3.5,"20"
"9830",38,1,60,2703963,2707622,3659,3.7,"20"
"9928",38,7,2,2711941,2714384,2443,2.4,"20"
"10139",38,6,57,2719538,2722023,2485,2.5,"0"
"10231",38,1,20,2724754,2727452,2698,2.7,"20"
"10425",38,2,5,2732608,2735892,3284,3.3,"0"
"10625",38,2,37,2741341,2744756,3415,3.4,"0"
"10729",38,6,33,2747836,2750190,2354,2.4,"0"
"10824",38,3,14,2753170,2757421,4251,4.3,"20"
"11024",38,8,3,2766179,2770365,4186,4.2,"0"
"11230",38,2,45,2776286,2778770,2484,2.5,"0"
"11327",38,2,13,2781663,2784794,3131,3.1,"0"
"11527",38,8,67,2790653,2794091,3438,3.4,"0"
"11628",38,7,66,2797916,2801249,3333,3.3,"20"
"11727",38,8,19,2804197,2807303,3106,3.1,"0"
"11926",38,4,39,2813284,2816568,3284,3.3,"0"
"12029",38,6,17,2820191,2824225,4034,4,"0"
"10140",39,3,45,7279171,7285354,6183,6.2,"20"
"11108",39,2,68,7287851,7293734,5883,5.9,"0"
"1233",39,4,14,7296214,7302789,6575,6.6,"0"
"1423",39,5,15,7309771,7315109,5338,5.3,"20"
"1624",39,4,22,7320222,7325695,5473,5.5,"0"
"1828",39,7,33,7331277,7335361,4084,4.1,"20"
"1929",39,1,3,7339063,7343988,4925,4.9,"20"
"2125",39,6,40,7349257,7357641,8384,8.4,"0"
"2229",39,7,49,7362404,7367192,4788,4.8,"20"
"2327",39,2,60,7369661,7374515,4854,4.9,"0"
"2423",39,8,58,7377603,7383092,5489,5.5,"0"
"2525",39,4,62,7385537,7392798,7261,7.3,"0"
"2629",39,6,16,7395166,7400944,5778,5.8,"0"
"2827",39,8,10,7408327,7413814,5487,5.5,"0"
"3023",39,1,67,7419821,7427624,7803,7.8,"20"
"3126",39,4,46,7431023,7435413,4390,4.4,"0"
"3226",39,4,70,7438515,7442739,4224,4.2,"0"
"3330",39,8,74,7445431,7450623,5192,5.2,"0"
"3425",39,7,25,7453078,7459159,6081,6.1,"20"
"3630",39,3,53,7466019,7471381,5362,5.4,"20"
"3725",39,5,39,7473875,7478336,4461,4.5,"20"
"3829",39,4,6,7480848,7487198,6350,6.3,"0"
"4025",39,5,63,7493157,7498535,5378,5.4,"20"
"4126",39,8,66,7502030,7507026,4996,5,"0"
"4228",39,4,54,7509562,7513739,4177,4.2,"0"
"4325",39,6,32,7516200,7520392,4192,4.2,"0"
"4530",39,7,65,7525959,7531656,5697,5.7,"20"
"4627",39,7,73,7534183,7539787,5604,5.6,"20"
"4730",39,3,5,7542245,7548478,6233,6.2,"20"
"4920",39,3,69,7554316,7559191,4875,4.9,"20"
"5030",39,1,27,7561686,7565975,4289,4.3,"20"
"5224",39,1,43,7572339,7576364,4025,4,"20"
"5328",39,3,77,7578975,7583616,4641,4.6,"20"
"5427",39,5,55,7585977,7590307,4330,4.3,"20"
"5531",39,1,59,7593274,7598386,5112,5.1,"20"
"5624",39,6,64,7600910,7604930,4020,4,"0"
"5727",39,4,78,7607479,7612569,5090,5.1,"0"
"5827",39,6,72,7615061,7618797,3736,3.7,"0"
"5929",39,6,8,7621398,7624525,3127,3.1,"0"
"6131",39,3,37,7630028,7635810,5782,5.8,"20"
"6223",39,2,28,7638299,7643575,5276,5.3,"0"
"6424",39,3,29,7649261,7655351,6090,6.1,"20"
"6630",39,2,44,7662903,7668637,5734,5.7,"0"
"6730",39,6,80,7671340,7674802,3462,3.5,"0"
"6827",39,1,11,7677249,7681171,3922,3.9,"20"
"7027",39,2,4,7688330,7692574,4244,4.2,"0"
"7231",39,1,51,7697689,7701704,4015,4,"20"
"7323",39,7,9,7704382,7709280,4898,4.9,"20"
"7522",39,3,21,7714831,7719074,4243,4.2,"20"
"7727",39,6,48,7724904,7729129,4225,4.2,"0"
"7827",39,7,1,7731634,7736493,4859,4.9,"20"
"8025",39,5,47,7742317,7746827,4510,4.5,"20"
"8127",39,1,19,7749559,7753768,4209,4.2,"20"
"8326",39,5,79,7760652,7765135,4483,4.5,"20"
"8426",39,2,36,7768179,7772896,4717,4.7,"0"
"8525",39,7,17,7775520,7780231,4711,4.7,"20"
"8728",39,6,56,7785050,7789652,4602,4.6,"0"
"8825",39,1,75,7792342,7795932,3590,3.6,"20"
"8929",39,8,26,7802387,7806480,4093,4.1,"0"
"9124",39,8,50,7814988,7819142,4154,4.2,"0"
"9229",39,6,24,7821594,7826862,5268,5.3,"0"
"9424",39,8,42,7832551,7836535,3984,4,"0"
"9527",39,5,71,7839084,7842531,3447,3.4,"20"
"9633",39,5,23,7845222,7848628,3406,3.4,"20"
"9831",39,8,34,7853442,7857958,4516,4.5,"0"
"9929",39,2,76,7860430,7864867,4437,4.4,"0"
"10024",39,4,38,7867311,7871714,4403,4.4,"0"
"10141",39,7,41,7874195,7878061,3866,3.9,"20"
"10232",39,3,61,7881040,7885530,4490,4.5,"20"
"10327",39,8,2,7888190,7891735,3545,3.5,"0"
"10527",39,8,18,7897182,7900560,3378,3.4,"0"
"10730",39,2,20,7905784,7909555,3771,3.8,"0"
"10932",39,5,7,7915859,7919619,3760,3.8,"20"
"11133",39,1,35,7928200,7932211,4011,4,"20"
"11231",39,5,31,7935211,7939153,3942,3.9,"20"
"11424",39,7,57,7944404,7948797,4393,4.4,"20"
"11528",39,2,12,7951478,7955650,4172,4.2,"0"
"11728",39,4,30,7961256,7965206,3950,4,"0"
"11927",39,2,52,7970039,7973635,3596,3.6,"0"
"12030",39,3,13,7976416,7980806,4390,4.4,"20"
"10142",40,8,25,12113256,12120828,7572,7.6,"0"
"1234",40,6,47,12125536,12130330,4794,4.8,"0"
"1332",40,1,34,12133097,12143467,10370,10.4,"20"
"1424",40,5,78,12148675,12155635,6960,7,"20"
"1525",40,6,79,12158918,12165725,6807,6.8,"0"
"1625",40,8,33,12168215,12173071,4856,4.9,"0"
"1726",40,7,72,12179338,12190008,10670,10.7,"20"
"1829",40,6,7,12193396,12200055,6659,6.7,"0"
"2025",40,3,36,12208376,12218838,10462,10.5,"20"
"2126",40,4,13,12222959,12230398,7439,7.4,"0"
"2328",40,3,20,12236251,12243982,7731,7.7,"20"
"2526",40,7,80,12250131,12255825,5694,5.7,"20"
"2630",40,7,32,12262863,12269236,6373,6.4,"20"
"2828",40,1,2,12275156,12281715,6559,6.6,"20"
"3024",40,1,58,12286766,12293981,7215,7.2,"20"
"3127",40,3,76,12298011,12307471,9460,9.5,"20"
"3227",40,5,46,12310784,12320395,9611,9.6,"20"
"3331",40,5,22,12323398,12335544,12146,12.1,"20"
"3526",40,2,35,12344882,12351386,6504,6.5,"0"
"3631",40,5,62,12356082,12364895,8813,8.8,"20"
"3726",40,8,17,12368136,12372395,4259,4.3,"0"
"3928",40,8,65,12385265,12392735,7470,7.5,"0"
"4026",40,2,43,12396376,12400775,4399,4.4,"0"
"4127",40,5,38,12405366,12412511,7145,7.1,"20"
"4229",40,6,71,12420656,12426492,5836,5.8,"0"
"4326",40,5,30,12430006,12434715,4709,4.7,"20"
"4531",40,3,44,12439539,12446796,7257,7.3,"20"
"4628",40,3,28,12459081,12465495,6414,6.4,"20"
"4827",40,2,67,12472400,12482233,9833,9.8,"0"
"4921",40,8,73,12485336,12491935,6599,6.6,"0"
"5031",40,1,42,12496588,12501896,5308,5.3,"20"
"5129",40,8,49,12505477,12510105,4628,4.6,"0"
"5225",40,3,60,12516151,12521395,5244,5.2,"20"
"5329",40,1,66,12530111,12535758,5647,5.6,"20"
"5428",40,7,64,12540783,12544690,3907,3.9,"20"
"5532",40,1,74,12550057,12556595,6538,6.5,"20"
"5625",40,4,5,12559767,12569245,9478,9.5,"0"
"5828",40,6,31,12586843,12593933,7090,7.1,"0"
"6027",40,2,3,12601508,12608620,7112,7.1,"0"
"6224",40,3,68,12615459,12622814,7355,7.4,"20"
"6327",40,4,37,12626529,12632091,5562,5.6,"0"
"6425",40,5,54,12635612,12643627,8015,8,"20"
"6527",40,7,40,12650217,12656921,6704,6.7,"20"
"6631",40,4,29,12664328,12676660,12332,12.3,"0"
"6828",40,4,45,12683658,12689801,6143,6.1,"0"
"6932",40,8,57,12711865,12718290,6425,6.4,"0"
"7028",40,8,41,12720858,12728867,8009,8,"0"
"7128",40,6,23,12733377,12738959,5582,5.6,"0"
"7324",40,1,26,12744418,12749068,4650,4.7,"20"
"7523",40,8,9,12756375,12767387,11012,11,"0"
"7728",40,4,69,12773776,12781267,7491,7.5,"0"
"7828",40,2,51,12784419,12789953,5534,5.5,"0"
"7930",40,1,50,12792600,12799968,7368,7.4,"20"
"8026",40,3,4,12802873,12808361,5488,5.5,"20"
"8230",40,2,27,12813353,12828830,15477,15.5,"0"
"8427",40,4,61,12836123,12845934,9811,9.8,"0"
"8526",40,2,59,12848761,12854852,6091,6.1,"0"
"8625",40,2,11,12858752,12865019,6267,6.3,"0"
"8826",40,3,12,12872761,12878087,5326,5.3,"20"
"9028",40,6,15,12883664,12887361,3697,3.7,"0"
"9230",40,6,55,12892796,12898496,5700,5.7,"0"
"9325",40,1,18,12900912,12908064,7152,7.2,"20"
"9528",40,7,24,12914484,12924152,9668,9.7,"20"
"9723",40,6,39,12931026,12941032,10006,10,"0"
"9832",40,4,21,12943846,12950404,6558,6.6,"0"
"10025",40,5,14,12955854,12960571,4717,4.7,"20"
"10233",40,6,63,12965971,12977621,11650,11.7,"0"
"10328",40,2,75,12982801,12987752,4951,5,"0"
"10426",40,2,19,12990523,12994731,4208,4.2,"0"
"10626",40,5,70,13002119,13011250,9131,9.1,"20"
"10731",40,8,1,13013929,13017634,3705,3.7,"0"
"10933",40,7,16,13023502,13031885,8383,8.4,"20"
"11134",40,4,53,13038738,13048326,9588,9.6,"0"
"11232",40,7,56,13051659,13056370,4711,4.7,"20"
"11328",40,4,77,13058915,13065743,6828,6.8,"0"
"11425",40,1,10,13068582,13075262,6680,6.7,"20"
"11629",40,5,6,13080776,13090174,9398,9.4,"20"
"11826",40,3,52,13094773,13103025,8252,8.3,"20"
"11928",40,7,8,13105504,13115348,9844,9.8,"20"
"12120",40,7,48,13120275,13127273,6998,7,"20"
"10143",41,5,21,24513476,24519388,5912,5.9,"20"
"1235",41,8,72,24524340,24530112,5772,5.8,"0"
"1333",41,6,6,24532605,24539082,6477,6.5,"0"
"1526",41,6,30,24544872,24548920,4048,4,"0"
"1727",41,7,79,24554895,24564639,9744,9.7,"20"
"1830",41,1,57,24567226,24570051,2825,2.8,"20"
"1930",41,3,59,24572639,24578189,5550,5.5,"20"
"2026",41,8,32,24580707,24585319,4612,4.6,"0"
"2230",41,7,71,24591160,24597681,6521,6.5,"20"
"2329",41,3,19,24600197,24605213,5016,5,"20"
"2527",41,1,33,24612323,24618567,6244,6.2,"20"
"2631",41,3,51,24621721,24630648,8927,8.9,"20"
"2727",41,4,12,24633252,24636076,2824,2.8,"0"
"2932",41,8,56,24642243,24646300,4057,4.1,"0"
"3025",41,7,55,24649136,24654359,5223,5.2,"20"
"3128",41,7,47,24657184,24661314,4130,4.1,"20"
"3228",41,2,50,24663739,24667956,4217,4.2,"0"
"3332",41,1,9,24670531,24675348,4817,4.8,"20"
"3527",41,7,31,24680888,24689268,8380,8.4,"20"
"3727",41,6,38,24719784,24726508,6724,6.7,"0"
"3830",41,2,2,24729026,24731910,2884,2.9,"0"
"4027",41,8,16,24737418,24740834,3416,3.4,"0"
"4230",41,7,63,24746269,24751783,5514,5.5,"20"
"4327",41,2,42,24755265,24760891,5626,5.6,"0"
"4430",41,6,78,24763759,24772594,8835,8.8,"0"
"4532",41,3,3,24775548,24781228,5680,5.7,"20"
"4731",41,6,62,24787993,24800519,12526,12.5,"0"
"4828",41,5,61,24803253,24810331,7078,7.1,"20"
"4922",41,3,67,24813508,24820265,6757,6.8,"20"
"5032",41,6,70,24823369,24829236,5867,5.9,"0"
"5130",41,4,28,24832292,24837714,5422,5.4,"0"
"5330",41,2,10,24845218,24847863,2645,2.6,"0"
"5533",41,4,68,24853620,24858382,4762,4.8,"0"
"5626",41,6,46,24860904,24864692,3788,3.8,"0"
"5728",41,4,60,24867606,24872396,4790,4.8,"0"
"5829",41,3,43,24875182,24877912,2730,2.7,"20"
"5930",41,2,58,24880357,24886636,6279,6.3,"0"
"6028",41,8,24,24889469,24893078,3609,3.6,"0"
"6225",41,4,36,24899298,24903466,4168,4.2,"0"
"6328",41,5,69,24905988,24910030,4042,4,"20"
"6426",41,2,26,24913775,24917188,3413,3.4,"0"
"6632",41,8,8,24924257,24927948,3691,3.7,"0"
"6829",41,7,7,24934275,24942852,8577,8.6,"20"
"7029",41,1,41,24949591,24954293,4702,4.7,"20"
"7129",41,5,45,24957221,24962529,5308,5.3,"20"
"7232",41,8,40,24965080,24969127,4047,4,"0"
"7325",41,1,49,24971588,24973940,2352,2.4,"20"
"7430",41,5,13,24976488,24982655,6167,6.2,"20"
"7631",41,5,5,24988631,24994154,5523,5.5,"20"
"7829",41,2,18,24999912,25004795,4883,4.9,"0"
"8027",41,5,77,25012249,25017621,5372,5.4,"20"
"8128",41,6,14,25020546,25030089,9543,9.5,"0"
"8327",41,4,52,25035727,25040032,4305,4.3,"0"
"8428",41,2,66,25044011,25047790,3779,3.8,"0"
"8527",41,8,64,25052019,25056571,4552,4.6,"0"
"8626",41,1,1,25059434,25064270,4836,4.8,"20"
"8827",41,8,80,25070759,25078473,7714,7.7,"0"
"8930",41,6,22,25081130,25090017,8887,8.9,"0"
"9125",41,1,17,25101762,25106830,5068,5.1,"20"
"9326",41,3,27,25112491,25116668,4177,4.2,"20"
"9529",41,3,11,25122554,25127089,4535,4.5,"20"
"9724",41,5,29,25132785,25140971,8186,8.2,"20"
"9930",41,5,37,25146088,25149525,3437,3.4,"20"
"10026",41,8,48,25152152,25156679,4527,4.5,"0"
"10144",41,3,75,25159312,25162904,3592,3.6,"20"
"10234",41,3,35,25166367,25169604,3237,3.2,"20"
"10329",41,4,76,25172197,25177565,5368,5.4,"0"
"10427",41,4,20,25180131,25183012,2881,2.9,"0"
"10627",41,1,65,25189099,25196096,6997,7,"20"
"10732",41,2,74,25198497,25204194,5697,5.7,"0"
"10825",41,7,15,25206848,25211861,5013,5,"20"
"11025",41,7,39,25217581,25222827,5246,5.2,"20"
"11135",41,1,73,25225493,25229884,4391,4.4,"20"
"11233",41,7,23,25232754,25238330,5576,5.6,"20"
"11426",41,5,53,25245043,25253284,8241,8.2,"20"
"11529",41,6,54,25257073,25263364,6291,6.3,"0"
"11630",41,4,44,25266839,25270011,3172,3.2,"0"
"11729",41,4,4,25272675,25277900,5225,5.2,"0"
"11929",41,1,25,25284621,25289542,4921,4.9,"20"
"12121",41,2,34,25295367,25300549,5182,5.2,"0"
"10145",42,6,5,950633,957304,6671,6.7,"0"
"1236",42,4,19,965827,971388,5561,5.6,"0"
"1425",42,5,20,978415,983734,5319,5.3,"20"
"1626",42,8,15,989169,994449,5280,5.3,"0"
"1831",42,4,11,999792,1005118,5326,5.3,"0"
"2027",42,6,13,1018337,1036280,17943,17.9,"0"
"2231",42,7,78,1041780,1050731,8951,9,"20"
"2330",42,8,31,1053362,1060398,7036,7,"0"
"2528",42,8,7,1068066,1080172,12106,12.1,"0"
"2728",42,1,80,1089872,1095108,5236,5.2,"20"
"2829",42,6,45,1098520,1105457,6937,6.9,"0"
"2933",42,7,62,1108048,1131527,23479,23.5,"20"
"3026",42,7,54,1135344,1141987,6643,6.6,"20"
"3129",42,4,35,1145065,1150080,5015,5,"0"
"3229",42,2,41,1159404,1174661,15257,15.3,"0"
"3333",42,3,58,1177720,1194735,17015,17,"20"
"3426",42,5,28,1197257,1203483,6226,6.2,"20"
"3632",42,3,42,1210848,1231932,21084,21.1,"20"
"3728",42,7,46,1235075,1252722,17647,17.6,"20"
"3831",42,3,34,1256590,1270731,14141,14.1,"20"
"3929",42,7,22,1292629,1300429,7800,7.8,"20"
"4128",42,6,37,1305620,1314439,8819,8.8,"0"
"4231",42,7,70,1317051,1320568,3517,3.5,"20"
"4328",42,5,60,1328159,1333537,5378,5.4,"20"
"4431",42,7,14,1336396,1341031,4635,4.6,"20"
"4629",42,3,26,1346849,1350927,4078,4.1,"20"
"4829",42,7,30,1358393,1361686,3293,3.3,"20"
"5033",42,3,66,1366755,1373167,6412,6.4,"20"
"5131",42,7,6,1375745,1381482,5737,5.7,"20"
"5331",42,6,61,1386750,1390943,4193,4.2,"0"
"5429",42,1,24,1398669,1405939,7270,7.3,"20"
"5627",42,8,63,1418606,1426739,8133,8.1,"0"
"5729",42,1,56,1429369,1433900,4531,4.5,"20"
"5830",42,8,47,1441806,1444927,3121,3.1,"0"
"5931",42,3,18,1447503,1450798,3295,3.3,"20"
"6132",42,2,73,1457474,1460968,3494,3.5,"0"
"6226",42,1,64,1463506,1466295,2789,2.8,"20"
"6329",42,1,72,1469006,1475059,6053,6.1,"20"
"6427",42,2,57,1477366,1481604,4238,4.2,"0"
"6528",42,4,3,1483942,1486876,2934,2.9,"0"
"6731",42,4,67,1502864,1506093,3229,3.2,"0"
"6830",42,1,16,1508799,1513338,4539,4.5,"20"
"7030",42,5,12,1518988,1522819,3831,3.8,"20"
"7233",42,4,59,1537791,1544740,6949,6.9,"0"
"7326",42,1,48,1547512,1552266,4754,4.8,"20"
"7431",42,1,40,1554596,1557401,2805,2.8,"20"
"7524",42,2,9,1560237,1563719,3482,3.5,"0"
"7729",42,5,4,1571568,1575815,4247,4.2,"20"
"7931",42,8,23,1583903,1586833,2930,2.9,"0"
"8129",42,5,36,1592589,1595695,3106,3.1,"20"
"8231",42,2,1,1598441,1601506,3065,3.1,"0"
"8429",42,8,39,1617169,1625824,8655,8.7,"0"
"8528",42,2,25,1628308,1634306,5998,6,"0"
"8729",42,2,33,1640548,1643227,2679,2.7,"0"
"8828",42,6,21,1649766,1656932,7166,7.2,"0"
"9029",42,8,79,1662741,1666045,3304,3.3,"0"
"9126",42,7,38,1668353,1672982,4629,4.6,"20"
"9231",42,1,32,1680791,1685299,4508,4.5,"20"
"9425",42,4,43,1691325,1694678,3353,3.4,"0"
"9530",42,4,51,1697129,1700739,3610,3.6,"0"
"9634",42,5,44,1703230,1707430,4200,4.2,"20"
"9725",42,6,53,1709965,1716617,6652,6.7,"0"
"9833",42,2,49,1718952,1721570,2618,2.6,"0"
"9931",42,2,17,1731197,1734265,3068,3.1,"0"
"10146",42,6,29,1739249,1742967,3718,3.7,"0"
"10330",42,5,68,1755789,1760357,4568,4.6,"20"
"10428",42,8,55,1768896,1771736,2840,2.8,"0"
"10528",42,5,52,1774746,1778595,3849,3.8,"20"
"10628",42,3,10,1781066,1784306,3240,3.2,"20"
"10826",42,3,74,1789989,1797198,7209,7.2,"20"
"10934",42,1,8,1799680,1802647,2967,3,"20"
"11136",42,3,2,1808951,1811239,2288,2.3,"20"
"11329",42,4,27,1816827,1819758,2931,2.9,"0"
"11530",42,2,65,1824718,1827728,3010,3,"0"
"11631",42,5,76,1835463,1839438,3975,4,"20"
"11730",42,8,71,1841985,1844458,2473,2.5,"0"
"11827",42,6,69,1850357,1852812,2455,2.5,"0"
"11930",42,6,77,1866777,1869313,2536,2.5,"0"
"12031",42,4,75,1871666,1873640,1974,2,"0"
"12122",42,3,50,1876281,1878558,2277,2.3,"20"
"10147",43,5,51,6354705,6358142,3437,3.4,"20"
"11109",43,1,63,6360535,6364681,4146,4.1,"20"
"1237",43,7,69,6367678,6371396,3718,3.7,"20"
"1334",43,4,2,6375006,6377883,2877,2.9,"0"
"1527",43,6,20,6385461,6388286,2825,2.8,"0"
"1728",43,1,39,6393617,6398281,4664,4.7,"20"
"1832",43,5,27,6400677,6404111,3434,3.4,"20"
"2028",43,8,70,6409681,6414085,4404,4.4,"0"
"2127",43,8,62,6417221,6420584,3363,3.4,"0"
"2232",43,3,1,6422933,6426033,3100,3.1,"20"
"2424",43,6,4,6432172,6434716,2544,2.5,"0"
"2632",43,6,36,6439323,6442408,3085,3.1,"0"
"2729",43,5,3,6444735,6447768,3033,3,"20"
"2934",43,4,74,6453657,6456325,2668,2.7,"0"
"3027",43,5,59,6458889,6462170,3281,3.3,"20"
"3130",43,4,58,6465297,6468313,3016,3,"0"
"3230",43,8,78,6472012,6476074,4062,4.1,"0"
"3334",43,7,53,6478960,6482347,3387,3.4,"20"
"3427",43,4,42,6486285,6489333,3048,3,"0"
"3528",43,6,28,6491724,6495349,3625,3.6,"0"
"3729",43,1,71,6501865,6505679,3814,3.8,"20"
"3832",43,5,11,6508503,6511350,2847,2.8,"20"
"4028",43,8,14,6516766,6519930,3164,3.2,"0"
"4232",43,1,7,6525438,6529126,3688,3.7,"20"
"4432",43,1,79,6535649,6540071,4422,4.4,"20"
"4533",43,7,21,6543186,6545802,2616,2.6,"20"
"4732",43,4,10,6550982,6554206,3224,3.2,"0"
"4923",43,2,48,6560081,6563077,2996,3,"0"
"5034",43,2,80,6566162,6568847,2685,2.7,"0"
"5132",43,8,30,6572239,6575116,2877,2.9,"0"
"5332",43,7,37,6581128,6586244,5116,5.1,"20"
"5430",43,5,75,6588639,6591965,3326,3.3,"20"
"5534",43,3,17,6594998,6598226,3228,3.2,"20"
"5730",43,3,65,6603970,6608310,4340,4.3,"20"
"5831",43,7,77,6610747,6613363,2616,2.6,"20"
"5932",43,6,52,6616896,6619157,2261,2.3,"0"
"6029",43,2,16,6621683,6624225,2542,2.5,"0"
"6227",43,8,46,6629082,6631747,2665,2.7,"0"
"6330",43,8,6,6634180,6637227,3047,3,"0"
"6529",43,2,72,6642258,6645901,3643,3.6,"0"
"6633",43,5,67,6648788,6653195,4407,4.4,"20"
"6732",43,1,55,6656260,6659767,3507,3.5,"20"
"6831",43,6,44,6662268,6664930,2662,2.7,"0"
"6933",43,8,54,6667268,6670368,3100,3.1,"0"
"7031",43,1,31,6673229,6676451,3222,3.2,"20"
"7234",43,2,64,6682044,6684886,2842,2.8,"0"
"7327",43,6,60,6687495,6689992,2497,2.5,"0"
"7432",43,6,12,6692387,6694860,2473,2.5,"0"
"7632",43,3,49,6700227,6704073,3846,3.8,"20"
"7730",43,3,41,6706616,6708935,2319,2.3,"20"
"7830",43,2,40,6711274,6713773,2499,2.5,"0"
"7932",43,7,45,6716427,6718645,2218,2.2,"20"
"8028",43,7,5,6721198,6723635,2437,2.4,"20"
"8232",43,3,73,6731047,6733740,2693,2.7,"20"
"8328",43,8,38,6736081,6738637,2556,2.6,"0"
"8430",43,6,68,6742597,6746627,4030,4,"0"
"8529",43,7,29,6748990,6752486,3496,3.5,"20"
"8730",43,2,32,6758356,6761782,3426,3.4,"0"
"8931",43,6,76,6766417,6770188,3771,3.8,"0"
"9030",43,3,57,6774210,6778068,3858,3.9,"20"
"9127",43,4,50,6781354,6783900,2546,2.5,"0"
"9232",43,7,13,6786237,6788904,2667,2.7,"20"
"9426",43,8,22,6794602,6798848,4246,4.2,"0"
"9635",43,2,24,6803536,6807072,3536,3.5,"0"
"9834",43,3,33,6812343,6814604,2261,2.3,"20"
"9932",43,4,66,6816958,6819612,2654,2.7,"0"
"10027",43,5,43,6822315,6825379,3064,3.1,"20"
"10148",43,1,47,6828808,6832041,3233,3.2,"20"
"10235",43,7,61,6834697,6837925,3228,3.2,"20"
"10331",43,1,23,6840483,6842220,1737,1.7,"20"
"10529",43,3,25,6846728,6849137,2409,2.4,"20"
"10733",43,1,15,6855281,6858495,3214,3.2,"20"
"10935",43,4,18,6863000,6865319,2319,2.3,"0"
"11137",43,2,8,6872912,6876493,3581,3.6,"0"
"11330",43,4,26,6881237,6883644,2407,2.4,"0"
"11531",43,4,34,6890941,6894564,3623,3.6,"0"
"11632",43,2,56,6897991,6900866,2875,2.9,"0"
"11731",43,5,19,6904275,6907489,3214,3.2,"20"
"11931",43,5,35,6913312,6916335,3023,3,"20"
"12032",43,3,9,6918715,6922424,3709,3.7,"20"
"10149",44,8,45,1375640,1380301,4661,4.7,"0"
"11138",44,3,16,1384343,1389163,4820,4.8,"20"
"1335",44,3,56,1395081,1399526,4445,4.4,"20"
"1426",44,1,38,1402931,1407530,4599,4.6,"20"
"1528",44,6,3,1413017,1419474,6457,6.5,"0"
"1729",44,7,68,1425516,1430189,4673,4.7,"20"
"1833",44,5,74,1432802,1437548,4746,4.7,"20"
"1931",44,8,21,1441966,1446947,4981,5,"0"
"2128",44,2,79,1452439,1457716,5277,5.3,"0"
"2233",44,2,31,1463585,1468018,4433,4.4,"0"
"2425",44,7,28,1474531,1478500,3969,4,"20"
"2633",44,7,76,1484905,1489570,4665,4.7,"20"
"2730",44,2,15,1495141,1498446,3305,3.3,"0"
"2935",44,2,71,1503789,1508350,4561,4.6,"0"
"3028",44,6,27,1510879,1515488,4609,4.6,"0"
"3231",44,8,5,1520513,1525273,4760,4.8,"0"
"3428",44,1,30,1532504,1536274,3770,3.8,"20"
"3633",44,7,60,1541022,1544486,3464,3.5,"20"
"3730",44,8,53,1549441,1553615,4174,4.2,"0"
"3833",44,4,17,1556864,1564207,7343,7.3,"0"
"4029",44,4,57,1572630,1576109,3479,3.5,"0"
"4129",44,7,36,1581447,1584694,3247,3.2,"20"
"4233",44,6,59,1587638,1591092,3454,3.5,"0"
"4329",44,6,75,1594343,1597594,3251,3.3,"0"
"4433",44,2,7,1600276,1605011,4735,4.7,"0"
"4630",44,3,64,1613482,1617427,3945,3.9,"20"
"4733",44,6,11,1619862,1624532,4670,4.7,"0"
"4924",44,5,58,1633303,1638419,5116,5.1,"20"
"5035",44,5,26,1642616,1646163,3547,3.5,"20"
"5226",44,4,1,1655655,1658316,2661,2.7,"0"
"5431",44,7,12,1667174,1669826,2652,2.7,"20"
"5628",44,2,63,1676499,1681296,4797,4.8,"0"
"5731",44,1,70,1686810,1691404,4594,4.6,"20"
"5832",44,5,34,1694110,1699902,5792,5.8,"20"
"5933",44,1,46,1706496,1711183,4687,4.7,"20"
"6030",44,4,49,1715320,1718661,3341,3.3,"0"
"6133",44,7,20,1722089,1726835,4746,4.7,"20"
"6331",44,6,67,1733011,1738145,5134,5.1,"0"
"6428",44,1,22,1741475,1745636,4161,4.2,"20"
"6634",44,6,43,1753115,1756001,2886,2.9,"0"
"6733",44,3,40,1758409,1761803,3394,3.4,"20"
"6832",44,4,25,1764458,1767824,3366,3.4,"0"
"7032",44,1,14,1772430,1777498,5068,5.1,"20"
"7235",44,4,33,1783565,1786436,2871,2.9,"0"
"7328",44,2,23,1789575,1792258,2683,2.7,"0"
"7525",44,6,35,1797833,1803732,5899,5.9,"0"
"7633",44,5,10,1806393,1810786,4393,4.4,"20"
"7831",44,8,29,1819713,1825158,5445,5.4,"0"
"8029",44,4,65,1830418,1834020,3602,3.6,"0"
"8130",44,7,52,1838597,1841925,3328,3.3,"20"
"8233",44,3,72,1844708,1848170,3462,3.5,"20"
"8329",44,5,66,1851578,1857968,6390,6.4,"20"
"8431",44,3,32,1863616,1867260,3644,3.6,"20"
"8627",44,1,78,1872785,1876792,4007,4,"20"
"8731",44,8,37,1880138,1884758,4620,4.6,"0"
"8829",44,2,55,1887615,1890212,2597,2.6,"0"
"8932",44,5,50,1892935,1896878,3943,3.9,"20"
"9031",44,5,42,1899827,1903258,3431,3.4,"20"
"9128",44,3,24,1905901,1908897,2996,3,"20"
"9327",44,5,2,1914747,1917661,2914,2.9,"20"
"9531",44,6,51,1926338,1929488,3150,3.1,"0"
"9636",44,4,73,1934421,1936980,2559,2.6,"0"
"9726",44,8,61,1939705,1942997,3292,3.3,"0"
"9835",44,4,41,1945557,1947967,2410,2.4,"0"
"9933",44,6,19,1950608,1954077,3469,3.5,"0"
"10150",44,1,62,1962484,1965783,3299,3.3,"20"
"10236",44,1,54,1970605,1973806,3201,3.2,"20"
"10332",44,3,48,1976504,1980024,3520,3.5,"20"
"10429",44,3,8,1984326,1987271,2945,2.9,"20"
"10629",44,7,4,1996670,1999995,3325,3.3,"20"
"10827",44,8,77,2004300,2006891,2591,2.6,"0"
"10936",44,3,80,2009756,2012644,2888,2.9,"20"
"11026",44,8,69,2018847,2021171,2324,2.3,"0"
"11139",44,2,39,2024729,2027282,2553,2.6,"0"
"11234",44,4,9,2030275,2034592,4317,4.3,"0"
"11427",44,7,44,2043855,2045955,2100,2.1,"20"
"11532",44,5,18,2051606,2054036,2430,2.4,"20"
"11732",44,1,6,2060807,2065132,4325,4.3,"20"
"11932",44,2,47,2071186,2073391,2205,2.2,"0"
"12033",44,8,13,2077577,2080268,2691,2.7,"0"
"10151",45,6,26,16259183,16262366,3183,3.2,"0"
"1238",45,4,8,16268678,16273959,5281,5.3,"0"
"1427",45,1,77,16279699,16285178,5479,5.5,"20"
"1529",45,3,63,16287645,16291077,3432,3.4,"20"
"1627",45,5,73,16293716,16297613,3897,3.9,"20"
"1730",45,6,34,16300164,16304486,4322,4.3,"0"
"1834",45,5,9,16307263,16312048,4785,4.8,"20"
"2029",45,4,32,16317516,16320742,3226,3.2,"0"
"2234",45,3,7,16327105,16330905,3800,3.8,"20"
"2426",45,8,68,16336429,16339930,3501,3.5,"0"
"2529",45,2,38,16344247,16348502,4255,4.3,"0"
"2634",45,7,75,16352098,16357175,5077,5.1,"20"
"2731",45,4,40,16359595,16363862,4267,4.3,"0"
"2830",45,1,21,16366702,16369883,3181,3.2,"20"
"3029",45,3,55,16374509,16377902,3393,3.4,"20"
"3131",45,1,69,16381801,16385669,3868,3.9,"20"
"3232",45,7,67,16389152,16394166,5014,5,"20"
"3335",45,5,33,16398452,16401131,2679,2.7,"20"
"3429",45,2,62,16403813,16406962,3149,3.1,"0"
"3529",45,2,6,16410272,16413995,3723,3.7,"0"
"3731",45,2,14,16419314,16423551,4237,4.2,"0"
"3930",45,7,51,16428952,16432702,3750,3.8,"20"
"4030",45,3,71,16435627,16438137,2510,2.5,"20"
"4130",45,3,31,16442129,16446074,3945,3.9,"20"
"4330",45,8,12,16454313,16458541,4228,4.2,"0"
"4534",45,7,43,16464427,16466676,2249,2.2,"20"
"4631",45,1,5,16469637,16474036,4399,4.4,"20"
"4830",45,7,35,16479654,16483483,3829,3.8,"20"
"4925",45,5,49,16488993,16492801,3808,3.8,"20"
"5036",45,8,60,16497626,16501300,3674,3.7,"0"
"5133",45,4,72,16508184,16512289,4105,4.1,"0"
"5227",45,5,25,16515945,16520148,4203,4.2,"20"
"5432",45,4,24,16525522,16531024,5502,5.5,"0"
"5629",45,7,19,16539795,16545682,5887,5.9,"20"
"5833",45,1,13,16552185,16555933,3748,3.7,"20"
"6031",45,3,15,16562830,16565871,3041,3,"20"
"6228",45,5,17,16570612,16574775,4163,4.2,"20"
"6429",45,3,39,16581974,16585234,3260,3.3,"20"
"6530",45,8,20,16587716,16590335,2619,2.6,"0"
"6734",45,2,22,16596249,16599543,3294,3.3,"0"
"6934",45,6,2,16606491,16609047,2556,2.6,"0"
"7130",45,6,50,16615263,16618035,2772,2.8,"0"
"7236",45,1,37,16626625,16630483,3858,3.9,"20"
"7329",45,1,29,16633865,16637613,3748,3.7,"20"
"7526",45,8,44,16642954,16646457,3503,3.5,"0"
"7634",45,8,28,16649268,16653478,4210,4.2,"0"
"7832",45,5,57,16660990,16663870,2880,2.9,"20"
"7933",45,7,27,16666750,16670452,3702,3.7,"20"
"8131",45,8,52,16677218,16680081,2863,2.9,"0"
"8234",45,2,46,16683890,16687821,3931,3.9,"0"
"8330",45,4,48,16690813,16694515,3702,3.7,"0"
"8432",45,1,45,16697779,16700858,3079,3.1,"20"
"8530",45,1,61,16703502,16707145,3643,3.6,"20"
"8628",45,3,47,16709757,16713349,3592,3.6,"20"
"8732",45,2,54,16716900,16720467,3567,3.6,"0"
"8830",45,7,3,16724956,16728168,3212,3.2,"20"
"9032",45,4,56,16733504,16736695,3191,3.2,"0"
"9129",45,8,76,16739817,16742776,2959,3,"0"
"9233",45,6,74,16746567,16749960,3393,3.4,"0"
"9328",45,8,4,16753089,16755614,2525,2.5,"0"
"9532",45,6,58,16760841,16763653,2812,2.8,"0"
"9637",45,7,59,16767672,16772270,4598,4.6,"20"
"9727",45,6,18,16774832,16778219,3387,3.4,"0"
"9934",45,2,70,16784727,16788477,3750,3.8,"0"
"10028",45,1,53,16791195,16795013,3818,3.8,"20"
"10152",45,3,79,16798291,16801690,3399,3.4,"20"
"10237",45,2,78,16805132,16807889,2757,2.8,"0"
"10333",45,6,42,16810400,16813859,3459,3.5,"0"
"10430",45,6,10,16816709,16819773,3064,3.1,"0"
"10630",45,2,30,16828909,16833092,4183,4.2,"0"
"10828",45,3,23,16837742,16841107,3365,3.4,"20"
"11027",45,7,11,16846093,16849651,3558,3.6,"20"
"11235",45,5,1,16855043,16858466,3423,3.4,"20"
"11428",45,5,41,16864409,16866850,2441,2.4,"20"
"11533",45,4,16,16875887,16878850,2963,3,"0"
"11733",45,4,80,16884807,16887315,2508,2.5,"0"
"11828",45,8,36,16889882,16893254,3372,3.4,"0"
"11933",45,4,64,16896852,16900059,3207,3.2,"0"
"12034",45,6,66,16903969,16906630,2661,2.7,"0"
"12123",45,5,65,16909347,16912913,3566,3.6,"20"
"10153",46,4,39,25552514,25555921,3407,3.4,"0"
"11140",46,6,73,25558684,25562085,3401,3.4,"0"
"1239",46,1,12,25564608,25568437,3829,3.8,"20"
"1428",46,4,47,25576160,25578399,2239,2.2,"0"
"1530",46,5,72,25580719,25584701,3982,4,"20"
"1628",46,4,23,25587034,25588972,1938,1.9,"0"
"1835",46,4,7,25593997,25597770,3773,3.8,"0"
"2030",46,3,38,25605641,25608568,2927,2.9,"20"
"2129",46,1,68,25611410,25614396,2986,3,"20"
"2235",46,6,65,25617003,25622198,5195,5.2,"0"
"2331",46,6,57,25626427,25628763,2336,2.3,"0"
"2427",46,1,60,25631224,25634274,3050,3,"20"
"2530",46,8,3,25636849,25640794,3945,3.9,"0"
"2732",46,6,25,25645858,25648712,2854,2.9,"0"
"2936",46,8,19,25653457,25655793,2336,2.3,"0"
"3132",46,8,11,25662263,25666152,3889,3.9,"0"
"3336",46,3,30,25673094,25675832,2738,2.7,"20"
"3530",46,7,42,25680320,25683930,3610,3.6,"20"
"3634",46,8,51,25687623,25691129,3506,3.5,"0"
"3732",46,4,31,25694340,25697641,3301,3.3,"0"
"3931",46,6,17,25702878,25707386,4508,4.5,"0"
"4131",46,1,44,25712792,25716065,3273,3.3,"20"
"4234",46,8,35,25719246,25721807,2561,2.6,"0"
"4331",46,6,1,25726059,25728237,2178,2.2,"0"
"4535",46,3,6,25733035,25737043,4008,4,"20"
"4734",46,5,40,25742200,25744922,2722,2.7,"20"
"4831",46,1,4,25748248,25750903,2655,2.7,"20"
"5037",46,6,9,25757981,25761074,3093,3.1,"0"
"5228",46,4,79,25767805,25771005,3200,3.2,"0"
"5333",46,5,56,25773343,25776001,2658,2.7,"20"
"5433",46,7,10,25781176,25784291,3115,3.1,"20"
"5630",46,3,46,25792681,25795798,3117,3.1,"20"
"5732",46,8,67,25798363,25801576,3213,3.2,"0"
"5834",46,5,48,25804233,25807077,2844,2.8,"20"
"5934",46,6,49,25809447,25811597,2150,2.1,"0"
"6032",46,1,76,25815873,25820813,4940,4.9,"20"
"6134",46,2,53,25823338,25826544,3206,3.2,"0"
"6229",46,4,15,25833501,25835682,2181,2.2,"0"
"6430",46,7,26,25841117,25844194,3077,3.1,"20"
"6635",46,2,29,25852563,25856780,4217,4.2,"0"
"6833",46,5,24,25866505,25869050,2545,2.5,"20"
"7033",46,2,37,25874587,25876860,2273,2.3,"0"
"7131",46,7,50,25879358,25881716,2358,2.4,"20"
"7237",46,1,28,25884951,25888507,3556,3.6,"20"
"7433",46,3,22,25893252,25896060,2808,2.8,"20"
"7635",46,4,55,25902425,25905790,3365,3.4,"0"
"7731",46,1,20,25909418,25911613,2195,2.2,"20"
"7934",46,2,13,25919430,25922908,3478,3.5,"0"
"8132",46,3,54,25927051,25930650,3599,3.6,"20"
"8235",46,2,21,25933128,25935804,2676,2.7,"0"
"8433",46,7,2,25940854,25944304,3450,3.5,"20"
"8629",46,8,43,25949542,25951760,2218,2.2,"0"
"8733",46,2,69,25956761,25960000,3239,3.2,"0"
"8831",46,7,66,25962614,25964807,2193,2.2,"20"
"8933",46,4,63,25967383,25970102,2719,2.7,"0"
"9033",46,6,41,25973352,25976204,2852,2.9,"0"
"9130",46,5,64,25978839,25981061,2222,2.2,"20"
"9234",46,2,61,25983532,25986130,2598,2.6,"0"
"9329",46,2,45,25988452,25990565,2113,2.1,"0"
"9427",46,4,71,25995197,25997236,2039,2,"0"
"9533",46,7,18,26000090,26002810,2720,2.7,"20"
"9728",46,2,5,26009238,26012351,3113,3.1,"0"
"9935",46,3,62,26018861,26022260,3399,3.4,"20"
"10029",46,1,52,26026915,26029497,2582,2.6,"20"
"10154",46,5,8,26032020,26036371,4351,4.4,"20"
"10334",46,5,32,26041170,26044065,2895,2.9,"20"
"10530",46,7,58,26051634,26054737,3103,3.1,"20"
"10631",46,7,34,26058755,26062635,3880,3.9,"20"
"10734",46,2,77,26066815,26069048,2233,2.2,"0"
"10829",46,3,78,26071442,26074092,2650,2.6,"20"
"10937",46,1,36,26080279,26082629,2350,2.4,"20"
"11028",46,3,14,26084968,26088263,3295,3.3,"20"
"11236",46,7,74,26093354,26096406,3052,3.1,"20"
"11331",46,3,70,26100770,26103463,2693,2.7,"20"
"11429",46,8,75,26106755,26109191,2436,2.4,"0"
"11534",46,8,27,26111947,26114245,2298,2.3,"0"
"11734",46,5,16,26120381,26122855,2474,2.5,"20"
"11934",46,8,59,26128221,26130961,2740,2.7,"0"
"12035",46,5,80,26134549,26136549,2000,2,"20"
"12124",46,6,33,26141961,26144874,2913,2.9,"0"
"10155",47,8,66,7263253,7270571,7318,7.3,"0"
"11141",47,3,13,7275906,7285036,9130,9.1,"20"
"1336",47,3,37,7290289,7296239,5950,6,"20"
"1429",47,8,26,7302581,7307577,4996,5,"0"
"1629",47,4,46,7316293,7322583,6290,6.3,"0"
"1731",47,6,24,7328090,7336025,7935,7.9,"0"
"1932",47,7,57,7341378,7346763,5385,5.4,"20"
"2031",47,6,64,7358168,7363116,4948,4.9,"0"
"2130",47,7,65,7365470,7375688,10218,10.2,"20"
"2236",47,4,30,7383022,7387866,4844,4.8,"0"
"2428",47,6,16,7396069,7401949,5880,5.9,"0"
"2635",47,1,27,7408154,7416713,8559,8.6,"20"
"2831",47,4,78,7422893,7430141,7248,7.2,"0"
"2937",47,2,44,7438730,7444753,6023,6,"0"
"3030",47,5,15,7452466,7457780,5314,5.3,"20"
"3233",47,1,11,7463996,7472366,8370,8.4,"20"
"3430",47,5,39,7485664,7492728,7064,7.1,"20"
"3531",47,4,22,7502197,7507930,5733,5.7,"0"
"3733",47,8,42,7513496,7518607,5111,5.1,"0"
"3834",47,3,5,7522813,7532586,9773,9.8,"20"
"4031",47,1,67,7542391,7549282,6891,6.9,"20"
"4132",47,6,48,7557822,7564656,6834,6.8,"0"
"4235",47,2,60,7572979,7577170,4191,4.2,"0"
"4332",47,3,69,7580862,7585107,4245,4.2,"20"
"4434",47,3,29,7589100,7594131,5031,5,"20"
"4632",47,2,68,7600813,7604339,3526,3.5,"0"
"4735",47,2,76,7608003,7611445,3442,3.4,"0"
"4832",47,5,55,7619762,7622795,3033,3,"20"
"4926",47,4,70,7626066,7630084,4018,4,"0"
"5038",47,5,79,7640154,7648282,8128,8.1,"20"
"5134",47,4,14,7651601,7661789,10188,10.2,"0"
"5334",47,1,43,7674061,7676958,2897,2.9,"20"
"5434",47,6,40,7681969,7686785,4816,4.8,"0"
"5535",47,2,4,7692158,7695570,3412,3.4,"0"
"5733",47,7,17,7706716,7714297,7581,7.6,"20"
"5935",47,2,20,7724652,7727894,3242,3.2,"0"
"6135",47,3,45,7736913,7740760,3847,3.8,"20"
"6230",47,4,38,7744993,7750116,5123,5.1,"0"
"6332",47,8,10,7753547,7757956,4409,4.4,"0"
"6531",47,3,21,7765705,7769671,3966,4,"20"
"6735",47,5,71,7775556,7781672,6116,6.1,"20"
"6834",47,7,9,7784424,7788783,4359,4.4,"20"
"7034",47,4,54,7794254,7801895,7641,7.6,"0"
"7132",47,1,59,7806235,7809899,3664,3.7,"20"
"7238",47,7,41,7816119,7819986,3867,3.9,"20"
"7330",47,5,31,7824674,7829527,4853,4.9,"20"
"7527",47,1,19,7833849,7836764,2915,2.9,"20"
"7732",47,7,1,7843733,7852193,8460,8.5,"20"
"7935",47,8,50,7860324,7866183,5859,5.9,"0"
"8030",47,1,51,7870902,7874474,3572,3.6,"20"
"8133",47,5,23,7880215,7883203,2988,3,"20"
"8331",47,8,58,7891648,7895410,3762,3.8,"0"
"8434",47,3,61,7899523,7903009,3486,3.5,"20"
"8531",47,3,53,7906684,7914028,7344,7.3,"20"
"8630",47,8,34,7917633,7922208,4575,4.6,"0"
"8734",47,8,18,7925366,7928495,3129,3.1,"0"
"8934",47,4,6,7934760,7941658,6898,6.9,"0"
"9131",47,5,7,7948892,7955455,6563,6.6,"20"
"9330",47,8,74,7965354,7968229,2875,2.9,"0"
"9428",47,1,35,7972790,7976113,3323,3.3,"20"
"9534",47,2,28,7979998,7983642,3644,3.6,"0"
"9729",47,1,75,7989809,7995556,5747,5.7,"20"
"9836",47,2,52,7999066,8002308,3242,3.2,"0"
"9936",47,7,49,8004778,8007698,2920,2.9,"20"
"10030",47,7,25,8010409,8013455,3046,3,"20"
"10238",47,6,8,8023620,8027650,4030,4,"0"
"10431",47,1,3,8033118,8038220,5102,5.1,"20"
"10632",47,6,56,8048992,8051125,2133,2.1,"0"
"10735",47,6,32,8060543,8063407,2864,2.9,"0"
"10938",47,5,47,8069294,8072358,3064,3.1,"20"
"11029",47,2,36,8080074,8084439,4365,4.4,"0"
"11142",47,7,33,8087614,8091500,3886,3.9,"20"
"11237",47,6,72,8094564,8103684,9120,9.1,"0"
"11332",47,3,77,8108567,8113012,4445,4.4,"20"
"11430",47,4,62,8117093,8121641,4548,4.5,"0"
"11535",47,5,63,8126520,8130567,4047,4,"20"
"11633",47,6,80,8138080,8141410,3330,3.3,"0"
"11735",47,2,12,8145408,8148742,3334,3.3,"0"
"11935",47,7,73,8155012,8160016,5004,5,"20"
"12036",47,8,2,8172957,8176523,3566,3.6,"0"
"10156",48,4,37,9436516,9441527,5011,5,"0"
"11143",48,4,13,9444267,9448871,4604,4.6,"0"
"1337",48,3,68,9454565,9458918,4353,4.4,"20"
"1430",48,5,14,9461659,9466881,5222,5.2,"20"
"1630",48,2,67,9472277,9476199,3922,3.9,"0"
"1732",48,2,43,9478886,9482333,3447,3.4,"0"
"1836",48,7,8,9484895,9488107,3212,3.2,"20"
"2032",48,7,16,9494052,9496553,2501,2.5,"20"
"2237",48,5,46,9503882,9508383,4501,4.5,"20"
"2332",48,3,36,9511060,9517550,6490,6.5,"20"
"2429",48,8,17,9521124,9526090,4966,5,"0"
"2636",48,1,58,9532187,9535326,3139,3.1,"20"
"2733",48,4,53,9537991,9544849,6858,6.9,"0"
"2832",48,7,32,9547347,9550716,3369,3.4,"20"
"3031",48,1,34,9557505,9562449,4944,4.9,"20"
"3133",48,2,27,9565112,9568124,3012,3,"0"
"3337",48,7,80,9574892,9577328,2436,2.4,"20"
"3431",48,7,48,9581110,9586272,5162,5.2,"20"
"3532",48,5,30,9589532,9592797,3265,3.3,"20"
"3734",48,5,62,9597574,9605955,8381,8.4,"20"
"3835",48,6,39,9608544,9612079,3535,3.5,"0"
"3932",48,3,52,9615235,9618755,3520,3.5,"20"
"4032",48,7,56,9621229,9623066,1837,1.8,"20"
"4133",48,1,10,9626680,9630122,3442,3.4,"20"
"4333",48,3,12,9634988,9637273,2285,2.3,"20"
"4536",48,6,31,9642762,9646771,4009,4,"0"
"4736",48,3,20,9653476,9657597,4121,4.1,"20"
"4927",48,6,23,9664354,9667617,3263,3.3,"0"
"5135",48,6,55,9672409,9675571,3162,3.2,"0"
"5229",48,2,51,9678150,9681025,2875,2.9,"0"
"5335",48,6,7,9683615,9687843,4228,4.2,"0"
"5536",48,4,5,9695269,9702894,7625,7.6,"0"
"5734",48,3,60,9708622,9711048,2426,2.4,"20"
"5835",48,8,73,9714395,9719236,4841,4.8,"0"
"5936",48,5,22,9723454,9728034,4580,4.6,"20"
"6136",48,8,57,9733198,9736771,3573,3.6,"0"
"6231",48,4,69,9739252,9742142,2890,2.9,"0"
"6333",48,3,28,9745879,9751067,5188,5.2,"20"
"6532",48,2,3,9756227,9759378,3151,3.2,"0"
"6736",48,1,2,9765889,9769278,3389,3.4,"20"
"6935",48,5,38,9774123,9777207,3084,3.1,"20"
"7035",48,4,29,9782014,9786197,4183,4.2,"0"
"7239",48,7,72,9792241,9799039,6798,6.8,"20"
"7331",48,6,71,9803548,9805661,2113,2.1,"0"
"7434",48,7,64,9808101,9810939,2838,2.8,"20"
"7528",48,8,41,9813767,9817262,3495,3.5,"0"
"7636",48,7,40,9819790,9824552,4762,4.8,"20"
"7733",48,2,59,9827209,9830653,3444,3.4,"0"
"7833",48,3,4,9833255,9835313,2058,2.1,"20"
"8031",48,4,21,9841384,9844167,2783,2.8,"0"
"8236",48,8,9,9851056,9855513,4457,4.5,"0"
"8435",48,1,42,9860263,9863078,2815,2.8,"20"
"8532",48,3,76,9865949,9868061,2112,2.1,"20"
"8631",48,2,19,9870561,9872290,1729,1.7,"0"
"8832",48,8,33,9880025,9882362,2337,2.3,"0"
"8935",48,5,70,9887918,9891050,3132,3.1,"20"
"9034",48,4,77,9893630,9896585,2955,3,"0"
"9132",48,3,44,9899445,9902617,3172,3.2,"20"
"9235",48,6,79,9905372,9908371,2999,3,"0"
"9331",48,1,18,9911733,9914021,2288,2.3,"20"
"9535",48,7,24,9921697,9924257,2560,2.6,"20"
"9730",48,5,54,9928997,9933226,4229,4.2,"20"
"9837",48,6,63,9935727,9943741,8014,8,"0"
"9937",48,5,78,9946237,9949244,3007,3,"20"
"10031",48,1,66,9951675,9954260,2585,2.6,"20"
"10157",48,8,1,9957092,9961414,4322,4.3,"0"
"10335",48,6,15,9966295,9968609,2314,2.3,"0"
"10531",48,5,6,9972944,9977633,4689,4.7,"20"
"10736",48,1,50,9982959,9986226,3267,3.3,"20"
"10830",48,2,75,9988631,9990835,2204,2.2,"0"
"10939",48,4,45,9993573,9995863,2290,2.3,"0"
"11030",48,8,25,9999031,10002210,3179,3.2,"0"
"11238",48,8,65,10006883,10010257,3374,3.4,"0"
"11333",48,1,74,10012755,10015417,2662,2.7,"20"
"11431",48,4,61,10017972,10021304,3332,3.3,"0"
"11536",48,2,11,10024026,10026386,2360,2.4,"0"
"11736",48,6,47,10031522,10033532,2010,2,"0"
"11829",48,8,49,10035989,10038634,2645,2.6,"0"
"11936",48,1,26,10041185,10044309,3124,3.1,"20"
"12125",48,2,35,10050126,10053229,3103,3.1,"0"
"10158",49,8,16,14385117,14388067,2950,3,"0"
"1240",49,6,62,14392820,14397127,4307,4.3,"0"
"1338",49,3,75,14399686,14403186,3500,3.5,"20"
"1431",49,8,24,14405698,14409761,4063,4.1,"0"
"1631",49,5,69,14415256,14418321,3065,3.1,"20"
"1733",49,7,7,14420789,14424311,3522,3.5,"20"
"1933",49,4,44,14429977,14433109,3132,3.1,"0"
"2033",49,7,55,14435577,14439932,4355,4.4,"20"
"2131",49,4,20,14442399,14445078,2679,2.7,"0"
"2333",49,6,14,14449904,14453294,3390,3.4,"0"
"2531",49,4,68,14458856,14461662,2806,2.8,"0"
"2637",49,2,26,14464157,14467025,2868,2.9,"0"
"2833",49,5,29,14471789,14474442,2653,2.7,"20"
"3032",49,3,51,14480198,14484207,4009,4,"20"
"3134",49,5,61,14486642,14490025,3383,3.4,"20"
"3234",49,3,67,14492625,14496397,3772,3.8,"20"
"3338",49,1,33,14499015,14501314,2299,2.3,"20"
"3432",49,7,47,14503818,14506388,2570,2.6,"20"
"3533",49,1,73,14508885,14512850,3965,4,"20"
"3635",49,2,2,14515436,14517832,2396,2.4,"0"
"3836",49,2,50,14523169,14525435,2266,2.3,"0"
"3933",49,4,76,14527957,14531720,3763,3.8,"0"
"4033",49,5,53,14535882,14540021,4139,4.1,"20"
"4134",49,7,71,14542407,14545271,2864,2.9,"20"
"4236",49,5,5,14548343,14553097,4754,4.8,"20"
"4435",49,7,15,14559135,14562439,3304,3.3,"20"
"4633",49,5,77,14566930,14569387,2457,2.5,"20"
"4737",49,4,60,14571937,14576106,4169,4.2,"0"
"4833",49,1,1,14579019,14581966,2947,2.9,"20"
"5039",49,3,35,14587671,14590845,3174,3.2,"20"
"5136",49,3,19,14593542,14596152,2610,2.6,"20"
"5336",49,2,10,14601799,14605150,3351,3.4,"0"
"5537",49,6,78,14610483,14613968,3485,3.5,"0"
"5631",49,6,70,14616471,14619970,3499,3.5,"0"
"5735",49,2,74,14622534,14626540,4006,4,"0"
"5836",49,1,41,14629046,14632817,3771,3.8,"20"
"5937",49,1,57,14635509,14638754,3245,3.2,"20"
"6033",49,3,11,14641242,14643582,2340,2.3,"20"
"6232",49,6,6,14649462,14653168,3706,3.7,"0"
"6431",49,7,23,14663393,14666612,3219,3.2,"20"
"6636",49,7,31,14671589,14675852,4263,4.3,"20"
"6835",49,4,12,14681432,14684154,2722,2.7,"0"
"7036",49,1,65,14689731,14693755,4024,4,"20"
"7133",49,2,66,14696393,14700206,3813,3.8,"0"
"7240",49,6,46,14702907,14705786,2879,2.9,"0"
"7332",49,4,52,14708293,14712229,3936,3.9,"0"
"7435",49,1,25,14714685,14717634,2949,2.9,"20"
"7637",49,2,18,14722350,14726304,3954,4,"0"
"7834",49,8,8,14731400,14735000,3600,3.6,"0"
"8032",49,4,4,14740417,14743158,2741,2.7,"0"
"8237",49,8,40,14747535,14751058,3523,3.5,"0"
"8332",49,4,28,14754003,14758250,4247,4.2,"0"
"8533",49,5,37,14763233,14766002,2769,2.8,"20"
"8632",49,6,30,14770455,14773849,3394,3.4,"0"
"8833",49,8,48,14778579,14782848,4269,4.3,"0"
"8936",49,2,58,14785290,14789490,4200,4.2,"0"
"9035",49,1,17,14791992,14796686,4694,4.7,"20"
"9236",49,3,43,14804224,14806847,2623,2.6,"20"
"9332",49,5,45,14809353,14812130,2777,2.8,"20"
"9429",49,6,38,14814905,14819097,4192,4.2,"0"
"9536",49,7,39,14822149,14826378,4229,4.2,"20"
"9638",49,5,13,14828963,14834102,5139,5.1,"20"
"9838",49,8,56,14838711,14841147,2436,2.4,"0"
"9938",49,8,32,14843933,14846559,2626,2.6,"0"
"10159",49,6,22,14851847,14855300,3453,3.5,"0"
"10336",49,1,9,14861233,14864373,3140,3.1,"20"
"10532",49,3,27,14869011,14871933,2922,2.9,"20"
"10737",49,8,72,14876721,14882465,5744,5.7,"0"
"10831",49,8,80,14884967,14887616,2649,2.6,"0"
"10940",49,5,21,14890214,14894271,4057,4.1,"20"
"11144",49,4,36,14899501,14902025,2524,2.5,"0"
"11239",49,3,3,14904483,14907397,2914,2.9,"20"
"11432",49,1,49,14911858,14914986,3128,3.1,"20"
"11537",49,2,42,14917407,14921751,4344,4.3,"0"
"11634",49,2,34,14928022,14931795,3773,3.8,"0"
"11737",49,7,79,14934346,14938537,4191,4.2,"20"
"11830",49,8,64,14940982,14945001,4019,4,"0"
"11937",49,6,54,14947553,14951573,4020,4,"0"
"12037",49,3,59,14954402,14957570,3168,3.2,"20"
"12126",49,7,63,14960303,14964506,4203,4.2,"20"
"10160",50,7,62,19063965,19069120,5155,5.2,"20"
"11145",50,3,18,19071944,19075931,3987,4,"20"
"1339",50,6,5,19081106,19086389,5283,5.3,"0"
"1531",50,6,13,19092297,19097354,5057,5.1,"0"
"1734",50,4,35,19104625,19108119,3494,3.5,"0"
"1837",50,6,61,19110774,19117015,6241,6.2,"0"
"1934",50,8,79,19119698,19123170,3472,3.5,"0"
"2034",50,3,74,19125914,19129239,3325,3.3,"20"
"2132",50,3,10,19132609,19136537,3928,3.9,"20"
"2334",50,8,7,19142075,19145564,3489,3.5,"0"
"2532",50,2,49,19152770,19156944,4174,4.2,"0"
"2638",50,4,59,19159602,19163266,3664,3.7,"0"
"2734",50,2,25,19169640,19172749,3109,3.1,"0"
"2938",50,2,33,19178616,19181138,2522,2.5,"0"
"3033",50,1,40,19184684,19188329,3645,3.6,"20"
"3135",50,1,80,19190893,19193492,2599,2.6,"20"
"3235",50,8,15,19198339,19201134,2795,2.8,"0"
"3433",50,5,60,19209467,19211935,2468,2.5,"20"
"3534",50,6,21,19214677,19218472,3795,3.8,"0"
"3735",50,7,70,19224615,19227380,2765,2.8,"20"
"3837",50,7,54,19232443,19236530,4087,4.1,"20"
"3934",50,3,42,19239716,19243275,3559,3.6,"20"
"4034",50,3,2,19245826,19248783,2957,3,"20"
"4237",50,6,77,19259074,19262640,3566,3.6,"0"
"4334",50,1,72,19266144,19269360,3216,3.2,"20"
"4436",50,7,22,19271886,19274384,2498,2.5,"20"
"4634",50,4,11,19280437,19283521,3084,3.1,"0"
"4834",50,6,45,19289586,19292091,2505,2.5,"0"
"4928",50,2,1,19295135,19297635,2500,2.5,"0"
"5137",50,4,27,19303382,19306261,2879,2.9,"0"
"5337",50,8,71,19312238,19315148,2910,2.9,"0"
"5435",50,6,29,19320716,19324873,4157,4.2,"0"
"5632",50,8,47,19330393,19332638,2245,2.2,"0"
"5736",50,1,56,19336412,19338625,2213,2.2,"20"
"5837",50,7,14,19341108,19345053,3945,3.9,"20"
"6034",50,8,31,19353738,19357044,3306,3.3,"0"
"6233",50,7,46,19365207,19370555,5348,5.3,"20"
"6334",50,1,48,19373227,19376747,3520,3.5,"20"
"6432",50,8,23,19379628,19381955,2327,2.3,"0"
"6637",50,3,26,19386475,19389098,2623,2.6,"20"
"6836",50,8,39,19395971,19401084,5113,5.1,"0"
"6936",50,4,75,19403680,19406154,2474,2.5,"0"
"7037",50,2,41,19410272,19413218,2946,2.9,"0"
"7134",50,1,24,19415609,19419283,3674,3.7,"20"
"7333",50,5,52,19424083,19427585,3502,3.5,"20"
"7436",50,7,78,19432267,19435442,3175,3.2,"20"
"7529",50,5,4,19438849,19441491,2642,2.6,"20"
"7734",50,3,34,19449179,19452439,3260,3.3,"20"
"7835",50,4,67,19456569,19459193,2624,2.6,"0"
"7936",50,4,3,19462118,19464148,2030,2,"0"
"8134",50,3,50,19505598,19508431,2833,2.8,"20"
"8238",50,2,57,19511971,19515029,3058,3.1,"0"
"8333",50,4,19,19518066,19520741,2675,2.7,"0"
"8534",50,4,51,19528492,19531794,3302,3.3,"0"
"8633",50,3,58,19534261,19537198,2937,2.9,"20"
"8735",50,3,66,19539613,19543083,3470,3.5,"20"
"8834",50,1,16,19545572,19548258,2686,2.7,"20"
"9036",50,1,8,19554790,19557250,2460,2.5,"20"
"9237",50,5,36,19562692,19565807,3115,3.1,"20"
"9333",50,6,69,19570314,19572806,2492,2.5,"0"
"9430",50,6,53,19575877,19579118,3241,3.2,"0"
"9537",50,8,55,19584180,19586993,2813,2.8,"0"
"9639",50,4,43,19589763,19592285,2522,2.5,"0"
"9731",50,5,20,19594867,19597153,2286,2.3,"20"
"9939",50,7,30,19604448,19606683,2235,2.2,"20"
"10161",50,1,32,19611489,19614306,2817,2.8,"20"
"10337",50,5,68,19619568,19622319,2751,2.8,"20"
"10432",50,8,63,19624864,19628062,3198,3.2,"0"
"10533",50,2,17,19630651,19634172,3521,3.5,"0"
"10738",50,2,65,19638931,19641192,2261,2.3,"0"
"10832",50,1,64,19647861,19650655,2794,2.8,"20"
"10941",50,2,9,19653017,19655465,2448,2.4,"0"
"11146",50,6,37,19660700,19663264,2564,2.6,"0"
"11240",50,5,12,19666899,19669493,2594,2.6,"20"
"11433",50,5,28,19675493,19678547,3054,3.1,"20"
"11635",50,5,76,19684907,19688193,3286,3.3,"20"
"11738",50,2,73,19693419,19696118,2699,2.7,"0"
"11831",50,7,6,19698876,19702597,3721,3.7,"20"
"12038",50,5,44,19709105,19712158,3053,3.1,"20"
"12127",50,7,38,19714683,19717443,2760,2.8,"20"
"10162",51,2,48,2156400,2165848,9448,9.4,"0"
"11147",51,5,51,2168401,2173702,5301,5.3,"20"
"1241",51,1,31,2176270,2182717,6447,6.4,"20"
"1432",51,6,68,2188589,2194956,6367,6.4,"0"
"1532",51,7,21,2197406,2203103,5697,5.7,"20"
"1735",51,5,67,2208292,2216724,8432,8.4,"20"
"1838",51,1,71,2219369,2222673,3304,3.3,"20"
"1935",51,3,17,2225134,2231339,6205,6.2,"20"
"2133",51,5,27,2238088,2241489,3401,3.4,"20"
"2335",51,8,6,2246901,2255264,8363,8.4,"0"
"2533",51,8,22,2262847,2272237,9390,9.4,"0"
"2735",51,4,18,2277220,2282133,4913,4.9,"0"
"2939",51,3,25,2290389,2294286,3897,3.9,"20"
"3136",51,6,76,2300981,2306534,5553,5.6,"0"
"3236",51,2,72,2310122,2315148,5026,5,"0"
"3339",51,7,37,2317596,2322707,5111,5.1,"20"
"3434",51,7,45,2325279,2331850,6571,6.6,"20"
"3535",51,6,28,2337250,2344543,7293,7.3,"0"
"3736",51,4,2,2353125,2359130,6005,6,"0"
"3935",51,8,62,2366893,2372198,5305,5.3,"0"
"4035",51,4,34,2374660,2381774,7114,7.1,"0"
"4135",51,2,40,2386122,2389653,3531,3.5,"0"
"4238",51,6,4,2395042,2399221,4179,4.2,"0"
"4437",51,3,65,2406455,2414620,8165,8.2,"20"
"4537",51,8,70,2419425,2424019,4594,4.6,"0"
"4635",51,1,79,2428065,2431699,3634,3.6,"20"
"4738",51,1,47,2436040,2439627,3587,3.6,"20"
"4835",51,5,59,2442194,2447662,5468,5.5,"20"
"4929",51,6,60,2450247,2453476,3229,3.2,"0"
"5040",51,6,12,2456662,2460351,3689,3.7,"0"
"5230",51,6,52,2468293,2471536,3243,3.2,"0"
"5338",51,8,78,2476047,2483528,7481,7.5,"0"
"5436",51,5,35,2486163,2490442,4279,4.3,"20"
"5538",51,2,8,2494573,2499246,4673,4.7,"0"
"5737",51,8,14,2509231,2515850,6619,6.6,"0"
"5938",51,7,69,2524022,2529450,5428,5.4,"20"
"6035",51,2,64,2532300,2536715,4415,4.4,"0"
"6137",51,5,11,2539348,2543116,3768,3.8,"20"
"6335",51,1,55,2550860,2555141,4281,4.3,"20"
"6433",51,6,36,2559258,2562210,2952,3,"0"
"6533",51,1,63,2565812,2573941,8129,8.1,"20"
"6638",51,7,61,2577776,2586242,8466,8.5,"20"
"6737",51,4,50,2589257,2593314,4057,4.1,"0"
"6837",51,7,5,2600333,2608962,8629,8.6,"20"
"7038",51,1,7,2616848,2620333,3485,3.5,"20"
"7241",51,3,57,2631576,2636748,5172,5.2,"20"
"7334",51,4,66,2639732,2643424,3692,3.7,"0"
"7437",51,4,10,2646360,2651213,4853,4.9,"0"
"7638",51,6,44,2659998,2664124,4126,4.1,"0"
"7735",51,7,53,2670372,2676786,6414,6.4,"20"
"7836",51,5,43,2680369,2684727,4358,4.4,"20"
"7937",51,8,46,2689564,2694055,4491,4.5,"0"
"8033",51,2,56,2697293,2701462,4169,4.2,"0"
"8135",51,2,80,2704005,2710085,6080,6.1,"0"
"8239",51,4,58,2712868,2719242,6374,6.4,"0"
"8334",51,4,26,2723405,2728892,5487,5.5,"0"
"8535",51,3,41,2737493,2741308,3815,3.8,"20"
"8634",51,3,73,2746652,2757009,10357,10.4,"20"
"8736",51,6,20,2761636,2764176,2540,2.5,"0"
"8937",51,3,33,2772501,2775764,3263,3.3,"20"
"9037",51,8,54,2781351,2789008,7657,7.7,"0"
"9133",51,2,16,2832216,2836112,3896,3.9,"0"
"9334",51,5,3,2843761,2846977,3216,3.2,"20"
"9538",51,1,39,2853451,2858419,4968,5,"20"
"9640",51,4,42,2861679,2866185,4506,4.5,"0"
"9732",51,3,9,2870135,2874925,4790,4.8,"20"
"9940",51,4,74,2881175,2884719,3544,3.5,"0"
"10032",51,7,13,2887751,2892304,4553,4.6,"20"
"10239",51,8,30,2899030,2901397,2367,2.4,"0"
"10433",51,2,24,2905820,2910360,4540,4.5,"0"
"10633",51,2,32,2918099,2922415,4316,4.3,"0"
"10833",51,7,29,2927796,2933348,5552,5.6,"20"
"11031",51,1,15,2938181,2941224,3043,3,"20"
"11241",51,3,1,2948993,2952617,3624,3.6,"20"
"11434",51,1,23,2960689,2963862,3173,3.2,"20"
"11636",51,5,75,3004459,3009169,4710,4.7,"20"
"11739",51,8,38,3013129,3017389,4260,4.3,"0"
"11832",51,7,77,3021717,3026306,4589,4.6,"20"
"11938",51,3,49,3028890,3033057,4167,4.2,"20"
"12039",51,5,19,3035642,3039273,3631,3.6,"20"
"10163",52,4,1,4096220,4099909,3689,3.7,"0"
"1242",52,4,41,4107507,4113043,5536,5.5,"0"
"1340",52,2,23,4116458,4119691,3233,3.2,"0"
"1533",52,1,78,4125750,4129451,3701,3.7,"20"
"1632",52,7,12,4131947,4134857,2910,2.9,"20"
"1839",52,4,73,4140500,4143178,2678,2.7,"0"
"1936",52,2,79,4145844,4149748,3904,3.9,"0"
"2035",52,1,38,4153205,4156038,2833,2.8,"20"
"2134",52,6,51,4159115,4163140,4025,4,"0"
"2238",52,5,10,4166453,4170652,4199,4.2,"20"
"2430",52,2,15,4176301,4179360,3059,3.1,"0"
"2639",52,1,54,4184966,4188846,3880,3.9,"20"
"2736",52,5,50,4191563,4194898,3335,3.3,"20"
"2834",52,8,13,4197660,4202321,4661,4.7,"0"
"3034",52,4,9,4207229,4210561,3332,3.3,"0"
"3237",52,3,80,4216043,4220490,4447,4.4,"20"
"3340",52,7,36,4223201,4226465,3264,3.3,"20"
"3435",52,5,42,4228996,4232928,3932,3.9,"20"
"3536",52,7,76,4235673,4239275,3602,3.6,"20"
"3636",52,5,18,4241951,4246083,4132,4.1,"20"
"3838",52,4,49,4251414,4255570,4156,4.2,"0"
"3936",52,3,64,4258976,4264725,5749,5.7,"20"
"4036",52,8,5,4267530,4271475,3945,3.9,"0"
"4239",52,3,8,4276790,4280227,3437,3.4,"20"
"4438",52,2,47,4286953,4289062,2109,2.1,"0"
"4538",52,3,40,4292869,4294885,2016,2,"20"
"4636",52,8,29,4297532,4299770,2238,2.2,"0"
"4836",52,2,55,4305694,4310367,4673,4.7,"0"
"4930",52,5,26,4313181,4316665,3484,3.5,"20"
"5138",52,8,21,4321869,4325313,3444,3.4,"0"
"5339",52,1,6,4331130,4334300,3170,3.2,"20"
"5539",52,1,14,4342068,4345234,3166,3.2,"20"
"5738",52,6,19,4351422,4352783,1361,1.4,"0"
"5939",52,8,77,4360561,4363678,3117,3.1,"0"
"6036",52,2,71,4366299,4368759,2460,2.5,"0"
"6138",52,4,65,4371520,4374120,2600,2.6,"0"
"6234",52,3,16,4376577,4378453,1876,1.9,"20"
"6434",52,1,62,4383550,4386620,3070,3.1,"20"
"6534",52,6,67,4392407,4394710,2303,2.3,"0"
"6639",52,6,75,4399301,4402593,3292,3.3,"0"
"6738",52,6,59,4405254,4408110,2856,2.9,"0"
"6838",52,5,2,4412340,4415032,2692,2.7,"20"
"7039",52,8,61,4420551,4424432,3881,3.9,"0"
"7135",52,7,44,4426929,4434907,7978,8,"20"
"7242",52,2,7,4438273,4440034,1761,1.8,"0"
"7438",52,6,43,4446351,4449061,2710,2.7,"0"
"7530",52,3,56,4453574,4454992,1418,1.4,"20"
"7639",52,5,34,4458046,4460438,2392,2.4,"20"
"7736",52,5,74,4464180,4466020,1840,1.8,"20"
"7837",52,5,66,4468530,4470417,1887,1.9,"20"
"7938",52,7,60,4474036,4476212,2176,2.2,"20"
"8034",52,3,72,4479264,4481593,2329,2.3,"20"
"8136",52,4,33,4484573,4485941,1368,1.4,"0"
"8240",52,7,68,4488850,4491223,2373,2.4,"20"
"8335",52,7,52,4494658,4496509,1851,1.9,"20"
"8436",52,2,31,4498912,4500832,1920,1.9,"0"
"8635",52,1,46,4508526,4511181,2655,2.7,"20"
"8737",52,1,70,4514190,4516471,2281,2.3,"20"
"8835",52,3,48,4519200,4521990,2790,2.8,"20"
"8938",52,7,4,4524936,4527761,2825,2.8,"20"
"9134",52,3,24,4532648,4534822,2174,2.2,"20"
"9335",52,5,58,4540659,4543116,2457,2.5,"20"
"9431",52,7,28,4546412,4549392,2980,3,"20"
"9641",52,1,22,4554430,4556895,2465,2.5,"20"
"9839",52,8,53,4562229,4565209,2980,3,"0"
"9941",52,8,45,4569050,4570869,1819,1.8,"0"
"10033",52,6,27,4574193,4577610,3417,3.4,"0"
"10240",52,4,25,4582376,4585422,3046,3,"0"
"10434",52,2,39,4591642,4593855,2213,2.2,"0"
"10534",52,2,63,4596332,4601007,4675,4.7,"0"
"10634",52,8,37,4603626,4605892,2266,2.3,"0"
"10739",52,4,17,4610361,4613673,3312,3.3,"0"
"10942",52,6,3,4620265,4622423,2158,2.2,"0"
"11148",52,3,32,4627615,4630167,2552,2.6,"20"
"11334",52,6,35,4634936,4637577,2641,2.6,"0"
"11435",52,1,30,4640239,4642241,2002,2,"20"
"11637",52,7,20,4649256,4651437,2181,2.2,"20"
"11833",52,4,57,4657170,4659202,2032,2,"0"
"11939",52,6,11,4664840,4666349,1509,1.5,"0"
"12128",52,8,69,4675643,4677754,2111,2.1,"0"
"10164",53,1,37,6681020,6685420,4400,4.4,"20"
"11149",53,5,65,6687788,6691341,3553,3.6,"20"
"1243",53,1,77,6694620,6697923,3303,3.3,"20"
"1341",53,3,79,6700825,6704038,3213,3.2,"20"
"1433",53,1,53,6706919,6710656,3737,3.7,"20"
"1534",53,1,61,6713675,6717934,4259,4.3,"20"
"1633",53,3,15,6720989,6724060,3071,3.1,"20"
"1840",53,3,39,6728543,6731326,2783,2.8,"20"
"1937",53,3,71,6733803,6736399,2596,2.6,"20"
"2036",53,3,63,6738971,6742780,3809,3.8,"20"
"2135",53,4,40,6745595,6749265,3670,3.7,"0"
"2239",53,4,80,6752491,6755406,2915,2.9,"0"
"2336",53,1,5,6758549,6768249,9700,9.7,"20"
"2534",53,5,41,6773377,6777103,3726,3.7,"20"
"2640",53,4,48,6779589,6782800,3211,3.2,"0"
"2737",53,1,45,6785551,6790690,5139,5.1,"20"
"2835",53,8,44,6793365,6796029,2664,2.7,"0"
"2940",53,2,78,6799931,6803029,3098,3.1,"0"
"3035",53,6,26,6805830,6809535,3705,3.7,"0"
"3238",53,7,67,6865953,6869035,3082,3.1,"20"
"3341",53,7,75,6871473,6875023,3550,3.5,"20"
"3436",53,2,62,6877592,6880530,2938,2.9,"0"
"3537",53,2,38,6883684,6886575,2891,2.9,"0"
"3637",53,8,4,6889162,6891837,2675,2.7,"0"
"3839",53,8,12,6897832,6901079,3247,3.2,"0"
"4037",53,8,76,6907279,6910836,3557,3.6,"0"
"4136",53,8,36,6914014,6916487,2473,2.5,"0"
"4240",53,1,13,6920096,6923076,2980,3,"20"
"4439",53,6,42,6929541,6932519,2978,3,"0"
"4539",53,7,51,6938069,6940776,2707,2.7,"20"
"4637",53,2,22,6997442,7001081,3639,3.6,"0"
"4837",53,4,72,7005613,7008559,2946,2.9,"0"
"4931",53,5,17,7011155,7014027,2872,2.9,"20"
"5139",53,5,25,7018441,7021395,2954,3,"20"
"5340",53,1,69,7026481,7028951,2470,2.5,"20"
"5437",53,6,2,7031522,7034238,2716,2.7,"0"
"5633",53,6,66,7039067,7041640,2573,2.6,"0"
"5739",53,6,34,7044888,7048044,3156,3.2,"0"
"5838",53,4,32,7051004,7053815,2811,2.8,"0"
"6037",53,4,24,7059096,7061679,2583,2.6,"0"
"6235",53,5,49,7065843,7068294,2451,2.5,"20"
"6336",53,2,70,7071915,7075588,3673,3.7,"0"
"6435",53,5,9,7078404,7081353,2949,2.9,"20"
"6640",53,8,28,7086090,7088578,2488,2.5,"0"
"6839",53,7,3,7094073,7096557,2484,2.5,"20"
"7040",53,5,1,7100713,7103487,2774,2.8,"20"
"7243",53,6,58,7112114,7114491,2377,2.4,"0"
"7335",53,5,57,7116964,7119609,2645,2.6,"20"
"7439",53,7,35,7123031,7125876,2845,2.8,"20"
"7531",53,4,64,7128500,7130833,2333,2.3,"0"
"7640",53,6,18,7133476,7135772,2296,2.3,"0"
"7838",53,2,30,7140079,7143509,3430,3.4,"0"
"8035",53,2,14,7148801,7151349,2548,2.5,"0"
"8241",53,3,47,7155837,7158577,2740,2.7,"20"
"8336",53,2,54,7161186,7163782,2596,2.6,"0"
"8437",53,8,20,7166714,7168782,2068,2.1,"0"
"8636",53,3,31,7174861,7180247,5386,5.4,"20"
"8836",53,7,11,7186457,7189051,2594,2.6,"20"
"9038",53,4,56,7196577,7198664,2087,2.1,"0"
"9135",53,7,59,7201565,7204552,2987,3,"20"
"9238",53,1,21,7207175,7210000,2825,2.8,"20"
"9432",53,6,10,7214898,7217449,2551,2.6,"0"
"9642",53,4,16,7222668,7224802,2134,2.1,"0"
"9840",53,8,68,7230422,7232876,2454,2.5,"0"
"9942",53,7,19,7240640,7243736,3096,3.1,"20"
"10165",53,3,7,7248929,7252284,3355,3.4,"20"
"10338",53,3,55,7257170,7260246,3076,3.1,"20"
"10435",53,8,52,7262890,7265631,2741,2.7,"0"
"10535",53,8,60,7268405,7271066,2661,2.7,"0"
"10635",53,3,23,7273629,7275876,2247,2.2,"20"
"10834",53,1,29,7280908,7283762,2854,2.9,"20"
"11032",53,7,43,7289727,7292597,2870,2.9,"20"
"11150",53,5,33,7295107,7297711,2604,2.6,"20"
"11242",53,5,73,7300997,7304670,3673,3.7,"20"
"11335",53,2,6,7308202,7310796,2594,2.6,"0"
"11538",53,4,8,7316503,7318862,2359,2.4,"0"
"11740",53,6,74,7323278,7326112,2834,2.8,"0"
"11834",53,7,27,7328716,7331529,2813,2.8,"20"
"12040",53,6,50,7339496,7341786,2290,2.3,"0"
"12129",53,2,46,7344321,7347003,2682,2.7,"0"
"10166",54,2,5,9240322,9244588,4266,4.3,"0"
"1244",54,4,31,9251107,9255948,4841,4.8,"0"
"1434",54,4,15,9263718,9268143,4425,4.4,"0"
"1634",54,8,11,9274329,9276761,2432,2.4,"0"
"1841",54,2,61,9282663,9288879,6216,6.2,"0"
"1938",54,4,79,9292456,9296964,4508,4.5,"0"
"2037",54,1,76,9300329,9307868,7539,7.5,"20"
"2136",54,1,44,9310821,9314552,3731,3.7,"20"
"2240",54,8,19,9317300,9321302,4002,4,"0"
"2431",54,4,7,9329333,9333119,3786,3.8,"0"
"2641",54,8,43,9340373,9344954,4581,4.6,"0"
"2738",54,4,23,9347813,9351228,3415,3.4,"0"
"2941",54,1,4,9356765,9360777,4012,4,"20"
"3137",54,5,24,9366712,9374728,8016,8,"20"
"3342",54,3,38,9380830,9386878,6048,6,"20"
"3437",54,2,53,9390118,9394968,4850,4.8,"0"
"3538",54,5,8,9398602,9403357,4755,4.8,"20"
"3737",54,7,2,9409099,9412560,3461,3.5,"20"
"3937",54,5,72,9419513,9425013,5500,5.5,"20"
"4038",54,8,51,9427976,9434873,6897,6.9,"0"
"4137",54,4,71,9438266,9443425,5159,5.2,"0"
"4241",54,5,80,9446731,9450695,3964,4,"20"
"4335",54,6,57,9453855,9457098,3243,3.2,"0"
"4440",54,1,52,9460053,9464119,4066,4.1,"20"
"4540",54,7,10,9467297,9471555,4258,4.3,"20"
"4739",54,7,26,9477981,9482992,5011,5,"20"
"4932",54,1,20,9488483,9492286,3803,3.8,"20"
"5140",54,6,25,9497586,9500863,3277,3.3,"0"
"5341",54,2,29,9507133,9512546,5413,5.4,"0"
"5540",54,2,77,9518154,9520878,2724,2.7,"0"
"5634",54,7,50,9524297,9527860,3563,3.6,"20"
"5740",54,5,40,9531281,9535375,4094,4.1,"20"
"5839",54,6,49,9538205,9541948,3743,3.7,"0"
"5940",54,2,37,9544417,9548735,4318,4.3,"0"
"6038",54,7,66,9551304,9555533,4229,4.2,"20"
"6139",54,3,22,9559008,9564847,5839,5.8,"20"
"6337",54,8,35,9571215,9575591,4376,4.4,"0"
"6436",54,3,70,9578106,9582506,4400,4.4,"20"
"6535",54,5,64,9585036,9591734,6698,6.7,"20"
"6641",54,7,74,9594804,9599311,4507,4.5,"20"
"6739",54,1,36,9601796,9606086,4290,4.3,"20"
"6840",54,6,65,9608736,9614805,6069,6.1,"0"
"6937",54,6,41,9617851,9624380,6529,6.5,"0"
"7041",54,2,13,9627239,9635050,7811,7.8,"0"
"7244",54,7,18,9639892,9645333,5441,5.4,"20"
"7440",54,6,33,9651324,9654799,3475,3.5,"0"
"7532",54,4,39,9657738,9660921,3183,3.2,"0"
"7641",54,3,14,9663364,9669827,6463,6.5,"20"
"7839",54,6,1,9678915,9682232,3317,3.3,"0"
"8036",54,4,47,9688988,9691649,2661,2.7,"0"
"8137",54,1,60,9694651,9698100,3449,3.4,"20"
"8242",54,2,45,9701151,9704152,3001,3,"0"
"8337",54,5,48,9706840,9710967,4127,4.1,"20"
"8438",54,8,27,9714511,9717816,3305,3.3,"0"
"8637",54,1,12,9724026,9728004,3978,4,"20"
"8837",54,4,63,9734382,9739844,5462,5.5,"0"
"8939",54,3,54,9742626,9747014,4388,4.4,"20"
"9039",54,3,62,9752977,9757522,4545,4.5,"20"
"9136",54,7,58,9760513,9763882,3369,3.4,"20"
"9239",54,3,6,9767521,9772743,5222,5.2,"20"
"9433",54,5,16,9779978,9783958,3980,4,"20"
"9643",54,8,59,9792865,9797207,4342,4.3,"0"
"9733",54,7,42,9800718,9803792,3074,3.1,"20"
"9841",54,3,30,9807898,9811119,3221,3.2,"20"
"10034",54,7,34,9816746,9820979,4233,4.2,"20"
"10167",54,4,55,9823820,9829740,5920,5.9,"0"
"10241",54,5,32,9832683,9836821,4138,4.1,"20"
"10436",54,8,67,9842003,9848235,6232,6.2,"0"
"10536",54,8,3,9850968,9854623,3655,3.7,"0"
"10740",54,5,56,9860731,9863127,2396,2.4,"20"
"10835",54,8,75,9866210,9870746,4536,4.5,"0"
"10943",54,2,69,9873480,9877590,4110,4.1,"0"
"11033",54,6,17,9880455,9884598,4143,4.1,"0"
"11243",54,1,28,9889908,9894035,4127,4.1,"20"
"11436",54,3,78,9900565,9904980,4415,4.4,"20"
"11539",54,2,21,9908232,9911726,3494,3.5,"0"
"11741",54,6,9,9916944,9922745,5801,5.8,"0"
"11940",54,3,46,9928289,9932000,3711,3.7,"20"
"12041",54,1,68,9935262,9939638,4376,4.4,"20"
"12130",54,6,73,9942852,9946691,3839,3.8,"0"
"10168",55,2,76,4447615,4451682,4067,4.1,"0"
"11151",55,2,52,4454028,4457300,3272,3.3,"0"
"1245",55,3,5,4462381,4467197,4816,4.8,"20"
"1435",55,8,18,4473558,4476678,3120,3.1,"0"
"1635",55,3,61,4485888,4493101,7213,7.2,"20"
"1736",55,7,41,4496609,4501783,5174,5.2,"20"
"1842",55,1,11,4505285,4508143,2858,2.9,"20"
"2038",55,1,51,4516050,4521913,5863,5.9,"20"
"2137",55,7,73,4523843,4526570,2727,2.7,"20"
"2241",55,6,56,4528770,4530794,2024,2,"0"
"2337",55,2,4,4534033,4536634,2601,2.6,"0"
"2535",55,3,13,4542872,4546623,3751,3.8,"20"
"2739",55,4,78,4552316,4555556,3240,3.2,"0"
"2836",55,3,53,4558320,4565180,6860,6.9,"20"
"2942",55,6,48,4567600,4570319,2719,2.7,"0"
"3036",55,3,21,4573752,4576372,2620,2.6,"20"
"3239",55,5,63,4583402,4585952,2550,2.5,"20"
"3343",55,5,15,4589184,4591795,2611,2.6,"20"
"3539",55,8,50,4599350,4602101,2751,2.8,"0"
"3638",55,2,60,4604233,4607236,3003,3,"0"
"3738",55,6,24,4610097,4613258,3161,3.2,"0"
"3938",55,5,39,4618629,4621915,3286,3.3,"20"
"4039",55,7,65,4627905,4631537,3632,3.6,"20"
"4138",55,1,59,4634978,4639350,4372,4.4,"20"
"4242",55,2,28,4642421,4646616,4195,4.2,"0"
"4441",55,1,43,4659127,4663387,4260,4.3,"20"
"4541",55,2,68,4665632,4672255,6623,6.6,"0"
"4638",55,3,77,4674657,4677901,3244,3.2,"20"
"4740",55,8,10,4680077,4683747,3670,3.7,"0"
"4933",55,3,29,4689882,4692731,2849,2.8,"20"
"5141",55,4,38,4700208,4704547,4339,4.3,"0"
"5231",55,1,75,4706664,4709330,2666,2.7,"20"
"5342",55,7,33,4711602,4715222,3620,3.6,"20"
"5438",55,7,17,4717375,4719811,2436,2.4,"20"
"5635",55,5,7,4727889,4730734,2845,2.8,"20"
"5840",55,8,26,4736156,4740080,3924,3.9,"0"
"6039",55,4,46,4749711,4749825,114,0.1,"0"
"6140",55,8,34,4755549,4759060,3511,3.5,"0"
"6236",55,1,35,4763951,4766497,2546,2.5,"20"
"6338",55,5,47,4771982,4778537,6555,6.6,"20"
"6437",55,3,45,4782212,4785424,3212,3.2,"20"
"6536",55,6,40,4790863,4794251,3388,3.4,"0"
"6642",55,5,23,4798840,4801921,3081,3.1,"20"
"6841",55,7,1,4808715,4813788,5073,5.1,"20"
"7042",55,5,71,4822008,4826575,4567,4.6,"20"
"7136",55,6,32,4833055,4838505,5450,5.5,"0"
"7336",55,8,66,4845538,4849293,3755,3.8,"0"
"7441",55,6,8,4853023,4857508,4485,4.5,"0"
"7642",55,8,42,4862605,4865441,2836,2.8,"0"
"7737",55,4,22,4870873,4874927,4054,4.1,"0"
"7939",55,7,25,4883004,4886737,3733,3.7,"20"
"8138",55,6,64,4892968,4897652,4684,4.7,"0"
"8243",55,1,27,4902688,4906683,3995,4,"20"
"8439",55,1,19,4913155,4917715,4560,4.6,"20"
"8638",55,5,31,4929234,4934117,4883,4.9,"20"
"8838",55,2,36,4939381,4943611,4230,4.2,"0"
"8940",55,6,80,4949767,4953851,4084,4.1,"0"
"9040",55,6,16,4957460,4961038,3578,3.6,"0"
"9240",55,4,54,4970350,4973790,3440,3.4,"0"
"9336",55,6,72,4977110,4981027,3917,3.9,"0"
"9434",55,4,62,4990488,4994598,4110,4.1,"0"
"9539",55,4,6,5066319,5071741,5422,5.4,"0"
"9734",55,8,2,5079425,5082094,2669,2.7,"0"
"9943",55,3,69,5088901,5092220,3319,3.3,"20"
"10035",55,7,49,5096174,5104226,8052,8.1,"20"
"10169",55,3,37,5109766,5112316,2550,2.5,"20"
"10242",55,5,55,5114855,5117196,2341,2.3,"20"
"10339",55,2,12,5121825,5125042,3217,3.2,"0"
"10537",55,2,44,5130471,5132660,2189,2.2,"0"
"10636",55,1,67,5138296,5139902,1606,1.6,"20"
"10741",55,5,79,5143420,5145864,2444,2.4,"20"
"10836",55,4,30,5149370,5151756,2386,2.4,"0"
"11034",55,2,20,5157524,5159813,2289,2.3,"0"
"11244",55,8,58,5168188,5171536,3348,3.3,"0"
"11336",55,1,3,5173402,5175680,2278,2.3,"20"
"11540",55,7,57,5181250,5185538,4288,4.3,"20"
"11638",55,4,14,5187858,5191353,3495,3.5,"0"
"11835",55,8,74,5195997,5199708,3711,3.7,"0"
"11941",55,7,9,5202096,5205699,3603,3.6,"20"
"12131",55,4,70,5210328,5215111,4783,4.8,"0"
"10170",56,2,59,6801636,6806804,5168,5.2,"0"
"11152",56,6,79,6809593,6820549,10956,11,"0"
"1246",56,4,61,6822501,6827600,5099,5.1,"0"
"1342",56,4,45,6829300,6833759,4459,4.5,"0"
"1436",56,6,55,6837022,6842008,4986,5,"0"
"1535",56,4,13,6846611,6860364,13753,13.8,"0"
"1737",56,5,14,6869449,6875423,5974,6,"20"
"1939",56,7,56,6883543,6888549,5006,5,"20"
"2039",56,6,63,6891283,6898150,6867,6.9,"0"
"2138",56,6,47,6901536,6904767,3231,3.2,"0"
"2242",56,2,35,6906522,6910742,4220,4.2,"0"
"2338",56,5,6,6912553,6917827,5274,5.3,"20"
"2536",56,3,52,6926686,6930717,4031,4,"20"
"2642",56,5,62,6932739,6941417,8678,8.7,"20"
"2740",56,4,37,6943556,6949435,5879,5.9,"0"
"2837",56,2,51,6954392,6958319,3927,3.9,"0"
"2943",56,8,65,6959953,6966707,6754,6.8,"0"
"3037",56,7,64,6968464,6975320,6856,6.9,"20"
"3138",56,6,7,6976994,6982183,5189,5.2,"0"
"3344",56,8,25,6990756,6995218,4462,4.5,"0"
"3540",56,3,68,6998964,7003511,4547,4.5,"20"
"3639",56,8,49,7004981,7008568,3587,3.6,"0"
"3739",56,1,42,7011453,7015947,4494,4.5,"20"
"3840",56,3,4,7020602,7024713,4111,4.1,"20"
"4040",56,7,72,7028759,7037694,8935,8.9,"20"
"4139",56,3,44,7039759,7044618,4859,4.9,"20"
"4243",56,5,70,7046119,7050868,4749,4.7,"20"
"4336",56,1,18,7054125,7058482,4357,4.4,"20"
"4542",56,2,3,7062956,7068684,5728,5.7,"0"
"4741",56,3,28,7073494,7080273,6779,6.8,"20"
"4934",56,4,29,7085394,7088591,3197,3.2,"0"
"5142",56,3,76,7092356,7098281,5925,5.9,"20"
"5232",56,1,10,7100973,7108701,7728,7.7,"20"
"5439",56,8,41,7114618,7118891,4273,4.3,"0"
"5541",56,2,75,7121863,7125578,3715,3.7,"0"
"5636",56,5,30,7127403,7131282,3879,3.9,"20"
"5841",56,7,24,7134696,7140739,6043,6,"20"
"6040",56,2,27,7144995,7147737,2742,2.7,"0"
"6237",56,6,23,7152782,7155712,2930,2.9,"0"
"6438",56,7,16,7159041,7164398,5357,5.4,"20"
"6643",56,8,1,7168593,7171392,2799,2.8,"0"
"6842",56,4,5,7175088,7179645,4557,4.6,"0"
"7043",56,8,73,7184996,7189713,4717,4.7,"0"
"7137",56,8,17,7192140,7198498,6358,6.4,"0"
"7337",56,7,8,7203143,7209562,6419,6.4,"20"
"7533",56,5,38,7213298,7221223,7925,7.9,"20"
"7643",56,1,50,7223693,7230099,6406,6.4,"20"
"7738",56,5,54,7232594,7237983,5389,5.4,"20"
"7840",56,4,21,7239645,7242326,2681,2.7,"0"
"8037",56,1,66,7246419,7250951,4532,4.5,"20"
"8139",56,1,26,7253541,7258565,5024,5,"20"
"8338",56,2,67,7263982,7267871,3889,3.9,"0"
"8440",56,2,11,7270204,7273660,3456,3.5,"0"
"8639",56,4,77,7277268,7284585,7317,7.3,"0"
"8738",56,8,57,7286146,7288912,2766,2.8,"0"
"8839",56,7,40,7290459,7295447,4988,5,"20"
"8941",56,7,32,7298500,7302383,3883,3.9,"20"
"9137",56,8,9,7307157,7312541,5384,5.4,"0"
"9337",56,6,31,7317616,7323674,6058,6.1,"0"
"9540",56,8,33,7327796,7330571,2775,2.8,"0"
"9644",56,3,60,7332062,7337602,5540,5.5,"20"
"9735",56,4,53,7339274,7344211,4937,4.9,"0"
"9842",56,3,36,7345664,7349230,3566,3.6,"20"
"9944",56,3,20,7351585,7358656,7071,7.1,"20"
"10171",56,5,22,7363010,7371514,8504,8.5,"20"
"10340",56,4,69,7376053,7381660,5607,5.6,"0"
"10437",56,2,19,7383086,7385499,2413,2.4,"0"
"10637",56,7,48,7392185,7397115,4930,4.9,"20"
"10742",56,6,39,7398540,7401511,2971,3,"0"
"10837",56,6,15,7403774,7406969,3195,3.2,"0"
"11035",56,1,58,7410420,7415517,5097,5.1,"20"
"11153",56,1,2,7416837,7420167,3330,3.3,"20"
"11337",56,6,71,7424566,7428666,4100,4.1,"0"
"11437",56,1,34,7430029,7433635,3606,3.6,"20"
"11541",56,7,80,7434994,7437975,2981,3,"20"
"11639",56,1,74,7440511,7444416,3905,3.9,"20"
"11742",56,2,43,7445777,7447960,2183,2.2,"0"
"11836",56,3,12,7450386,7454623,4237,4.2,"20"
"12042",56,5,46,7459339,7466444,7105,7.1,"20"
"12132",56,5,78,7467862,7471743,3881,3.9,"20"
"10172",57,8,40,8828199,8834155,5956,6,"0"
"11154",57,6,22,8836801,8841277,4476,4.5,"0"
"1343",57,3,59,8845680,8852475,6795,6.8,"20"
"1437",57,1,49,8854210,8860667,6457,6.5,"20"
"1536",57,5,69,8862453,8867071,4618,4.6,"20"
"1636",57,3,11,8869912,8874663,4751,4.8,"20"
"1843",57,2,2,8879408,8885920,6512,6.5,"0"
"2040",57,6,30,8890374,8893843,3469,3.5,"0"
"2243",57,6,62,8897146,8902683,5537,5.5,"0"
"2339",57,5,37,8904092,8909252,5160,5.2,"20"
"2432",57,7,55,8910976,8915570,4594,4.6,"20"
"2537",57,8,72,8917582,8924819,7237,7.2,"0"
"2643",57,3,43,8926243,8932456,6213,6.2,"20"
"2741",57,2,74,8933935,8939816,5881,5.9,"0"
"2838",57,8,48,8941367,8946097,4730,4.7,"0"
"2944",57,8,8,8947544,8952486,4942,4.9,"0"
"3139",57,6,14,8957772,8962123,4351,4.4,"0"
"3345",57,8,24,8966911,8973879,6968,7,"0"
"3541",57,4,4,8978953,8982677,3724,3.7,"0"
"3740",57,7,15,8986225,8991175,4950,5,"20"
"3939",57,7,7,8997929,9004820,6891,6.9,"20"
"4140",57,7,23,9011461,9014711,3250,3.2,"20"
"4337",57,2,34,9018260,9023849,5589,5.6,"0"
"4442",57,3,27,9026141,9029952,3811,3.8,"20"
"4639",57,1,1,9033390,9036917,3527,3.5,"20"
"4838",57,4,36,9042683,9047809,5126,5.1,"0"
"4935",57,5,77,9049284,9053197,3913,3.9,"20"
"5041",57,8,16,9055572,9059254,3682,3.7,"0"
"5233",57,7,39,9063893,9067547,3654,3.7,"20"
"5343",57,4,44,9068966,9073107,4141,4.1,"0"
"5440",57,5,13,9074513,9078217,3704,3.7,"20"
"5637",57,5,21,9082404,9085765,3361,3.4,"20"
"5842",57,3,3,9089325,9093231,3906,3.9,"20"
"6041",57,8,32,9097345,9101366,4021,4,"0"
"6238",57,4,68,9106106,9111126,5020,5,"0"
"6339",57,5,45,9112465,9115969,3504,3.5,"20"
"6439",57,1,9,9117346,9125504,8158,8.2,"20"
"6644",57,5,53,9129673,9137695,8022,8,"20"
"6740",57,4,60,9139149,9142252,3103,3.1,"0"
"6843",57,3,75,9144818,9149103,4285,4.3,"20"
"6938",57,1,73,9150749,9156553,5804,5.8,"20"
"7044",57,2,10,9157768,9165054,7286,7.3,"0"
"7245",57,3,51,9171795,9179756,7961,8,"20"
"7338",57,7,47,9186844,9193209,6365,6.4,"20"
"7442",57,1,17,9194624,9199504,4880,4.9,"20"
"7644",57,7,71,9203736,9210173,6437,6.4,"20"
"7739",57,7,31,9211668,9216520,4852,4.9,"20"
"7940",57,4,12,9220260,9224626,4366,4.4,"0"
"8140",57,6,46,9228308,9233674,5366,5.4,"0"
"8244",57,2,50,9235037,9239741,4704,4.7,"0"
"8339",57,1,41,9242180,9247179,4999,5,"20"
"8441",57,4,76,9248572,9254813,6241,6.2,"0"
"8536",57,2,26,9256387,9260854,4467,4.5,"0"
"8739",57,4,20,9264799,9268831,4032,4,"0"
"8942",57,5,5,9272098,9277288,5190,5.2,"20"
"9138",57,7,63,9281022,9288155,7133,7.1,"20"
"9241",57,7,79,9290265,9296616,6351,6.4,"20"
"9338",57,3,35,9297932,9302586,4654,4.7,"20"
"9435",57,2,66,9304687,9310130,5443,5.4,"0"
"9541",57,8,56,9311815,9316581,4766,4.8,"0"
"9645",57,6,70,9319648,9324268,4620,4.6,"0"
"9736",57,5,61,9326571,9333881,7310,7.3,"20"
"9843",57,6,54,9335281,9340699,5418,5.4,"0"
"9945",57,6,6,9342074,9350291,8217,8.2,"0"
"10173",57,1,25,9353795,9358625,4830,4.8,"20"
"10341",57,2,42,9362900,9367177,4277,4.3,"0"
"10438",57,8,80,9370364,9374520,4156,4.2,"0"
"10538",57,8,64,9375722,9379699,3977,4,"0"
"10638",57,5,29,9381185,9388595,7410,7.4,"20"
"10838",57,3,19,9392204,9396167,3963,4,"20"
"11036",57,1,33,9402772,9407362,4590,4.6,"20"
"11155",57,3,67,9410305,9415429,5124,5.1,"20"
"11245",57,6,78,9416857,9420559,3702,3.7,"0"
"11338",57,4,28,9422768,9426407,3639,3.6,"0"
"11542",57,1,65,9431909,9438314,6405,6.4,"20"
"11640",57,2,58,9439925,9446899,6974,7,"0"
"11743",57,4,52,9448224,9453759,5535,5.5,"0"
"11837",57,2,18,9455310,9460135,4825,4.8,"0"
"12043",57,6,38,9463630,9472632,9002,9,"0"
"12133",57,1,57,9473983,9478050,4067,4.1,"20"
"10174",58,7,62,13814394,13819046,4652,4.7,"20"
"11156",58,6,29,13821295,13824913,3618,3.6,"0"
"1344",58,4,3,13829396,13832264,2868,2.9,"0"
"1537",58,4,59,13836858,13840672,3814,3.8,"0"
"1637",58,2,49,13842341,13845861,3520,3.5,"0"
"1738",58,1,64,13847400,13850256,2856,2.9,"20"
"1844",58,5,76,13851830,13855588,3758,3.8,"20"
"1940",58,7,38,13858445,13862304,3859,3.9,"20"
"2041",58,1,56,13864075,13867270,3195,3.2,"20"
"2139",58,8,47,13869435,13872252,2817,2.8,"0"
"2244",58,5,20,13874177,13877642,3465,3.5,"20"
"2433",58,8,71,13882017,13885055,3038,3,"0"
"2538",58,3,74,13886563,13890475,3912,3.9,"20"
"2644",58,2,33,13892335,13894970,2635,2.6,"0"
"2742",58,3,10,13896539,13899960,3421,3.4,"20"
"2945",58,1,40,13904187,13907177,2990,3,"20"
"3038",58,6,21,13909130,13912577,3447,3.4,"0"
"3240",58,8,31,13916785,13920691,3906,3.9,"0"
"3438",58,4,67,13924763,13930200,5437,5.4,"0"
"3542",58,2,9,13931936,13935248,3312,3.3,"0"
"3741",58,1,8,13939208,13942398,3190,3.2,"20"
"3940",58,6,13,13945856,13949460,3604,3.6,"0"
"4141",58,6,77,13953985,13957314,3329,3.3,"0"
"4244",58,6,5,13960928,13964821,3893,3.9,"0"
"4443",58,4,35,13968642,13971696,3054,3.1,"0"
"4543",58,7,46,13973410,13976539,3129,3.1,"20"
"4640",58,5,68,13978161,13980949,2788,2.8,"20"
"4742",58,6,61,13982619,13987157,4538,4.5,"0"
"4839",58,4,19,13989408,13992090,2682,2.7,"0"
"5042",58,7,54,13996616,14001379,4763,4.8,"20"
"5143",58,2,41,14002860,14006441,3581,3.6,"0"
"5234",58,4,43,14008589,14011279,2690,2.7,"0"
"5344",58,1,48,14014368,14018498,4130,4.1,"20"
"5441",58,8,23,14019978,14023941,3963,4,"0"
"5638",58,7,6,14028034,14031746,3712,3.7,"20"
"5843",58,1,24,14035152,14038836,3684,3.7,"20"
"6042",58,4,75,14042266,14047529,5263,5.3,"0"
"6141",58,5,28,14049228,14053448,4220,4.2,"20"
"6340",58,6,53,14058019,14061453,3434,3.4,"0"
"6440",58,2,17,14062972,14068498,5526,5.5,"0"
"6645",58,6,37,14072051,14075493,3442,3.4,"0"
"6741",58,7,30,14076830,14079632,2802,2.8,"20"
"6939",58,3,2,14083688,14086846,3158,3.2,"20"
"7138",58,6,45,14092035,14094608,2573,2.6,"0"
"7246",58,5,44,14098677,14102054,3377,3.4,"20"
"7339",58,3,26,14103778,14108417,4639,4.6,"20"
"7534",58,3,18,14112924,14115514,2590,2.6,"20"
"7740",58,8,55,14119579,14122493,2914,2.9,"0"
"7841",58,6,69,14123773,14126955,3182,3.2,"0"
"7941",58,5,12,14128320,14131074,2754,2.8,"20"
"8141",58,8,7,14134705,14138027,3322,3.3,"0"
"8340",58,2,65,14142935,14146148,3213,3.2,"0"
"8442",58,1,72,14147827,14152587,4760,4.8,"20"
"8537",58,8,39,14153951,14157101,3150,3.1,"0"
"8640",58,7,22,14160946,14165125,4179,4.2,"20"
"8840",58,3,42,14168120,14171886,3766,3.8,"20"
"8943",58,3,58,14173806,14177373,3567,3.6,"20"
"9041",58,3,50,14179262,14182425,3163,3.2,"20"
"9139",58,7,78,14184492,14187277,2785,2.8,"20"
"9242",58,5,36,14188468,14192231,3763,3.8,"20"
"9339",58,2,1,14195473,14198402,2929,2.9,"0"
"9542",58,3,34,14203308,14207358,4050,4,"20"
"9646",58,7,14,14208682,14212530,3848,3.8,"20"
"9844",58,5,60,14216176,14220153,3977,4,"20"
"9946",58,1,32,14221764,14224935,3171,3.2,"20"
"10175",58,2,73,14229279,14235019,5740,5.7,"0"
"10243",58,8,79,14236387,14239485,3098,3.1,"0"
"10342",58,4,51,14241254,14244419,3165,3.2,"0"
"10439",58,2,57,14245716,14248611,2895,2.9,"0"
"10539",58,5,52,14249996,14253090,3094,3.1,"20"
"10639",58,3,66,14254805,14258686,3881,3.9,"20"
"10743",58,4,27,14260258,14263409,3151,3.2,"0"
"10944",58,8,63,14268560,14272270,3710,3.7,"0"
"11037",58,8,15,14274251,14277451,3200,3.2,"0"
"11246",58,7,70,14281043,14284564,3521,3.5,"20"
"11339",58,4,11,14286171,14289037,2866,2.9,"0"
"11543",58,5,4,14293005,14296517,3512,3.5,"20"
"11744",58,1,80,14299924,14302769,2845,2.8,"20"
"11838",58,2,25,14304495,14307273,2778,2.8,"0"
"12044",58,1,16,14310370,14313304,2934,2.9,"20"
"10176",59,4,26,16082231,16086243,4012,4,"0"
"1247",59,3,49,16093324,16098312,4988,5,"20"
"1345",59,2,48,16101056,16106409,5353,5.4,"0"
"1438",59,3,9,16109935,16116108,6173,6.2,"20"
"1638",59,5,35,16122411,16127037,4626,4.6,"20"
"1739",59,7,29,16130521,16137732,7211,7.2,"20"
"1941",59,7,69,16143281,16147759,4478,4.5,"20"
"2042",59,2,64,16151368,16154880,3512,3.5,"0"
"2140",59,6,52,16157914,16163735,5821,5.8,"0"
"2245",59,8,78,16166131,16170476,4345,4.3,"0"
"2340",59,3,57,16172691,16176958,4267,4.3,"20"
"2434",59,1,23,16178915,16183720,4805,4.8,"20"
"2645",59,6,28,16190592,16195107,4515,4.5,"0"
"2839",59,8,54,16200155,16204916,4761,4.8,"0"
"2946",59,7,45,16207484,16211362,3878,3.9,"20"
"3039",59,3,25,16213432,16218627,5195,5.2,"20"
"3241",59,3,73,16223735,16228876,5141,5.1,"20"
"3346",59,6,36,16230775,16235715,4940,4.9,"0"
"3439",59,7,37,16238034,16243738,5704,5.7,"20"
"3543",59,5,11,16245542,16249864,4322,4.3,"20"
"3742",59,8,14,16254584,16258837,4253,4.3,"0"
"3941",59,5,51,16263441,16268759,5318,5.3,"20"
"4041",59,5,67,16270565,16275893,5328,5.3,"20"
"4142",59,6,68,16277622,16281789,4167,4.2,"0"
"4245",59,2,16,16284112,16287792,3680,3.7,"0"
"4444",59,2,32,16292609,16296578,3969,4,"0"
"4641",59,6,44,16300292,16304113,3821,3.8,"0"
"4743",59,8,46,16305519,16309281,3762,3.8,"0"
"4840",59,7,5,16310744,16317312,6568,6.6,"20"
"5043",59,4,66,16322526,16326163,3637,3.6,"0"
"5144",59,6,20,16327659,16331798,4139,4.1,"0"
"5345",59,5,59,16335967,16341099,5132,5.1,"20"
"5442",59,8,30,16343333,16347375,4042,4,"0"
"5639",59,5,75,16351524,16357451,5927,5.9,"20"
"5741",59,7,61,16358862,16363516,4654,4.7,"20"
"5844",59,1,31,16365618,16368896,3278,3.3,"20"
"6043",59,3,33,16373904,16377263,3359,3.4,"20"
"6142",59,3,41,16379516,16384279,4763,4.8,"20"
"6239",59,3,1,16386820,16390258,3438,3.4,"20"
"6441",59,3,17,16395317,16399028,3711,3.7,"20"
"6646",59,2,56,16402722,16405256,2534,2.5,"0"
"6742",59,1,79,16407766,16413018,5252,5.3,"20"
"6844",59,8,62,16414783,16418181,3398,3.4,"0"
"6940",59,5,27,16419923,16423106,3183,3.2,"20"
"7139",59,1,39,16427461,16431061,3600,3.6,"20"
"7247",59,6,12,16432771,16436068,3297,3.3,"0"
"7443",59,2,24,16440625,16443907,3282,3.3,"0"
"7645",59,4,50,16451438,16454248,2810,2.8,"0"
"7741",59,2,80,16457192,16460790,3598,3.6,"0"
"7842",59,4,34,16462490,16466736,4246,4.2,"0"
"7942",59,8,38,16469000,16472986,3986,4,"0"
"8038",59,7,13,16474698,16478059,3361,3.4,"20"
"8245",59,8,22,16482958,16487029,4071,4.1,"0"
"8443",59,7,53,16492304,16496580,4276,4.3,"20"
"8538",59,1,47,16499859,16502932,3073,3.1,"20"
"8641",59,6,60,16504507,16506715,2208,2.2,"0"
"8740",59,1,71,16508015,16512009,3994,4,"20"
"8841",59,5,43,16513487,16515915,2428,2.4,"20"
"8944",59,1,7,16517278,16520344,3066,3.1,"20"
"9140",59,1,55,16526770,16530953,4183,4.2,"20"
"9243",59,5,19,16533675,16536709,3034,3,"20"
"9436",59,2,8,16540759,16545570,4811,4.8,"0"
"9647",59,4,74,16549706,16553855,4149,4.1,"0"
"9737",59,3,65,16556092,16559551,3459,3.5,"20"
"9845",59,4,10,16561217,16566038,4821,4.8,"0"
"10036",59,7,77,16571841,16575106,3265,3.3,"20"
"10177",59,8,6,16577625,16581446,3821,3.8,"0"
"10343",59,1,63,16587460,16592932,5472,5.5,"20"
"10440",59,2,72,16595457,16600120,4663,4.7,"0"
"10540",59,1,15,16602958,16605792,2834,2.8,"20"
"10744",59,5,3,16609026,16611942,2916,2.9,"20"
"10945",59,4,58,16619064,16622309,3245,3.2,"0"
"11038",59,6,4,16623565,16626702,3137,3.1,"0"
"11247",59,7,21,16630659,16633964,3305,3.3,"20"
"11438",59,4,18,16638296,16641449,3153,3.2,"0"
"11641",59,6,76,16645216,16648159,2943,2.9,"0"
"11745",59,8,70,16649392,16655304,5912,5.9,"0"
"11839",59,4,42,16657701,16660763,3062,3.1,"0"
"11942",59,2,40,16662357,16665198,2841,2.8,"0"
"12045",59,4,2,16666989,16669730,2741,2.7,"0"
"10178",60,8,13,18408039,18417720,9681,9.7,"0"
"1248",60,3,56,18423260,18427701,4441,4.4,"20"
"1346",60,6,35,18430298,18433953,3655,3.7,"0"
"1439",60,4,41,18435760,18445050,9290,9.3,"0"
"1538",60,1,38,18447099,18454069,6970,7,"20"
"1639",60,7,28,18458255,18463629,5374,5.4,"20"
"1845",60,8,5,18471314,18475501,4187,4.2,"0"
"2043",60,8,37,18483120,18487056,3936,3.9,"0"
"2141",60,5,34,18489554,18497742,8188,8.2,"20"
"2246",60,5,50,18499926,18503573,3647,3.6,"20"
"2341",60,8,53,18508201,18515622,7421,7.4,"0"
"2435",60,4,17,18518021,18521714,3693,3.7,"0"
"2646",60,5,2,18530652,18534782,4130,4.1,"20"
"2840",60,8,29,18552427,18561499,9072,9.1,"0"
"3040",60,7,44,18567548,18572047,4499,4.5,"20"
"3140",60,5,18,18574391,18579143,4752,4.8,"20"
"3347",60,4,49,18590835,18596559,5724,5.7,"0"
"3440",60,2,79,18599079,18603004,3925,3.9,"0"
"3544",60,4,57,18606521,18610605,4084,4.1,"0"
"3640",60,3,24,18616533,18622051,5518,5.5,"20"
"3841",60,7,52,18629732,18637638,7906,7.9,"20"
"3942",60,2,7,18640154,18648078,7924,7.9,"0"
"4143",60,1,46,18663395,18667752,4357,4.4,"20"
"4246",60,7,12,18671147,18674956,3809,3.8,"20"
"4445",60,4,73,18681340,18685357,4017,4,"0"
"4544",60,7,36,18688936,18693895,4959,5,"20"
"4642",60,8,61,18696682,18701104,4422,4.4,"0"
"4744",60,3,80,18703308,18706247,2939,2.9,"20"
"4841",60,3,40,18709590,18713414,3824,3.8,"20"
"4936",60,2,31,18715322,18720565,5243,5.2,"0"
"5145",60,2,55,18730122,18734779,4657,4.7,"0"
"5235",60,1,6,18737772,18745212,7440,7.4,"20"
"5443",60,3,32,18752924,18757960,5036,5,"20"
"5640",60,5,74,18762893,18766536,3643,3.6,"20"
"5742",60,8,77,18768225,18772561,4336,4.3,"0"
"5845",60,1,78,18773933,18778884,4951,5,"20"
"5941",60,1,30,18780570,18784591,4021,4,"20"
"6143",60,6,43,18788453,18792140,3687,3.7,"0"
"6240",60,5,26,18793537,18797520,3983,4,"20"
"6442",60,1,14,18802776,18808949,6173,6.2,"20"
"6647",60,1,22,18813361,18818939,5578,5.6,"20"
"6845",60,2,63,18822981,18828397,5416,5.4,"0"
"6941",60,6,59,18831333,18836535,5202,5.2,"0"
"7045",60,5,10,18837860,18846412,8552,8.6,"20"
"7248",60,6,67,18853552,18858807,5255,5.3,"0"
"7340",60,6,11,18860929,18864475,3546,3.5,"0"
"7535",60,7,76,18872103,18878800,6697,6.7,"20"
"7646",60,1,62,18880284,18885394,5110,5.1,"20"
"7742",60,3,8,18887101,18891147,4046,4,"20"
"7943",60,6,75,18896789,18900236,3447,3.4,"0"
"8039",60,2,47,18901560,18905457,3897,3.9,"0"
"8142",60,4,25,18907952,18912906,4954,5,"0"
"8341",60,5,66,18917448,18922622,5174,5.2,"20"
"8444",60,2,71,18924560,18928802,4242,4.2,"0"
"8539",60,2,23,18930551,18936467,5916,5.9,"0"
"8741",60,3,48,18940517,18946278,5761,5.8,"20"
"8842",60,7,60,18947587,18951070,3483,3.5,"20"
"8945",60,4,33,18952488,18955405,2917,2.9,"0"
"9042",60,8,21,18957033,18962392,5359,5.4,"0"
"9244",60,7,4,18967072,18971486,4414,4.4,"20"
"9437",60,5,42,18977925,18983381,5456,5.5,"20"
"9543",60,2,15,18984633,18989782,5149,5.1,"0"
"9738",60,3,72,18993730,19000560,6830,6.8,"20"
"9846",60,4,1,19004797,19009771,4974,5,"0"
"10037",60,1,54,19015404,19021806,6402,6.4,"20"
"10179",60,4,65,19024777,19029487,4710,4.7,"0"
"10244",60,3,64,19032336,19035785,3449,3.4,"20"
"10344",60,7,68,19037216,19041964,4748,4.7,"20"
"10441",60,6,3,19043629,19047852,4223,4.2,"0"
"10640",60,6,51,19052734,19056999,4265,4.3,"0"
"10745",60,5,58,19059548,19063765,4217,4.2,"20"
"10839",60,8,69,19066481,19071650,5169,5.2,"0"
"10946",60,1,70,19074235,19078760,4525,4.5,"20"
"11039",60,7,20,19080204,19084078,3874,3.9,"20"
"11248",60,6,27,19088753,19093979,5226,5.2,"0"
"11439",60,2,39,19098221,19104396,6175,6.2,"0"
"11544",60,8,45,19107304,19110662,3358,3.4,"0"
"11642",60,3,16,19112481,19118649,6168,6.2,"20"
"11840",60,6,19,19124211,19128276,4065,4.1,"0"
"12046",60,4,9,19140292,19147983,7691,7.7,"0"
"10180",61,7,59,20768664,20776842,8178,8.2,"20"
"11157",61,7,27,20779209,20787156,7947,7.9,"20"
"1347",61,6,18,20791834,20795660,3826,3.8,"0"
"1539",61,3,71,20801478,20805100,3622,3.6,"20"
"1640",61,8,20,20808621,20813190,4569,4.6,"0"
"1846",61,2,38,20817855,20823426,5571,5.6,"0"
"1942",61,2,46,20826168,20830036,3868,3.9,"0"
"2044",61,4,8,20833471,20837744,4273,4.3,"0"
"2247",61,3,47,20842904,20846230,3326,3.3,"20"
"2342",61,2,54,20849517,20854848,5331,5.3,"0"
"2436",61,8,68,20856580,20860700,4120,4.1,"0"
"2539",61,2,6,20863130,20867089,3959,4,"0"
"2743",61,2,22,20873062,20878322,5260,5.3,"0"
"2947",61,6,10,20884289,20890611,6322,6.3,"0"
"3141",61,4,64,20895234,20898315,3081,3.1,"0"
"3242",61,1,21,20902329,20907506,5177,5.2,"20"
"3441",61,2,62,20911990,20915489,3499,3.5,"0"
"3545",61,1,61,20916945,20923242,6297,6.3,"20"
"3641",61,2,30,20925805,20930642,4837,4.8,"0"
"3842",61,1,69,20935515,20940120,4605,4.6,"20"
"3943",61,3,79,20942629,20946685,4056,4.1,"20"
"4042",61,1,45,20949265,20953348,4083,4.1,"20"
"4144",61,3,31,20955288,20960491,5203,5.2,"20"
"4338",61,5,73,20966730,20974304,7574,7.6,"20"
"4446",61,1,53,20976228,20984508,8280,8.3,"20"
"4545",61,7,19,20987535,20990290,2755,2.8,"20"
"4745",61,5,49,20997323,21004669,7346,7.3,"20"
"4842",61,8,52,21009875,21014234,4359,4.4,"0"
"4937",61,1,13,21015999,21021455,5456,5.5,"20"
"5146",61,1,5,21025444,21030248,4804,4.8,"20"
"5346",61,2,70,21036639,21042276,5637,5.6,"0"
"5444",61,1,37,21047952,21051881,3929,3.9,"20"
"5542",61,5,33,21053865,21056479,2614,2.6,"20"
"5641",61,2,78,21062264,21066215,3951,4,"0"
"5743",61,6,2,21068951,21072280,3329,3.3,"0"
"5942",61,4,48,21076427,21080950,4523,4.5,"0"
"6044",61,4,40,21083035,21088608,5573,5.6,"0"
"6144",61,6,34,21090459,21094608,4149,4.1,"0"
"6241",61,8,36,21097193,21100640,3447,3.4,"0"
"6341",61,3,7,21102608,21107352,4744,4.7,"20"
"6537",61,7,11,21116003,21118556,2553,2.6,"20"
"6743",61,8,28,21122545,21126579,4034,4,"0"
"6942",61,7,75,21131828,21136369,4541,4.5,"20"
"7046",61,6,42,21139969,21144341,4372,4.4,"0"
"7140",61,5,57,21148439,21151867,3428,3.4,"20"
"7249",61,1,29,21156573,21160107,3534,3.5,"20"
"7444",61,6,26,21168645,21172597,3952,4,"0"
"7647",61,7,35,21178253,21182551,4298,4.3,"20"
"7743",61,5,1,21187623,21193181,5558,5.6,"20"
"7944",61,4,16,21198135,21200746,2611,2.6,"0"
"8143",61,8,44,21206021,21209002,2981,3,"0"
"8246",61,7,51,21212447,21216482,4035,4,"20"
"8342",61,6,74,21218289,21223061,4772,4.8,"0"
"8445",61,4,32,21228352,21232876,4524,4.5,"0"
"8642",61,4,24,21236946,21241588,4642,4.6,"0"
"8843",61,2,14,21250319,21254865,4546,4.5,"0"
"9043",61,7,43,21262542,21265229,2687,2.7,"20"
"9141",61,8,12,21269421,21273027,3606,3.6,"0"
"9340",61,5,9,21279940,21286026,6086,6.1,"20"
"9544",61,6,58,21293010,21296988,3978,4,"0"
"9648",61,5,17,21301660,21305072,3412,3.4,"20"
"9847",61,3,15,21312303,21315718,3415,3.4,"20"
"10038",61,3,23,21322106,21326296,4190,4.2,"20"
"10245",61,7,67,21332913,21338552,5639,5.6,"20"
"10345",61,5,65,21342845,21347903,5058,5.1,"20"
"10442",61,4,72,21350267,21353875,3608,3.6,"0"
"10541",61,4,80,21358020,21360988,2968,3,"0"
"10641",61,3,55,21362396,21367446,5050,5,"20"
"10746",61,6,50,21371447,21374080,2633,2.6,"0"
"10840",61,8,4,21376344,21381416,5072,5.1,"0"
"11040",61,8,76,21390542,21393828,3286,3.3,"0"
"11158",61,6,66,21396488,21400405,3917,3.9,"0"
"11249",61,1,77,21406305,21411584,5279,5.3,"20"
"11340",61,8,60,21415554,21420304,4750,4.8,"0"
"11440",61,5,41,21423231,21428227,4996,5,"20"
"11545",61,4,56,21431806,21435712,3906,3.9,"0"
"11643",61,5,25,21439438,21443907,4469,4.5,"20"
"11841",61,3,39,21449288,21453307,4019,4,"20"
"11943",61,7,3,21456203,21460905,4702,4.7,"20"
"12134",61,3,63,21465024,21468667,3643,3.6,"20"
"10181",62,6,57,25761101,25765638,4537,4.5,"0"
"11159",62,1,76,25768687,25774356,5669,5.7,"20"
"1249",62,7,34,25776182,25782036,5854,5.9,"20"
"1348",62,3,62,25783414,25789669,6255,6.3,"20"
"1440",62,6,17,25791668,25795787,4119,4.1,"0"
"1641",62,7,2,25800877,25804757,3880,3.9,"20"
"1847",62,6,33,25810329,25813406,3077,3.1,"0"
"1943",62,3,54,25815107,25821053,5946,5.9,"20"
"2045",62,8,11,25822814,25826853,4039,4,"0"
"2248",62,2,5,25832924,25836552,3628,3.6,"0"
"2437",62,4,15,25842990,25846082,3092,3.1,"0"
"2647",62,4,31,25849782,25853908,4126,4.1,"0"
"2841",62,1,52,25861181,25868234,7053,7.1,"20"
"2948",62,4,79,25871238,25875196,3958,4,"0"
"3041",62,2,29,25877729,25881645,3916,3.9,"0"
"3243",62,2,13,25886068,25889603,3535,3.5,"0"
"3442",62,7,26,25894838,25899373,4535,4.5,"20"
"3642",62,3,22,25903262,25909904,6642,6.6,"20"
"3843",62,7,66,25915243,25920559,5316,5.3,"20"
"3944",62,5,8,25921965,25926903,4938,4.9,"20"
"4145",62,6,25,25931639,25937147,5508,5.5,"0"
"4339",62,8,59,25941084,25944514,3430,3.4,"0"
"4447",62,5,32,25947724,25952459,4735,4.7,"20"
"4643",62,8,75,25956669,25959426,2757,2.8,"0"
"4746",62,3,46,25960962,25964782,3820,3.8,"20"
"4843",62,3,6,25966400,25972809,6409,6.4,"20"
"5044",62,5,64,25976823,25980517,3694,3.7,"20"
"5147",62,5,40,25982184,25986443,4259,4.3,"20"
"5236",62,8,67,25989353,25992900,3547,3.5,"0"
"5347",62,6,49,25994627,25998023,3396,3.4,"0"
"5445",62,1,20,25999913,26004510,4597,4.6,"20"
"5642",62,4,23,26009973,26013952,3979,4,"0"
"5846",62,5,16,26020534,26024643,4109,4.1,"20"
"6045",62,4,63,26028861,26031856,2995,3,"0"
"6145",62,1,12,26034438,26039244,4806,4.8,"20"
"6342",62,7,42,26044366,26048197,3831,3.8,"20"
"6443",62,6,73,26049549,26052590,3041,3,"0"
"6538",62,7,10,26054101,26058209,4108,4.1,"20"
"6744",62,1,60,26065925,26069543,3618,3.6,"20"
"6846",62,4,39,26071033,26073916,2883,2.9,"0"
"6943",62,2,37,26075362,26077623,2261,2.3,"0"
"7047",62,5,80,26079019,26083066,4047,4,"20"
"7141",62,6,41,26084446,26087516,3070,3.1,"0"
"7250",62,1,4,26088974,26093155,4181,4.2,"20"
"7445",62,4,7,26097315,26100978,3663,3.7,"0"
"7648",62,7,58,26105770,26113549,7779,7.8,"20"
"7744",62,4,47,26114928,26117352,2424,2.4,"0"
"7843",62,1,28,26118764,26122176,3412,3.4,"20"
"8040",62,6,9,26126416,26129541,3125,3.1,"0"
"8247",62,4,55,26134273,26137732,3459,3.5,"0"
"8343",62,2,61,26139072,26143203,4131,4.1,"0"
"8446",62,2,69,26144633,26147763,3130,3.1,"0"
"8540",62,3,30,26149074,26151943,2869,2.9,"20"
"8742",62,6,1,26155435,26157796,2361,2.4,"0"
"8946",62,1,44,26163831,26166835,3004,3,"20"
"9044",62,4,71,26168511,26170941,2430,2.4,"0"
"9142",62,5,24,26173816,26178494,4678,4.7,"20"
"9341",62,5,48,26183827,26189865,6038,6,"20"
"9438",62,2,53,26191569,26195808,4239,4.2,"0"
"9545",62,7,50,26197203,26202393,5190,5.2,"20"
"9649",62,3,70,26203825,26207925,4100,4.1,"20"
"9739",62,8,35,26209810,26212740,2930,2.9,"0"
"9848",62,1,36,26214672,26218465,3793,3.8,"20"
"9947",62,8,19,26220093,26222824,2731,2.7,"0"
"10182",62,2,45,26227634,26229738,2104,2.1,"0"
"10246",62,3,38,26231173,26235258,4085,4.1,"20"
"10346",62,3,78,26236694,26240085,3391,3.4,"20"
"10443",62,6,65,26241375,26244401,3026,3,"0"
"10542",62,7,74,26245813,26249453,3640,3.6,"20"
"10642",62,8,43,26250790,26253727,2937,2.9,"0"
"10747",62,8,51,26257009,26260796,3787,3.8,"0"
"10841",62,2,77,26262275,26265140,2865,2.9,"0"
"10947",62,8,27,26266544,26269950,3406,3.4,"0"
"11160",62,5,56,26274489,26277449,2960,3,"20"
"11250",62,3,14,26278878,26282380,3502,3.5,"20"
"11441",62,5,72,26287344,26290702,3358,3.4,"20"
"11546",62,1,68,26292287,26295567,3280,3.3,"20"
"11644",62,8,3,26297073,26299865,2792,2.8,"0"
"11842",62,2,21,26304770,26307775,3005,3,"0"
"12047",62,7,18,26311653,26315156,3503,3.5,"20"
"10183",63,3,45,5641123,5643658,2535,2.5,"20"
"11161",63,1,3,5649607,5652899,3292,3.3,"20"
"1349",63,1,27,5658437,5661794,3357,3.4,"20"
"1540",63,8,26,5666689,5669637,2948,2.9,"0"
"1740",63,7,41,5676938,5680201,3263,3.3,"20"
"1848",63,6,32,5681736,5685635,3899,3.9,"0"
"2046",63,5,79,5691080,5694905,3825,3.8,"20"
"2142",63,5,23,5697600,5700041,2441,2.4,"20"
"2343",63,7,49,5705332,5708061,2729,2.7,"20"
"2438",63,4,14,5717943,5721407,3464,3.5,"0"
"2648",63,7,1,5727007,5730261,3254,3.3,"20"
"2842",63,5,31,5738620,5743189,4569,4.6,"20"
"3042",63,6,24,5752864,5757178,4314,4.3,"0"
"3244",63,4,54,5769288,5773056,3768,3.8,"0"
"3348",63,6,16,5775286,5777995,2709,2.7,"0"
"3546",63,2,36,5782413,5785512,3099,3.1,"0"
"3643",63,5,71,5787286,5790769,3483,3.5,"20"
"3743",63,7,73,5792721,5796925,4204,4.2,"20"
"3844",63,5,7,5799287,5802469,3182,3.2,"20"
"4043",63,1,51,5808170,5811270,3100,3.1,"20"
"4146",63,1,75,5812979,5816281,3302,3.3,"20"
"4247",63,1,59,5818564,5822960,4396,4.4,"20"
"4340",63,8,74,5827518,5831488,3970,4,"0"
"4448",63,4,62,5833846,5837167,3321,3.3,"0"
"4546",63,1,67,5839074,5843542,4468,4.5,"20"
"4644",63,8,2,5845245,5848057,2812,2.8,"0"
"4844",63,6,8,5853495,5856429,2934,2.9,"0"
"5045",63,2,68,5864847,5868882,4035,4,"0"
"5148",63,6,48,5870495,5873700,3205,3.2,"0"
"5237",63,8,66,5876113,5880240,4127,4.1,"0"
"5348",63,4,22,5882183,5885809,3626,3.6,"0"
"5543",63,1,19,5909258,5911926,2668,2.7,"20"
"5744",63,8,34,5919255,5924052,4797,4.8,"0"
"5847",63,7,33,5926664,5929318,2654,2.7,"20"
"5943",63,3,13,5935607,5939648,4041,4,"20"
"6146",63,6,72,5948915,5953224,4309,4.3,"0"
"6242",63,3,21,5957187,5960825,3638,3.6,"20"
"6444",63,7,25,5968707,5972659,3952,4,"20"
"6648",63,3,61,5977603,5981589,3986,4,"20"
"6745",63,3,5,5983149,5987185,4036,4,"20"
"6944",63,2,20,5993656,5995467,1811,1.8,"0"
"7142",63,2,4,6004735,6009431,4696,4.7,"0"
"7341",63,2,12,6017331,6021232,3901,3.9,"0"
"7536",63,8,10,6026868,6031185,4317,4.3,"0"
"7745",63,4,38,6037923,6041447,3524,3.5,"0"
"7844",63,4,46,6043065,6047208,4143,4.1,"0"
"7945",63,5,15,6048823,6051396,2573,2.6,"20"
"8144",63,3,69,6055371,6058735,3364,3.4,"20"
"8248",63,3,29,6061601,6065143,3542,3.5,"20"
"8447",63,4,78,6069423,6072630,3207,3.2,"0"
"8541",63,8,50,6074572,6077018,2446,2.4,"0"
"8643",63,3,37,6079451,6082595,3144,3.1,"20"
"8743",63,6,40,6085232,6088016,2784,2.8,"0"
"8844",63,2,44,6091292,6093744,2452,2.5,"0"
"8947",63,6,80,6097072,6100100,3028,3,"0"
"9045",63,8,18,6103835,6107041,3206,3.2,"0"
"9245",63,6,64,6112171,6114835,2664,2.7,"0"
"9342",63,4,30,6116537,6118823,2286,2.3,"0"
"9546",63,2,28,6125915,6129739,3824,3.8,"0"
"9740",63,7,65,6134961,6139622,4661,4.7,"20"
"9849",63,1,11,6144428,6147678,3250,3.2,"20"
"10039",63,2,60,6155611,6158971,3360,3.4,"0"
"10184",63,5,63,6167646,6170833,3187,3.2,"20"
"10247",63,5,55,6174098,6177116,3018,3,"20"
"10347",63,8,58,6184506,6188753,4247,4.2,"0"
"10444",63,8,42,6191853,6194595,2742,2.7,"0"
"10543",63,1,35,6196346,6199390,3044,3,"20"
"10643",63,2,76,6202386,6205971,3585,3.6,"0"
"10748",63,1,43,6208081,6211049,2968,3,"20"
"10842",63,3,77,6216167,6218773,2606,2.6,"20"
"10948",63,6,56,6220356,6222846,2490,2.5,"0"
"11041",63,4,6,6226234,6230414,4180,4.2,"0"
"11251",63,7,9,6235239,6238975,3736,3.7,"20"
"11442",63,5,47,6243617,6246340,2723,2.7,"20"
"11547",63,7,17,6247825,6250961,3136,3.1,"20"
"11746",63,5,39,6255704,6258799,3095,3.1,"20"
"11843",63,4,70,6264434,6267893,3459,3.5,"0"
"11944",63,3,53,6269949,6273485,3536,3.5,"20"
"12048",63,7,57,6275994,6279280,3286,3.3,"20"
"12135",63,2,52,6285313,6288026,2713,2.7,"0"
"10185",64,4,37,10203733,10207723,3990,4,"0"
"11162",64,8,65,10211670,10216706,5036,5,"0"
"1250",64,8,17,10221722,10226602,4880,4.9,"0"
"1441",64,7,48,10236615,10243231,6616,6.6,"20"
"1541",64,8,1,10245031,10253062,8031,8,"0"
"1741",64,2,59,10261526,10267324,5798,5.8,"0"
"1849",64,6,39,10272268,10276927,4659,4.7,"0"
"1944",64,3,44,10280203,10283956,3753,3.8,"20"
"2047",64,7,32,10290944,10294548,3604,3.6,"20"
"2249",64,2,75,10303566,10306501,2935,2.9,"0"
"2344",64,6,7,10307906,10311689,3783,3.8,"0"
"2540",64,2,3,10322304,10326254,3950,4,"0"
"2744",64,6,55,10343604,10347361,3757,3.8,"0"
"2843",64,2,43,10348799,10351771,2972,3,"0"
"2949",64,3,36,10354572,10357765,3193,3.2,"20"
"3043",64,1,26,10359410,10362432,3022,3,"20"
"3245",64,1,10,10367123,10371329,4206,4.2,"20"
"3443",64,7,8,10381367,10385082,3715,3.7,"20"
"3644",64,3,4,10390478,10394190,3712,3.7,"20"
"3845",64,3,12,10398325,10402415,4090,4.1,"20"
"4044",64,2,51,10406446,10409959,3513,3.5,"0"
"4147",64,5,14,10411941,10416787,4846,4.8,"20"
"4341",64,8,25,10421477,10425736,4259,4.3,"0"
"4547",64,3,68,10429196,10433739,4543,4.5,"20"
"4645",64,4,53,10435248,10438861,3613,3.6,"0"
"4747",64,5,62,10440249,10444112,3863,3.9,"20"
"4845",64,4,69,10445976,10448697,2721,2.7,"0"
"4938",64,5,46,10450397,10456425,6028,6,"20"
"5046",64,5,30,10458254,10461889,3635,3.6,"20"
"5238",64,6,23,10469399,10476694,7295,7.3,"0"
"5446",64,3,28,10483179,10487502,4323,4.3,"20"
"5643",64,8,41,10492920,10497008,4088,4.1,"0"
"5745",64,5,54,10498811,10504777,5966,6,"20"
"5848",64,7,56,10506253,10509842,3589,3.6,"20"
"5944",64,8,49,10513990,10517181,3191,3.2,"0"
"6046",64,2,67,10519818,10525173,5355,5.4,"0"
"6147",64,6,71,10526787,10529459,2672,2.7,"0"
"6243",64,5,38,10535562,10538593,3031,3,"20"
"6343",64,3,60,10540357,10544330,3973,4,"20"
"6445",64,3,20,10553044,10555863,2819,2.8,"20"
"6649",64,8,73,10561242,10565788,4546,4.5,"0"
"6746",64,6,15,10570251,10573963,3712,3.7,"0"
"6945",64,8,57,10578432,10581335,2903,2.9,"0"
"7048",64,7,72,10582639,10586180,3541,3.5,"20"
"7143",64,4,45,10587457,10589737,2280,2.3,"0"
"7251",64,7,80,10590963,10593832,2869,2.9,"20"
"7342",64,4,61,10595542,10601433,5891,5.9,"0"
"7446",64,6,63,10602828,10606465,3637,3.6,"0"
"7537",64,2,11,10608078,10610326,2248,2.2,"0"
"7746",64,8,9,10615078,10619005,3927,3.9,"0"
"7946",64,2,35,10623420,10626663,3243,3.2,"0"
"8041",64,4,13,10628477,10634331,5854,5.9,"0"
"8249",64,1,50,10640178,10643083,2905,2.9,"20"
"8344",64,4,21,10649862,10653554,3692,3.7,"0"
"8542",64,7,24,10659119,10664165,5046,5,"20"
"8744",64,6,79,10670812,10674200,3388,3.4,"0"
"8845",64,8,33,10680723,10684028,3305,3.3,"0"
"8948",64,4,77,10687242,10692725,5483,5.5,"0"
"9046",64,6,47,10694228,10699187,4959,5,"0"
"9143",64,7,64,10700784,10708062,7278,7.3,"20"
"9246",64,4,29,10710254,10713690,3436,3.4,"0"
"9439",64,1,58,10718487,10723943,5456,5.5,"20"
"9547",64,3,76,10732396,10735726,3330,3.3,"20"
"9650",64,7,40,10737918,10742339,4421,4.4,"20"
"9741",64,5,78,10743760,10747393,3633,3.6,"20"
"9850",64,5,70,10750441,10754687,4246,4.2,"20"
"9948",64,1,74,10756256,10761383,5127,5.1,"20"
"10040",64,7,16,10763065,10767838,4773,4.8,"20"
"10248",64,5,22,10776012,10780489,4477,4.5,"20"
"10445",64,4,5,10784644,10790811,6167,6.2,"0"
"10644",64,3,52,10798951,10804393,5442,5.4,"20"
"10749",64,2,19,10807870,10810690,2820,2.8,"0"
"10949",64,1,34,10816392,10819478,3086,3.1,"20"
"11042",64,1,66,10821243,10825953,4710,4.7,"20"
"11163",64,2,27,10828423,10833333,4910,4.9,"0"
"11341",64,1,18,10837619,10841391,3772,3.8,"20"
"11548",64,1,42,10844797,10848657,3860,3.9,"20"
"11645",64,5,6,10851991,10856070,4079,4.1,"20"
"11844",64,6,31,10862043,10866688,4645,4.6,"0"
"12049",64,1,2,10870589,10872840,2251,2.3,"20"
