"","sub","cond","item","seq","start_time","end_time","duration_ms"
"10",1,2,128,1,558738,569913,11175
"11",1,2,80,2,573159,581249,8090
"12",1,3,45,3,585081,591698,6617
"14",1,4,52,4,597543,602548,5005
"16",1,4,16,5,608972,612111,3139
"18",1,1,85,6,618695,625519,6824
"19",1,2,62,7,628831,632577,3746
"20",1,1,7,8,636455,650823,14368
"22",1,3,15,9,658207,660659,2452
"24",1,3,3,10,666744,672349,5605
"26",1,2,98,11,680119,686683,6564
"27",1,5,101,12,690588,697832,7244
"28",1,2,26,13,701658,708222,6564
"30",1,6,54,14,714786,719105,4319
"32",1,5,107,15,726489,731646,5157
"33",1,5,47,16,735325,738597,3272
"35",1,2,2,17,744362,748461,4099
"37",1,5,59,18,754525,759090,4565
"38",1,2,44,19,762802,766354,3552
"40",1,3,105,20,772245,775810,3565
"41",1,4,58,21,778856,785247,6391
"42",1,6,102,22,788132,792884,4752
"43",1,6,126,23,796236,800687,4451
"44",1,5,23,24,803813,809364,5551
"46",1,1,25,25,815482,818081,2599
"48",1,1,49,26,824919,829730,4811
"50",1,5,131,27,835815,842945,7130
"51",1,5,53,28,846004,849316,3312
"53",1,5,95,29,855274,860065,4791
"54",1,3,69,30,863571,871148,7577
"55",1,5,11,31,874161,886076,11915
"57",1,3,123,32,891840,901803,9963
"58",1,3,117,33,905002,907754,2752
"59",1,2,32,34,911013,916431,5418
"61",1,2,104,35,922343,927880,5537
"62",1,6,66,36,930919,935231,4312
"63",1,6,60,37,938783,944101,5318
"64",1,3,135,38,947473,955530,8057
"65",1,6,42,39,958662,966819,8157
"67",1,6,138,40,974063,980687,6624
"68",1,2,134,41,983666,987705,4039
"69",1,3,129,42,990824,998374,7550
"70",1,5,83,43,1002360,1014142,11782
"71",1,2,110,44,1017594,1022825,5231
"72",1,4,40,45,1026317,1037146,10829
"74",1,5,71,46,1044524,1048136,3612
"75",1,4,76,47,1051428,1054114,2686
"76",1,2,122,48,1057226,1059845,2619
"77",1,4,118,49,1062917,1066909,3992
"78",1,4,100,50,1069754,1072587,2833
"79",1,1,37,51,1075633,1081590,5957
"81",1,5,17,52,1087555,1093306,5751
"83",1,1,61,53,1099649,1104747,5098
"84",1,4,4,54,1107959,1110932,2973
"86",1,4,64,55,1116496,1119608,3112
"87",1,4,22,56,1122327,1127232,4905
"89",1,4,88,57,1133497,1143466,9969
"90",1,5,125,58,1148030,1151775,3745
"91",1,5,89,59,1154634,1160299,5665
"92",1,6,36,60,1163225,1166823,3598
"94",1,3,33,61,1174187,1178092,3905
"96",1,1,19,62,1184603,1188368,3765
"98",1,5,65,63,1194513,1198397,3884
"99",1,2,92,64,1203423,1206754,3331
"100",1,5,41,65,1209933,1214631,4698
"102",1,1,121,66,1286758,1293282,6524
"103",1,4,28,67,1296308,1300013,3705
"105",1,4,70,68,1305778,1310523,4745
"106",1,1,109,69,1313635,1318166,4531
"107",1,3,39,70,1320946,1331621,10675
"109",1,2,14,71,1337679,1341904,4225
"111",1,4,112,72,1349682,1352394,2712
"112",1,3,87,73,1356699,1365096,8397
"113",1,6,48,74,1368015,1378091,10076
"115",1,1,13,75,1390326,1400049,9723
"117",1,5,119,76,1405367,1409659,4292
"118",1,4,136,77,1412804,1417323,4519
"119",1,1,67,78,1420388,1423221,2833
"120",1,1,133,79,1426706,1428878,2172
"121",1,3,93,80,1433004,1436529,3525
"122",1,3,51,81,1439948,1442694,2746
"124",1,5,113,82,1448565,1455189,6624
"125",1,6,114,83,1458215,1464325,6110
"126",1,2,20,84,1467544,1470750,3206
"128",1,4,82,85,1477140,1481438,4298
"129",1,5,35,86,1485250,1489069,3819
"131",1,1,55,87,1495466,1498652,3186
"132",1,2,38,88,1501791,1507115,5324
"134",1,5,137,89,1512620,1516792,4172
"135",1,1,43,90,1519731,1526261,6530
"137",1,4,124,91,1532146,1537371,5225
"138",1,2,68,92,1540696,1546787,6091
"139",1,1,73,93,1549827,1554024,4197
"140",1,6,90,94,1557177,1564607,7430
"141",1,3,9,95,1567886,1571312,3426
"143",1,2,56,96,1577676,1584906,7230
"144",1,4,34,97,1587985,1591291,3306
"146",1,3,75,98,1597368,1602367,4999
"147",1,1,115,99,1605679,1608791,3112
"148",1,4,94,100,1613096,1616994,3898
"149",1,5,5,101,1620214,1626084,5870
"151",1,3,57,102,1632989,1636894,3905
"152",1,6,120,103,1640346,1643451,3105
"153",1,6,24,104,1646831,1650849,4018
"155",1,5,29,105,1657247,1662824,5577
"157",1,3,27,106,1669369,1672007,2638
"159",1,6,78,107,1677099,1679005,1906
"160",1,6,30,108,1681877,1683970,2093
"162",1,1,79,109,1689821,1692633,2812
"163",1,3,21,110,1695506,1698851,3345
"165",1,6,18,111,1704556,1708314,3758
"167",1,6,108,112,1713805,1724735,10930
"168",1,2,74,113,1728080,1734098,6018
"169",1,4,46,114,1737230,1739782,2552
"171",1,6,132,115,1745420,1748433,3013
"172",1,1,97,116,1754997,1757742,2745
"173",1,1,103,117,1781967,1787098,5131
"174",1,4,130,118,1790957,1794596,3639
"175",1,3,99,119,1798654,1803972,5318
"176",1,1,31,120,1807291,1813209,5918
"178",1,6,6,121,1820526,1823672,3146
"180",1,2,116,122,1829363,1832501,3138
"181",1,2,50,123,1835420,1838533,3113
"183",1,6,72,124,1843911,1847409,3498
"184",1,5,77,125,1851255,1854833,3578
"185",1,6,84,126,1858299,1863277,4978
"186",1,4,10,127,1866736,1869955,3219
"188",1,3,111,128,1876159,1882770,6611
"189",1,1,127,129,1886715,1889681,2966
"190",1,4,106,130,1892506,1895312,2806
"191",1,3,81,131,1898091,1899997,1906
"192",1,3,63,132,1903129,1904928,1799
"193",1,2,8,133,1907954,1909753,1799
"195",1,1,1,134,1916164,1918136,1972
"197",1,6,12,135,1924141,1927447,3306
"199",1,6,96,136,1933564,1937143,3579
"200",1,1,91,137,1939969,1942094,2125
"201",1,2,86,138,1944920,1946406,1486
"101",2,4,57,1,3494235,3497787,3552
"1110",2,5,136,2,3501386,3504812,3426
"123",2,3,20,3,3507831,3512815,4984
"1410",2,3,38,4,3519846,3524637,4791
"164",2,1,6,5,3530209,3534840,4631
"1810",2,6,17,6,3541325,3547049,5724
"202",2,5,70,7,3552687,3556866,4179
"21",2,2,55,8,3559984,3563290,3306
"221",2,3,86,9,3566489,3570534,4045
"23",2,3,122,10,3574419,3577425,3006
"241",2,4,39,11,3580883,3584509,3626
"261",2,6,101,12,3591539,3595678,4139
"271",2,2,115,13,3598857,3603009,4152
"281",2,5,130,14,3606301,3610359,4058
"29",2,4,33,15,3613565,3618150,4585
"31",2,5,124,16,3626520,3631678,5158
"321",2,5,64,17,3634983,3638242,3259
"331",2,3,50,18,3641255,3644194,2939
"351",2,6,35,19,3650165,3654030,3865
"371",2,2,37,20,3661514,3665832,4318
"39",2,5,58,21,3675442,3681093,5651
"401",2,2,25,22,3684745,3688144,3399
"421",2,3,26,23,3695881,3698673,2792
"441",2,4,27,24,3705371,3709982,4611
"461",2,4,75,25,3717093,3720865,3772
"47",2,3,80,26,3724277,3729235,4958
"481",2,1,72,27,3732174,3733994,1820
"49",2,4,21,28,3737306,3739625,2319
"511",2,3,98,29,3745830,3751661,5831
"52",2,6,65,30,3754859,3758285,3426
"531",2,2,31,31,3761317,3764023,2706
"551",2,3,116,32,3772260,3777844,5584
"56",2,1,30,33,3781110,3784468,3358
"581",2,2,73,34,3790080,3794551,4471
"591",2,4,81,35,3798010,3803375,5365
"60",2,5,4,36,3807120,3813285,6165
"621",2,5,112,37,3819902,3824187,4285
"631",2,5,82,38,3827492,3830192,2700
"641",2,1,60,39,3834025,3837062,3037
"651",2,2,79,40,3840495,3842727,2232
"66",2,6,71,41,3848378,3850970,2592
"671",2,3,68,42,3868198,3873842,5644
"681",2,3,32,43,3877574,3880586,3012
"701",2,3,104,44,3887330,3890803,3473
"711",2,6,107,45,3893995,3898206,4211
"721",2,1,66,46,3902012,3905231,3219
"73",2,3,8,47,3909336,3912621,3285
"751",2,1,18,48,3918972,3922911,3939
"771",2,1,114,49,3929562,3933754,4192
"781",2,4,117,50,3937232,3939911,2679
"791",2,2,121,51,3942717,3945582,2865
"80",2,6,131,52,3948561,3951474,2913
"811",2,6,119,53,3954326,3957545,3219
"82",2,6,29,54,3960424,3964336,3912
"841",2,1,42,55,3970740,3974758,4018
"861",2,4,111,56,3982409,3985421,3012
"871",2,5,118,57,3988613,3991566,2953
"88",2,1,12,58,3994524,3997330,2806
"901",2,4,69,59,4003228,4006053,2825
"911",2,3,44,60,4009106,4012011,2905
"93",2,1,36,61,4018016,4020321,2305
"95",2,5,22,62,4026746,4031198,4452
"97",2,5,46,63,4038115,4041367,3252
"991",2,5,76,64,4047951,4052563,4612
"1001",2,4,9,65,4056228,4059221,2993
"1021",2,1,138,66,4144876,4147674,2798
"1031",2,3,14,67,4150734,4154325,3591
"1051",2,6,95,68,4160397,4163455,3058
"1061",2,2,19,69,4166341,4168600,2259
"108",2,5,34,70,4174558,4177984,3426
"110",2,4,15,71,4184181,4188100,3919
"1121",2,4,3,72,4194131,4197076,2945
"114",2,6,59,73,4202661,4206640,3979
"1151",2,3,74,74,4210258,4215196,4938
"116",2,5,10,75,4218569,4222700,4131
"1181",2,5,106,76,4228851,4232683,3832
"1191",2,2,133,77,4235482,4240627,5145
"1201",2,1,54,78,4244306,4248751,4445
"1221",2,6,11,79,4256648,4260013,3365
"1241",2,2,13,80,4266098,4270156,4058
"1261",2,4,105,81,4276241,4277520,1279
"127",2,3,128,82,4280446,4285897,5451
"1281",2,1,132,83,4288943,4294314,5371
"1291",2,2,127,84,4297579,4302651,5072
"130",2,4,123,85,4305863,4311454,5591
"1311",2,3,92,86,4314907,4319591,4684
"1321",2,4,63,87,4322784,4326075,3291
"133",2,6,53,88,4328908,4332533,3625
"1351",2,5,52,89,4338211,4341457,3246
"1371",2,1,96,90,4348761,4353612,4851
"1381",2,5,40,91,4357251,4362415,5164
"1401",2,6,83,92,4368707,4372765,4058
"1411",2,1,84,93,4375931,4379936,4005
"142",2,3,56,94,4382861,4385907,3046
"1431",2,3,110,95,4388606,4391938,3332
"1441",2,4,93,96,4394624,4397309,2685
"145",2,5,100,97,4400215,4402681,2466
"1461",2,2,1,98,4406719,4409111,2392
"1481",2,3,62,99,4415089,4419001,3912
"1491",2,2,109,100,4422127,4425406,3279
"150",2,2,103,101,4428458,4431783,3325
"1511",2,1,90,102,4434589,4435942,1353
"1521",2,1,48,103,4438794,4440686,1892
"154",2,6,23,104,4447391,4451349,3958
"156",2,5,16,105,4457774,4460686,2912
"158",2,6,5,106,4466764,4470789,4025
"1601",2,4,87,107,4477067,4481745,4678
"161",2,6,125,108,4485150,4490895,5745
"1621",2,1,126,109,4493960,4498072,4112
"1631",2,6,41,110,4501184,4504776,3592
"1651",2,1,24,111,4510881,4514839,3958
"1671",2,1,78,112,4521504,4526688,5184
"1681",2,1,102,113,4529800,4532273,2473
"1691",2,1,120,114,4535065,4537984,2919
"170",2,3,2,115,4540903,4544049,3146
"1721",2,4,51,116,4551106,4554471,3365
"1741",2,3,134,117,4560443,4563988,3545
"1751",2,6,137,118,4566820,4569599,2779
"1761",2,1,108,119,4572591,4575357,2766
"177",2,6,113,120,4578682,4582788,4106
"1781",2,4,99,121,4586073,4589772,3699
"179",2,5,28,122,4592844,4597842,4998
"1811",2,4,129,123,4611097,4615136,4039
"182",2,4,135,124,4618788,4623692,4904
"1831",2,6,77,125,4627118,4630963,3845
"1841",2,2,61,126,4634215,4637181,2966
"1851",2,5,88,127,4640746,4644631,3885
"1861",2,2,91,128,4648124,4652235,4111
"187",2,6,47,129,4655208,4658167,2959
"1891",2,2,49,130,4665037,4667843,2806
"1911",2,4,45,131,4673154,4675993,2839
"1931",2,2,85,132,4682811,4686243,3432
"194",2,2,43,133,4689022,4691881,2859
"196",2,2,97,134,4700664,4704303,3639
"1971",2,2,67,135,4707129,4710534,3405
"198",2,2,7,136,4713500,4716585,3085
"2001",2,6,89,137,4723309,4726908,3599
"2011",2,5,94,138,4729787,4732793,3006
"104",3,4,116,1,8027426,8031218,3792
"1111",3,4,20,2,8034437,8037082,2645
"13",3,2,102,3,8042480,8044973,2493
"1412",3,4,110,4,8047718,8050590,2872
"15",3,1,17,5,8053743,8057148,3405
"17",3,2,138,6,8062540,8065359,2819
"1812",3,4,68,7,8068617,8071483,2866
"1910",3,5,51,8,8076821,8079073,2252
"211",3,6,82,9,8083998,8085937,1939
"222",3,1,53,10,8088943,8091509,2566
"242",3,2,72,11,8096434,8098626,2192
"25",3,3,133,12,8101519,8103904,2385
"262",3,6,16,13,8106703,8109009,2306
"282",3,1,107,14,8115353,8118026,2673
"291",3,1,131,15,8120831,8123310,2479
"301",3,4,8,16,8126343,8129881,3538
"322",3,4,80,17,8135140,8137165,2025
"332",3,6,70,18,8140011,8142390,2379
"34",3,1,113,19,8145076,8147009,1933
"352",3,6,58,20,8149868,8153373,3505
"36",3,2,6,21,8156352,8158997,2645
"381",3,2,114,22,8164542,8167315,2773
"391",3,3,31,23,8170420,8173359,2939
"411",3,4,98,24,8179396,8183495,4099
"422",3,1,83,25,8186721,8189913,3192
"431",3,4,44,26,8192752,8195317,2565
"45",3,6,10,27,8200709,8204194,3485
"471",3,4,56,28,8210198,8213924,3726
"482",3,3,1,29,8216896,8220508,3612
"501",3,5,45,30,8225713,8229012,3299
"521",3,5,69,31,8234643,8237842,3199
"532",3,5,3,32,8240780,8244133,3353
"552",3,4,92,33,8249198,8253989,4791
"561",3,3,25,34,8257041,8260593,3552
"582",3,2,90,35,8265372,8268617,3245
"592",3,4,86,36,8271296,8274708,3412
"601",3,1,119,37,8277820,8282032,4212
"611",3,1,71,38,8284811,8287370,2559
"622",3,2,24,39,8290122,8293275,3153
"642",3,3,127,40,8299246,8301971,2725
"652",3,6,88,41,8305157,8307976,2819
"661",3,5,57,42,8310901,8314034,3133
"672",3,2,12,43,8316819,8319525,2706
"691",3,6,46,44,8325256,8329108,3852
"712",3,6,64,45,8335999,8338705,2706
"722",3,3,61,46,8341543,8345828,4285
"731",3,1,29,47,8349034,8351886,2852
"752",3,3,67,48,8357444,8361303,3859
"761",3,4,74,49,8364428,8368194,3766
"772",3,2,42,50,8371166,8373078,1912
"792",3,3,73,51,8379403,8381735,2332
"801",3,5,21,52,8384521,8386507,1986
"821",3,6,4,53,8392418,8394590,2172
"842",3,1,23,54,8399269,8400928,1659
"862",3,2,66,55,8405680,8408059,2379
"872",3,2,78,56,8411351,8413517,2166
"881",3,5,9,57,8416582,8419275,2693
"902",3,1,137,58,8424366,8426812,2446
"912",3,1,47,59,8430204,8433370,3166
"931",3,1,65,60,8438488,8440254,1766
"941",3,2,126,61,8443066,8445265,2199
"951",3,1,11,62,8448071,8449897,1826
"971",3,3,55,63,8457034,8459493,2459
"981",3,5,111,64,8462492,8467297,4805
"992",3,2,96,65,8470270,8473688,3418
"1002",3,4,2,66,8501278,8504377,3099
"1022",3,5,129,67,8509788,8514600,4812
"1032",3,6,52,68,8517752,8520131,2379
"1052",3,5,105,69,8525389,8529274,3885
"1062",3,3,121,70,8532453,8535325,2872
"1071",3,1,41,71,8538284,8541290,3006
"1091",3,4,26,72,8546561,8549160,2599
"1112",3,3,7,73,8556637,8561982,5345
"1131",3,5,39,74,8569913,8573371,3458
"1152",3,5,75,75,8579316,8582728,3412
"1161",3,3,19,76,8585600,8587933,2333
"1182",3,3,43,77,8593391,8599675,6284
"1202",3,1,5,78,8605600,8609425,3825
"1222",3,1,125,79,8614956,8618608,3652
"1231",3,6,106,80,8621281,8623479,2198
"1242",3,4,62,81,8626199,8628917,2718
"1251",3,6,28,82,8631597,8634769,3172
"1271",3,2,48,83,8640473,8641926,1453
"1292",3,6,22,84,8647591,8650956,3365
"1312",3,1,59,85,8656334,8659906,3572
"1322",3,4,122,86,8662872,8665064,2192
"1331",3,5,33,87,8668096,8671895,3799
"1352",3,5,99,88,8677633,8680332,2699
"136",3,2,54,89,8683404,8685504,2100
"1382",3,3,13,90,8691794,8696679,4885
"1402",3,5,117,91,8701504,8703823,2319
"1413",3,4,128,92,8706822,8710241,3419
"1421",3,4,32,93,8713260,8716232,2972
"1442",3,4,14,94,8721397,8725162,3765
"1462",3,5,135,95,8730527,8735771,5244
"1471",3,6,100,96,8738650,8743089,4439
"1482",3,6,136,97,8746568,8750166,3598
"1492",3,4,134,98,8753372,8756431,3059
"1501",3,5,123,99,8759316,8763295,3979
"1512",3,2,120,100,8766054,8769926,3872
"1522",3,2,18,101,8773058,8775503,2445
"1541",3,3,109,102,8781248,8786506,5258
"1551",3,6,124,103,8789432,8792691,3259
"1561",3,2,60,104,8795536,8799335,3799
"1571",3,3,79,105,8802301,8806792,4491
"1581",3,4,38,106,8809797,8812830,3033
"1602",3,5,87,107,8818501,8822846,4345
"1611",3,1,89,108,8825892,8829390,3498
"1622",3,6,94,109,8832456,8835981,3525
"1632",3,2,84,110,8838700,8842539,3839
"1641",3,6,34,111,8845571,8850043,4472
"166",3,3,49,112,8856127,8860352,4225
"1682",3,4,104,113,8865190,8868942,3752
"1692",3,1,95,114,8871961,8875827,3866
"1701",3,5,81,115,8879119,8881925,2806
"1711",3,2,108,116,8884950,8888089,3139
"1722",3,6,76,117,8890888,8894926,4038
"1731",3,1,77,118,8897785,8900504,2719
"1742",3,3,115,119,8903376,8906409,3033
"1752",3,6,118,120,8909581,8913753,4172
"1762",3,4,50,121,8916725,8919137,2412
"1782",3,3,97,122,8924242,8927648,3406
"1791",3,1,101,123,8930886,8934458,3572
"1801",3,2,30,124,8936917,8939670,2753
"1821",3,3,37,125,8944535,8948773,4238
"1842",3,2,36,126,8954198,8957124,2926
"1862",3,1,35,127,8962702,8965574,2872
"1881",3,3,85,128,8971585,8975776,4191
"1892",3,6,40,129,8979162,8984766,5604
"1912",3,6,112,130,8990378,8993610,3232
"1921",3,5,27,131,8996429,9000701,4272
"1941",3,6,130,132,9006192,9009744,3552
"1951",3,5,63,133,9012723,9015615,2892
"1961",3,5,93,134,9018334,9021320,2986
"1972",3,3,91,135,9024905,9030916,6011
"1981",3,5,15,136,9033995,9037120,3125
"2002",3,2,132,137,9042392,9046004,3612
"2012",3,3,103,138,9049010,9053494,4484
"1010",4,3,24,1,3537753,3543749,5996
"1210",4,1,82,2,3550059,3554353,4294
"1310",4,5,92,3,3557943,3562961,5018
"1414",4,3,48,4,3566009,3569407,3398
"1610",4,4,127,5,3575320,3579503,4183
"1710",4,5,32,6,3582687,3587685,4998
"1913",4,2,137,7,3598307,3602021,3714
"203",4,1,40,8,3605309,3609584,4275
"223",4,1,10,9,3615929,3620707,4778
"243",4,4,31,10,3627484,3631889,4405
"263",4,6,135,11,3638757,3643991,5234
"272",4,5,50,12,3647163,3651317,4154
"292",4,3,66,13,3657124,3660909,3785
"302",4,4,115,14,3663777,3667581,3804
"311",4,6,9,15,3671402,3675937,4535
"333",4,2,101,16,3683519,3686533,3014
"341",4,2,125,17,3689577,3692678,3101
"353",4,3,72,18,3695913,3699627,3714
"361",4,5,86,19,3702956,3706519,3563
"372",4,6,129,20,3710042,3716671,6629
"382",4,6,57,21,3720686,3724648,3962
"392",4,2,89,22,3728160,3732312,4152
"402",4,5,62,23,3735953,3739821,3868
"412",4,5,116,24,3743105,3747274,4169
"423",4,5,38,25,3750512,3754142,3630
"442",4,2,35,26,3760506,3763068,2562
"462",4,6,21,27,3770245,3773095,2850
"483",4,3,60,28,3779788,3783450,3662
"491",4,3,18,29,3786593,3790731,4138
"512",4,4,67,30,3796792,3799227,2435
"522",4,1,16,31,3802873,3805995,3122
"541",4,6,81,32,3812350,3815910,3560
"553",4,3,36,33,3819753,3822966,3213
"571",4,1,88,34,3829950,3832999,3049
"583",4,3,132,35,3835942,3839411,3469
"593",4,2,131,36,3844653,3848042,3389
"602",4,3,96,37,3851217,3854370,3153
"612",4,2,77,38,3857393,3860447,3054
"623",4,5,134,39,3864333,3868302,3969
"632",4,5,14,40,3872100,3876366,4266
"653",4,3,114,41,3883266,3886935,3669
"662",4,3,54,42,3890394,3892866,2472
"682",4,1,130,43,3903970,3907141,3171
"692",4,6,99,44,3911333,3914592,3259
"702",4,6,15,45,3917887,3920521,2634
"723",4,2,5,46,3926663,3929293,2630
"741",4,4,37,47,3935973,3940064,4091
"762",4,6,33,48,3946644,3950379,3735
"782",4,3,42,49,3957266,3960653,3387
"802",4,1,118,50,3967612,3971006,3394
"812",4,4,73,51,3974584,3977495,2911
"822",4,4,61,52,3981034,3984648,3614
"831",4,2,59,53,3987838,3991221,3383
"843",4,4,103,54,3996022,4000061,4039
"85",4,4,133,55,4003462,4006528,3066
"863",4,4,19,56,4009824,4012828,3004
"882",4,4,109,57,4019541,4024751,5210
"891",4,6,51,58,4027945,4031288,3343
"913",4,5,128,59,4037154,4041839,4685
"921",4,4,25,60,4045672,4049164,3492
"942",4,1,22,61,4055421,4058561,3140
"961",4,6,123,62,4064810,4068731,3921
"972",4,2,83,63,4072428,4076192,3764
"982",4,1,4,64,4081566,4084929,3363
"1003",4,4,49,65,4092686,4096051,3365
"1023",4,5,110,66,4130847,4134478,3631
"1033",4,3,12,67,4138044,4141555,3511
"1053",4,6,63,68,4148000,4150866,2866
"1063",4,4,91,69,4154377,4158069,3692
"1072",4,3,78,70,4161302,4164184,2882
"1081",4,3,108,71,4167274,4171430,4156
"1092",4,6,45,72,4179286,4183172,3886
"1113",4,4,43,73,4189832,4192948,3116
"1132",4,1,34,74,4201401,4204618,3217
"1153",4,1,58,75,4212770,4216554,3784
"1162",4,3,90,76,4219920,4223497,3577
"1171",4,2,107,77,4233305,4236467,3162
"1183",4,1,124,78,4240300,4243090,2790
"1192",4,5,2,79,4246249,4249272,3023
"1211",4,1,112,80,4255861,4258238,2377
"1223",4,6,39,81,4262632,4265589,2957
"1243",4,2,53,82,4272867,4276293,3426
"1262",4,1,46,83,4282230,4284855,2625
"1282",4,5,80,84,4291760,4295653,3893
"1293",4,4,79,85,4299803,4303798,3995
"1301",4,2,113,86,4309040,4312198,3158
"1313",4,5,104,87,4316779,4320162,3383
"1323",4,3,84,88,4324341,4327653,3312
"1332",4,2,71,89,4331794,4334470,2676
"1341",4,6,75,90,4337623,4341710,4087
"1353",4,5,20,91,4345815,4349331,3516
"1372",4,2,41,92,4356829,4359948,3119
"1391",4,5,74,93,4366219,4369573,3354
"1403",4,1,28,94,4373459,4376968,3509
"1422",4,6,105,95,4383172,4386549,3377
"1432",4,2,29,96,4389537,4393161,3624
"1451",4,1,136,97,4399496,4402804,3308
"1463",4,4,97,98,4405698,4408622,2924
"1472",4,3,30,99,4411522,4414234,2712
"1493",4,1,70,100,4422631,4426250,3619
"1502",4,5,98,101,4429519,4433113,3594
"1513",4,2,11,102,4436356,4438825,2469
"1531",4,5,68,103,4445718,4450502,4784
"1542",4,3,138,104,4454321,4457832,3511
"1552",4,4,85,105,4461420,4465696,4276
"1562",4,2,119,106,4469449,4473419,3970
"1572",4,4,1,107,4477218,4480796,3578
"1591",4,6,117,108,4487628,4490499,2871
"1603",4,4,13,109,4493452,4496687,3235
"1623",4,1,64,110,4503109,4507150,4041
"1633",4,3,102,111,4511880,4515810,3930
"1642",4,3,126,112,4519405,4523115,3710
"1652",4,1,52,113,4526746,4530197,3451
"1672",4,6,87,114,4538277,4542462,4185
"1683",4,3,120,115,4545679,4549457,3778
"1693",4,6,93,116,4552710,4555837,3127
"1702",4,1,106,117,4558918,4561946,3028
"1712",4,1,94,118,4565458,4569386,3928
"1723",4,2,65,119,4572586,4575201,2615
"1732",4,5,8,120,4578534,4582338,3804
"1753",4,4,121,121,4588612,4591956,3344
"1763",4,2,95,122,4595630,4598530,2900
"1771",4,4,7,123,4601959,4606097,4138
"1792",4,2,17,124,4613275,4616780,3505
"1813",4,2,23,125,4623357,4626389,3032
"1832",4,3,6,126,4633913,4637639,3726
"1852",4,6,111,127,4644136,4647146,3010
"1863",4,5,122,128,4650276,4653392,3116
"1871",4,5,44,129,4656858,4659984,3126
"1893",4,1,76,130,4666164,4669747,3583
"1901",4,4,55,131,4673366,4676237,2871
"1914",4,5,56,132,4679517,4683302,3785
"1922",4,6,3,133,4686797,4690201,3404
"1942",4,2,47,134,4696785,4699691,2906
"1962",4,5,26,135,4706029,4708881,2852
"1982",4,6,27,136,4715846,4718982,3136
"2003",4,6,69,137,4725267,4727751,2484
"2013",4,1,100,138,4730328,4732817,2489
"1011",5,3,113,1,6012393,6015650,3257
"1114",5,4,102,2,6018779,6024407,5628
"1212",5,1,135,3,6028437,6031723,3286
"1314",5,1,69,4,6035664,6038821,3157
"1415",5,5,61,5,6042964,6047546,4582
"1510",5,2,10,6,6052228,6057916,5688
"1713",5,2,100,7,6065553,6070245,4692
"1814",5,3,125,8,6076505,6081955,5450
"1915",5,2,22,9,6087189,6090479,3290
"212",5,5,7,10,6097423,6100061,2638
"231",5,5,109,11,6108094,6113206,5112
"244",5,3,53,12,6116201,6119394,3193
"264",5,6,98,13,6127354,6130316,2962
"273",5,2,28,14,6133536,6136798,3262
"293",5,6,116,15,6142855,6149836,6981
"303",5,6,44,16,6154198,6156653,2455
"323",5,3,41,17,6164203,6169316,5113
"342",5,4,60,18,6177747,6182652,4905
"354",5,1,117,19,6187316,6191495,4179
"362",5,4,72,20,6194439,6197821,3382
"373",5,1,33,21,6203170,6207622,4452
"393",5,6,128,22,6215231,6221717,6486
"403",5,2,136,23,6226196,6232645,6449
"413",5,4,108,24,6236071,6240515,4444
"424",5,3,65,25,6244745,6249365,4620
"432",5,5,127,26,6252318,6256057,3739
"443",5,5,55,27,6261461,6264426,2965
"451",5,6,8,28,6268085,6272922,4837
"472",5,4,36,29,6282694,6289132,6438
"492",5,4,66,30,6330982,6336241,5259
"502",5,5,25,31,6339667,6343433,3766
"523",5,2,16,32,6351655,6354953,3298
"542",5,1,27,33,6363008,6367975,4967
"562",5,5,43,34,6374287,6377702,3415
"584",5,6,134,35,6386257,6388834,2577
"594",5,1,87,36,6392280,6396074,3794
"603",5,3,47,37,6399304,6401736,2432
"624",5,2,76,38,6409169,6415018,5849
"633",5,2,130,39,6419391,6423729,4338
"643",5,2,58,40,6427407,6431312,3905
"654",5,2,64,41,6434481,6439113,4632
"663",5,5,97,42,6443374,6446997,3623
"673",5,1,15,43,6452251,6455329,3078
"693",5,3,89,44,6462938,6468093,5155
"703",5,2,4,45,6471381,6477966,6585
"724",5,4,24,46,6489542,6493409,3867
"742",5,5,91,47,6499894,6502826,2932
"753",5,6,110,48,6505921,6508682,2761
"763",5,4,84,49,6511612,6516467,4855
"773",5,6,26,50,6519663,6524092,4429
"793",5,6,38,51,6533303,6536381,3078
"813",5,6,86,52,6542871,6547849,4978
"823",5,3,29,53,6551049,6554285,3236
"844",5,2,106,54,6560918,6563230,2312
"851",5,3,83,55,6571604,6578018,6414
"864",5,3,11,56,6583149,6589649,6500
"883",5,6,92,57,6597458,6603003,5545
"892",5,5,85,58,6607087,6610668,3581
"903",5,4,18,59,6615864,6618389,2525
"922",5,2,88,60,6625074,6627973,2899
"932",5,2,124,61,6631999,6635730,3731
"943",5,6,56,62,6639457,6644207,4750
"952",5,4,12,63,6648060,6650484,2424
"973",5,6,50,64,6656786,6659456,2670
"993",5,6,62,65,6668488,6670870,2382
"1004",5,3,17,66,6731604,6736754,5150
"1024",5,1,57,67,6752883,6755869,2986
"1034",5,4,96,68,6758965,6761737,2772
"1041",5,5,13,69,6764700,6768581,3881
"1064",5,3,95,70,6774687,6778664,3977
"1073",5,3,71,71,6782221,6784428,2207
"1082",5,1,39,72,6787596,6791139,3543
"1101",5,1,21,73,6799230,6801516,2286
"1122",5,3,5,74,6807928,6812976,5048
"1141",5,3,131,75,6820156,6827181,7025
"1154",5,4,114,76,6831711,6837217,5506
"1163",5,4,132,77,6841887,6844727,2840
"1172",5,2,82,78,6848099,6851670,3571
"1184",5,1,3,79,6859090,6865620,6530
"1203",5,5,37,80,6880354,6883819,3465
"1224",5,5,133,81,6891632,6894532,2900
"1232",5,4,6,82,6897994,6902259,4265
"1252",5,1,45,83,6908503,6912514,4011
"1272",5,5,49,84,6922359,6926524,4165
"1294",5,4,120,85,6934848,6934860,12
"1302",5,6,74,86,6937926,6943971,6045
"1315",5,1,63,87,6947359,6951374,4015
"1324",5,1,129,88,6955773,6959998,4225
"1333",5,5,1,89,6963244,6966643,3399
"1354",5,3,77,90,6974642,6979205,4563
"1361",5,1,99,91,6982565,6986352,3787
"1373",5,5,31,92,6989968,6993532,3564
"1392",5,3,137,93,7001964,7006968,5004
"1404",5,6,122,94,7010345,7013402,3057
"1416",5,5,67,95,7019930,7022574,2644
"1423",5,1,81,96,7028339,7031877,3538
"1433",5,2,70,97,7036413,7040829,4416
"1443",5,3,107,98,7044349,7047661,3312
"1452",5,6,14,99,7051671,7056350,4679
"1473",5,1,111,100,7064493,7066938,2445
"1483",5,4,30,101,7069893,7072562,2669
"1503",5,4,48,102,7078951,7081155,2204
"1523",5,5,79,103,7088066,7091119,3053
"1532",5,4,54,104,7094305,7097542,3237
"1553",5,5,121,105,7104038,7108457,4419
"1563",5,6,80,106,7111981,7114822,2841
"1573",5,6,68,107,7117833,7121381,3548
"1582",5,3,23,108,7124477,7126949,2472
"1604",5,2,94,109,7135383,7139699,4316
"1612",5,1,9,110,7145609,7153821,8212
"1634",5,4,42,111,7161812,7164989,3177
"1653",5,6,104,112,7175065,7177742,2677
"1661",5,6,20,113,7180863,7183408,2545
"1684",5,2,112,114,7193446,7195524,2078
"1694",5,3,35,115,7199865,7203236,3371
"1714",5,5,73,116,7209874,7211951,2077
"1724",5,5,19,117,7215090,7217636,2546
"1743",5,6,2,118,7226003,7229052,3049
"1764",5,1,75,119,7237005,7242315,5310
"1772",5,3,119,120,7245986,7250124,4138
"1783",5,3,101,121,7256302,7258954,2652
"1793",5,4,90,122,7262386,7265504,3118
"1802",5,2,46,123,7270859,7273402,2543
"1822",5,5,103,124,7282166,7285364,3198
"1833",5,2,52,125,7289197,7291736,2539
"1853",5,1,51,126,7298370,7301607,3237
"1872",5,2,118,127,7308324,7310951,2627
"1882",5,2,34,128,7314174,7316967,2793
"1902",5,1,105,129,7323174,7325836,2662
"1916",5,4,78,130,7329018,7331047,2029
"1923",5,1,123,131,7336776,7340284,3508
"1932",5,6,32,132,7377750,7381356,3606
"1952",5,5,115,133,7387435,7389959,2524
"1963",5,4,126,134,7392945,7397025,4080
"1973",5,2,40,135,7400462,7404834,4372
"1991",5,4,138,136,7413831,7418864,5033
"2004",5,3,59,137,7423083,7429278,6195
"2014",5,1,93,138,7432584,7434729,2145
"1012",6,3,94,1,8209418,8214795,5377
"1115",6,1,104,2,8219681,8222699,3018
"1213",6,6,61,3,8225871,8228710,2839
"1316",6,4,65,4,8231743,8234848,3105
"1417",6,3,46,5,8239073,8241679,2606
"1613",6,5,132,6,8249003,8252761,3758
"1715",6,3,124,7,8256067,8261005,4938
"1815",6,4,17,8,8264477,8269282,4805
"204",6,4,137,9,8275673,8280285,4612
"213",6,6,73,10,8283377,8287489,4112
"224",6,1,92,11,8291181,8294439,3258
"232",6,5,84,12,8297532,8301983,4451
"245",6,5,120,13,8305615,8309307,3692
"251",6,4,77,14,8312459,8316038,3579
"265",6,2,123,15,8319757,8323449,3692
"274",6,3,34,16,8326688,8329966,3278
"294",6,1,56,17,8336444,8341049,4605
"304",6,5,78,18,8344481,8347353,2872
"312",6,6,31,19,8350719,8355150,4431
"334",6,2,75,20,8366213,8370658,4445
"343",6,2,45,21,8373797,8377009,3212
"363",6,6,49,22,8383000,8386126,3126
"383",6,5,138,23,8392144,8397242,5098
"394",6,3,118,24,8401293,8404912,3619
"404",6,1,134,25,8408477,8411070,2593
"414",6,4,29,26,8414022,8418001,3979
"433",6,4,89,27,8424625,8429969,5344
"444",6,2,15,28,8433322,8441692,8370
"463",6,5,30,29,8447483,8452069,4586
"484",6,2,57,30,8457893,8459925,2032
"493",6,1,68,31,8464097,8466896,2799
"503",6,2,51,32,8469815,8472414,2599
"524",6,1,122,33,8478318,8481124,2806
"533",6,2,69,34,8483930,8486329,2399
"543",6,2,129,35,8489274,8491780,2506
"554",6,1,62,36,8494813,8497858,3045
"563",6,3,82,37,8501477,8504649,3172
"572",6,4,47,38,8507694,8510240,2546
"595",6,2,21,39,8516698,8519750,3052
"613",6,4,131,40,8526174,8529613,3439
"625",6,2,9,41,8532879,8535018,2139
"644",6,5,24,42,8541609,8545501,3892
"664",6,2,105,43,8552238,8554544,2306
"674",6,5,12,44,8557903,8561735,3832
"694",6,3,4,45,8568165,8570658,2493
"713",6,3,106,46,8576976,8579041,2065
"725",6,6,97,47,8582120,8586225,4105
"732",6,4,41,48,8589045,8592757,3712
"754",6,1,38,49,8598875,8600980,2105
"774",6,4,11,50,8607171,8610777,3606
"794",6,5,90,51,8618987,8623738,4751
"803",6,1,8,52,8631236,8633681,2445
"824",6,6,55,53,8640133,8643391,3258
"832",6,2,63,54,8646776,8650395,3619
"845",6,6,43,55,8653447,8656420,2973
"865",6,1,2,56,8663870,8666463,2593
"884",6,2,33,57,8672614,8675333,2719
"904",6,3,40,58,8682917,8685129,2212
"923",6,6,127,59,8692360,8695512,3152
"933",6,3,10,60,8699011,8701436,2425
"953",6,2,135,61,8707574,8711206,3632
"962",6,5,54,62,8714458,8717477,3019
"983",6,6,13,63,8724402,8727707,3305
"1005",6,4,53,64,8733971,8738103,4132
"1025",6,3,70,65,8744048,8746480,2432
"1035",6,1,26,66,9004259,9007171,2912
"1054",6,6,133,67,9015494,9018780,3286
"1065",6,2,27,68,9021979,9024284,2305
"1083",6,4,101,69,9029589,9032688,3099
"1093",6,6,91,70,9035401,9038059,2658
"1102",6,2,117,71,9041058,9043658,2600
"1116",6,6,103,72,9046943,9050915,3972
"1123",6,4,107,73,9054587,9057626,3039
"1133",6,3,52,74,9060491,9063670,3179
"1155",6,4,119,75,9070355,9073773,3418
"1164",6,1,74,76,9077372,9080510,3138
"1173",6,5,60,77,9083956,9088548,4592
"1185",6,4,59,78,9091686,9097604,5918
"1193",6,3,64,79,9100663,9103482,2819
"1204",6,3,58,80,9106508,9109866,3358
"1214",6,4,35,81,9112979,9116304,3325
"1233",6,1,80,82,9122462,9125234,2772
"1244",6,1,116,83,9128160,9130272,2112
"1253",6,5,72,84,9133131,9135890,2759
"1263",6,3,28,85,9139102,9141828,2726
"1283",6,3,130,86,9148779,9152031,3252
"1295",6,3,16,87,9155643,9157362,1719
"1317",6,5,42,88,9162927,9166399,3472
"1334",6,2,87,89,9172743,9175536,2793
"1342",6,4,113,90,9179008,9182780,3772
"1355",6,6,121,91,9186065,9188984,2919
"1362",6,5,108,92,9191716,9195542,3826
"1374",6,5,18,93,9198887,9201686,2799
"1393",6,5,96,94,9207344,9210290,2946
"1405",6,5,66,95,9213095,9216714,3619
"1418",6,6,85,96,9220259,9225091,4832
"1424",6,1,98,97,9228283,9231495,3212
"1434",6,4,23,98,9234707,9237539,2832
"1453",6,1,50,99,9244830,9246956,2126
"1474",6,1,86,100,9252641,9257819,5178
"1484",6,2,81,101,9261071,9263730,2659
"1494",6,6,7,102,9266535,9269388,2853
"1514",6,1,44,103,9278618,9281383,2765
"1533",6,2,99,104,9288001,9291200,3199
"1543",6,1,20,105,9295592,9298057,2465
"1564",6,4,95,106,9307320,9310533,3213
"1574",6,3,88,107,9314471,9317170,2699
"1583",6,1,110,108,9320416,9322328,1912
"1592",6,5,126,109,9325040,9327466,2426
"1605",6,5,102,110,9330052,9332225,2173
"1614",6,5,6,111,9335230,9337209,1979
"1635",6,6,79,112,9344413,9347925,3512
"1643",6,2,3,113,9351544,9357728,6184
"1662",6,6,67,114,9365019,9368072,3053
"1673",6,2,111,115,9371117,9373909,2792
"1685",6,6,115,116,9376995,9379801,2806
"1695",6,3,100,117,9383479,9385605,2126
"1703",6,5,36,118,9389024,9391656,2632
"1725",6,5,114,119,9397427,9401966,4539
"1733",6,1,32,120,9405044,9408570,3526
"1754",6,6,1,121,9415014,9417800,2786
"1773",6,3,136,122,9424184,9427136,2952
"1784",6,1,128,123,9430515,9433334,2819
"1794",6,4,83,124,9436560,9440058,3498
"1803",6,3,112,125,9443577,9445623,2046
"1816",6,3,22,126,9448642,9450821,2179
"1834",6,5,48,127,9457059,9459751,2692
"1854",6,2,39,128,9465989,9468781,2792
"1873",6,2,93,129,9474519,9477058,2539
"1883",6,1,14,130,9480210,9482709,2499
"1903",6,6,19,131,9489494,9492912,3418
"1924",6,4,125,132,9500416,9503655,3239
"1933",6,3,76,133,9506567,9510299,3732
"1943",6,6,25,134,9513312,9517170,3858
"1964",6,6,109,135,9524394,9527959,3565
"1974",6,4,5,136,9531251,9534843,3592
"1992",6,6,37,137,9540968,9544427,3459
"2015",6,4,71,138,9551404,9553830,2426
"1013",7,2,56,1,10052920,10056645,3725
"1117",7,1,73,2,10060017,10063822,3805
"1215",7,4,70,3,10067134,10070586,3452
"1318",7,4,10,4,10074125,10077743,3618
"1515",7,2,134,5,10087720,10092025,4305
"1615",7,3,27,6,10095184,10099109,3925
"1817",7,4,106,7,10105474,10109512,4038
"1917",7,6,30,8,10112451,10115643,3192
"214",7,2,116,9,10121561,10124340,2779
"225",7,1,7,10,10127492,10130631,3139
"246",7,3,117,11,10140900,10144392,3492
"252",7,6,66,12,10147245,10150723,3478
"266",7,3,135,13,10154162,10157647,3485
"275",7,4,118,14,10162799,10166431,3632
"283",7,3,81,15,10170150,10174828,4678
"295",7,5,137,16,10178053,10182012,3959
"305",7,1,49,17,10185077,10188696,3619
"324",7,4,88,18,10196014,10199312,3298
"335",7,2,104,19,10204211,10207476,3265
"344",7,1,91,20,10210921,10214067,3146
"355",7,3,69,21,10218125,10221457,3332
"364",7,5,125,22,10224876,10227642,2766
"374",7,4,82,23,10232553,10235839,3286
"384",7,1,97,24,10239817,10242450,2633
"395",7,5,77,25,10245942,10249234,3292
"405",7,3,105,26,10254259,10256584,2325
"415",7,4,46,27,10260070,10263722,3652
"434",7,6,42,28,10270833,10273591,2758
"452",7,4,76,29,10285007,10289872,4865
"464",7,1,37,30,10293298,10296477,3179
"485",7,4,22,31,10306493,10311298,4805
"504",7,4,28,32,10317769,10321674,3905
"525",7,3,129,33,10329484,10331930,2446
"534",7,2,98,34,10336962,10340260,3298
"544",7,3,57,35,10344005,10346918,2913
"555",7,6,108,36,10349757,10352029,2272
"564",7,4,94,37,10356328,10359133,2805
"573",7,5,5,38,10363319,10367637,4318
"596",7,5,17,39,10375248,10378493,3245
"614",7,6,78,40,10384131,10387296,3165
"626",7,2,92,41,10390862,10393134,2272
"634",7,1,133,42,10396006,10398305,2299
"645",7,1,43,43,10401105,10402831,1726
"665",7,3,39,44,10409475,10413267,3792
"683",7,5,29,45,10420378,10424509,4131
"704",7,3,75,46,10433519,10437431,3912
"714",7,3,87,47,10442936,10445535,2599
"726",7,1,61,48,10448787,10453645,4858
"733",7,5,101,49,10456971,10460743,3772
"743",7,4,124,50,10463735,10467594,3859
"755",7,5,119,51,10473565,10476084,2519
"764",7,6,48,52,10481062,10483001,1939
"783",7,6,36,53,10492191,10495643,3452
"804",7,4,112,54,10548277,10551936,3659
"814",7,5,71,55,10555015,10557534,2519
"825",7,5,65,56,10561026,10563578,2552
"833",7,4,58,57,10566437,10568863,2426
"846",7,5,107,58,10575914,10578886,2972
"852",7,3,21,59,10582858,10585330,2472
"873",7,6,12,60,10596093,10599198,3105
"893",7,2,50,61,10606503,10609068,2565
"914",7,1,85,62,10616019,10619271,3252
"924",7,2,80,63,10623356,10625249,1893
"934",7,4,34,64,10628574,10631773,3199
"954",7,3,45,65,10639770,10642809,3039
"974",7,2,2,66,10684294,10686560,2266
"994",7,4,130,67,10695483,10698816,3333
"1006",7,1,109,68,10702188,10704493,2305
"1014",7,2,128,69,10707445,10709738,2293
"1026",7,5,53,70,10713756,10716535,2779
"1042",7,2,74,71,10723326,10725845,2519
"1055",7,6,18,72,10728777,10730916,2139
"1074",7,6,120,73,10737261,10739167,1906
"1084",7,6,138,74,10743572,10746991,3419
"1094",7,6,72,75,10751276,10754101,2825
"1103",7,2,20,76,10757760,10760159,2399
"1124",7,2,44,77,10768016,10771482,3466
"1142",7,6,6,78,10782578,10785817,3239
"1165",7,4,136,79,10794713,10797412,2699
"1174",7,1,103,80,10800691,10802930,2239
"1186",7,4,64,81,10805803,10808968,3165
"1194",7,3,51,82,10812053,10815019,2966
"1216",7,1,25,83,10821230,10825082,3852
"1234",7,1,31,84,10830833,10833972,3139
"1254",7,1,79,85,10840343,10843475,3132
"1264",7,2,26,86,10847201,10850633,3432
"1284",7,5,35,87,10861369,10865634,4265
"1303",7,4,40,88,10873451,10876223,2772
"1325",7,4,100,89,10883974,10886773,2799
"1335",7,3,93,90,10889932,10892337,2405
"1343",7,6,24,91,10895996,10898635,2639
"1363",7,1,13,92,10906812,10909964,3152
"1383",7,2,62,93,10951476,10953675,2199
"1394",7,1,115,94,10956987,10960106,3119
"1406",7,6,132,95,10963671,10966217,2546
"1419",7,4,16,96,10969609,10971608,1999
"1435",7,6,84,97,10978166,10981191,3025
"1444",7,5,59,98,10984964,10988455,3491
"1454",7,3,63,99,10991881,10994313,2432
"1464",7,3,9,100,10997845,11001078,3233
"1485",7,2,86,101,11007508,11009467,1959
"1495",7,4,4,102,11012347,11014259,1912
"1516",7,2,8,103,11022203,11025581,3378
"1534",7,5,11,104,11031553,11033412,1859
"1554",7,6,54,105,11039837,11042942,3105
"1575",7,5,41,106,11051039,11053804,2765
"1593",7,6,60,107,11060342,11064041,3699
"1606",7,6,96,108,11067086,11070385,3299
"1616",7,3,33,109,11085473,11087439,1966
"1636",7,1,1,110,11094776,11097455,2679
"1654",7,1,19,111,11103706,11105699,1993
"1674",7,2,32,112,11113249,11116189,2940
"1696",7,5,83,113,11122772,11125472,2700
"1704",7,6,126,114,11128330,11132149,3819
"1716",7,3,15,115,11134948,11137694,2746
"1734",7,5,89,116,11144631,11147810,3179
"1744",7,4,52,117,11152921,11155960,3039
"1765",7,6,102,118,11163998,11168063,4065
"1774",7,5,23,119,11171208,11173314,2106
"1795",7,3,111,120,11184463,11186482,2019
"1804",7,2,68,121,11190594,11192741,2147
"1818",7,3,3,122,11196139,11198412,2273
"1835",7,2,14,123,11205782,11207914,2132
"1855",7,5,47,124,11214445,11217198,2753
"1874",7,1,55,125,11224282,11226614,2332
"1884",7,2,122,126,11229240,11231639,2399
"1894",7,5,95,127,11234838,11237870,3032
"1904",7,5,131,128,11241096,11244148,3052
"1918",7,6,90,129,11246927,11249746,2819
"1925",7,1,67,130,11252352,11254197,1845
"1934",7,2,38,131,11257956,11260249,2293
"1953",7,2,110,132,11266420,11269359,2939
"1965",7,1,121,133,11272611,11274570,1959
"1975",7,1,127,134,11277356,11279721,2365
"1983",7,5,113,135,11282674,11285413,2739
"1993",7,3,123,136,11289638,11292317,2679
"2005",7,6,114,137,11296162,11301000,4838
"2016",7,3,99,138,11304026,11306218,2192
"1015",8,3,104,1,2968777,2971549,2772
"1118",8,2,67,2,2974655,2977260,2605
"1217",8,6,59,3,2980706,2984631,3925
"1319",8,4,39,4,2987737,2990576,2839
"1517",8,6,23,5,2996001,2998619,2618
"1717",8,5,64,6,3004897,3008289,3392
"1819",8,6,83,7,3011834,3015267,3433
"1919",8,4,9,8,3018612,3021804,3192
"215",8,2,19,9,3028055,3031207,3152
"233",8,4,129,10,3038371,3041763,3392
"247",8,6,113,11,3044656,3047495,2839
"253",8,3,98,12,3050400,3054279,3879
"267",8,5,124,13,3057098,3060070,2972
"276",8,4,45,14,3062889,3065368,2479
"296",8,5,4,15,3070833,3073652,2819
"313",8,2,7,16,3078936,3081522,2586
"336",8,4,27,17,3088273,3091079,2806
"356",8,4,3,18,3096923,3100502,3579
"375",8,2,13,19,3106420,3109745,3325
"396",8,5,34,20,3115343,3118589,3246
"416",8,1,114,21,3126819,3129458,2639
"425",8,6,35,22,3132304,3135322,3018
"445",8,3,44,23,3141840,3143999,2159
"465",8,3,38,24,3150057,3152482,2425
"486",8,1,48,25,3158347,3161272,2925
"505",8,1,96,26,3167857,3170022,2165
"513",8,3,62,27,3173128,3176220,3092
"526",8,4,81,28,3179159,3182245,3086
"535",8,3,122,29,3185284,3187136,1852
"545",8,6,89,30,3189929,3192554,2625
"556",8,1,12,31,3195960,3198139,2179
"574",8,5,94,32,3204390,3207049,2659
"585",8,3,32,33,3210168,3212807,2639
"604",8,4,75,34,3219158,3222117,2959
"615",8,4,93,35,3224936,3227528,2592
"627",8,2,127,36,3230694,3233059,2365
"635",8,1,66,37,3235652,3238231,2579
"646",8,2,109,38,3241416,3244735,3319
"655",8,3,8,39,3248254,3250153,1899
"675",8,5,46,40,3256857,3260223,3366
"695",8,5,82,41,3267147,3269606,2459
"705",8,5,70,42,3272585,3275657,3072
"715",8,1,84,43,3278549,3281775,3226
"727",8,6,53,44,3285333,3288312,2979
"744",8,4,63,45,3293997,3296269,2272
"756",8,1,138,46,3299115,3302387,3272
"765",8,5,40,47,3305513,3308638,3125
"784",8,5,76,48,3315575,3318495,2920
"795",8,1,72,49,3321453,3323126,1673
"805",8,4,135,50,3326345,3329144,2799
"815",8,2,61,51,3332063,3334462,2399
"826",8,4,105,52,3337194,3340466,3272
"834",8,1,36,53,3343498,3345464,1966
"853",8,3,80,54,3353275,3356301,3026
"866",8,5,100,55,3359366,3364404,5038
"874",8,6,101,56,3367196,3370389,3193
"885",8,1,60,57,3373814,3376726,2912
"894",8,2,133,58,3379766,3382738,2972
"905",8,2,73,59,3386156,3388382,2226
"915",8,6,65,60,3391681,3394406,2725
"925",8,3,116,61,3397472,3399784,2312
"935",8,5,88,62,3403663,3406375,2712
"944",8,2,31,63,3409294,3411453,2159
"963",8,2,49,64,3417205,3419430,2225
"984",8,2,121,65,3424795,3426688,1893
"995",8,3,56,66,3486359,3488971,2612
"1007",8,3,2,67,3492177,3496502,4325
"1027",8,4,123,68,3504319,3506985,2666
"1036",8,6,77,69,3509937,3513509,3572
"1043",8,4,57,70,3516528,3518780,2252
"1056",8,2,115,71,3521766,3524572,2806
"1066",8,4,15,72,3527464,3531103,3639
"1085",8,5,130,73,3537114,3541332,4218
"1095",8,4,21,74,3544285,3546410,2125
"1119",8,5,112,75,3553701,3555933,2232
"1125",8,1,24,76,3558826,3561405,2579
"1143",8,4,111,77,3569515,3572347,2832
"1156",8,2,25,78,3575726,3577698,1972
"1175",8,1,90,79,3583217,3585156,1939
"1187",8,6,131,80,3588635,3591100,2465
"1195",8,3,92,81,3594026,3597152,3126
"1205",8,2,43,82,3599944,3602996,3052
"1225",8,1,30,83,3608887,3611599,2712
"1245",8,5,16,84,3617357,3619923,2566
"1265",8,6,47,85,3626154,3628493,2339
"1285",8,5,28,86,3634691,3637250,2559
"1304",8,1,132,87,3643354,3646161,2807
"13110",8,3,110,88,3648926,3651691,2765
"1326",8,2,1,89,3654597,3656849,2252
"1344",8,2,55,90,3663327,3665753,2426
"1356",8,5,58,91,3668598,3670917,2319
"1364",8,4,51,92,3673723,3676089,2366
"1384",8,3,26,93,3681760,3683899,2139
"1407",8,6,71,94,3690537,3693016,2479
"14110",8,6,29,95,3695848,3698541,2693
"1436",8,3,50,96,3704665,3706844,2179
"1455",8,1,78,97,3713055,3715061,2006
"1465",8,1,18,98,3717667,3720353,2686
"1486",8,6,125,99,3725831,3728363,2532
"1496",8,1,102,100,3731155,3733514,2359
"1504",8,6,41,101,3736333,3739199,2866
"1524",8,5,10,102,3745064,3748036,2972
"1544",8,5,52,103,3753680,3756219,2539
"1565",8,6,119,104,3762377,3765796,3419
"1576",8,2,91,105,3769161,3771647,2486
"1584",8,1,126,106,3774586,3776592,2006
"1594",8,2,37,107,3779378,3781423,2045
"1617",8,6,95,108,3788254,3790560,2306
"1624",8,4,69,109,3793705,3795991,2286
"1637",8,4,117,110,3798930,3801202,2272
"1644",8,6,137,111,3804022,3806361,2339
"1655",8,6,17,112,3809386,3813285,3899
"1675",8,1,42,113,3819609,3822288,2679
"1697",8,2,85,114,3828353,3830865,2512
"1705",8,3,68,115,3833911,3835810,1899
"1718",8,6,11,116,3838842,3840748,1906
"1735",8,1,54,117,3847525,3849391,1866
"1755",8,6,5,118,3855349,3857488,2139
"1775",8,4,87,119,3863227,3866392,3165
"1785",8,3,14,120,3869524,3871736,2212
"1805",8,3,20,121,3877854,3880067,2213
"1823",8,4,33,122,3887038,3889023,1985
"1843",8,1,120,123,3894775,3897187,2412
"1856",8,1,108,124,3900353,3902052,1699
"1864",8,4,99,125,3906044,3908397,2353
"1875",8,2,103,126,3911395,3912961,1566
"1885",8,5,118,127,3915940,3917793,1853
"1895",8,5,22,128,3920592,3922651,2059
"19110",8,3,86,129,3930368,3932121,1753
"1926",8,6,107,130,3935160,3936866,1706
"1935",8,5,106,131,3939651,3941797,2146
"1944",8,1,6,132,3944676,3947175,2499
"1966",8,2,97,133,3954019,3955672,1653
"1976",8,3,134,134,3958745,3961297,2552
"1984",8,2,79,135,3964809,3966908,2099
"1994",8,5,136,136,3970093,3972273,2180
"2006",8,3,128,137,3975205,3978077,2872
"2017",8,3,74,138,3980816,3983129,2313
"1016",9,4,128,1,5686566,5692097,5531
"1120",9,3,109,2,5695649,5700028,4379
"1218",9,3,7,3,5705519,5710144,4625
"1420",9,3,121,4,5716681,5720867,4186
"1518",9,3,115,5,5724239,5731023,6784
"1618",9,6,94,6,5734235,5738240,4005
"1719",9,1,53,7,5743625,5748103,4478
"1920",9,2,18,8,5754501,5757233,2732
"216",9,3,61,9,5763311,5766577,3266
"226",9,6,124,10,5770775,5773940,3165
"234",9,6,70,11,5777426,5782784,5358
"248",9,6,106,12,5785709,5790881,5172
"254",9,6,46,13,5794406,5798378,3972
"277",9,4,32,14,5807008,5811053,4045
"297",9,1,107,15,5817364,5819937,2573
"306",9,3,55,16,5822709,5826548,3839
"314",9,4,116,17,5830086,5833272,3186
"325",9,3,133,18,5837044,5840076,3032
"337",9,5,99,19,5843442,5846640,3198
"345",9,1,137,20,5849606,5852811,3205
"357",9,5,81,21,5856003,5860068,4065
"365",9,2,66,22,5863641,5866253,2612
"376",9,1,11,23,5869885,5872351,2466
"397",9,3,37,24,5878475,5883073,4598
"417",9,5,111,25,5889238,5893010,3772
"426",9,1,35,26,5896369,5899940,3571
"446",9,6,136,27,5906944,5910117,3173
"453",9,4,92,28,5913316,5917194,3878
"466",9,2,6,29,5920193,5922679,2486
"487",9,5,129,30,5929056,5931715,2659
"494",9,2,120,31,5934721,5939859,5138
"506",9,4,110,32,5942878,5945090,2212
"514",9,4,134,33,5948189,5950775,2586
"527",9,4,44,34,5953774,5957146,3372
"546",9,6,118,35,5964063,5967702,3639
"557",9,2,54,36,5971134,5974733,3599
"575",9,6,34,37,5982657,5986862,4205
"597",9,4,86,38,5994872,5998591,3719
"605",9,3,79,39,6003276,6005821,2545
"616",9,5,135,40,6009380,6013418,4038
"628",9,5,87,41,6017224,6021875,4651
"636",9,1,77,42,6025048,6029253,4205
"647",9,2,90,43,6032845,6035170,2325
"656",9,4,56,44,6038409,6043041,4632
"666",9,4,80,45,6046726,6052691,5965
"676",9,5,69,46,6055750,6060688,4938
"684",9,2,114,47,6064799,6067445,2646
"696",9,2,84,48,6071457,6074196,2739
"706",9,2,132,49,6077642,6080674,3032
"716",9,5,21,50,6083907,6086405,2498
"734",9,6,40,51,6093023,6096021,2998
"757",9,2,78,52,6103665,6107677,4012
"766",9,1,17,53,6110716,6112742,2026
"785",9,2,138,54,6118886,6120925,2039
"796",9,3,25,55,6124557,6128096,3539
"816",9,4,74,56,6134181,6136873,2692
"827",9,4,98,57,6139619,6144903,5284
"835",9,6,16,58,6148036,6151474,3438
"854",9,1,5,59,6158192,6161644,3452
"875",9,2,102,60,6168301,6175025,6724
"886",9,3,43,61,6178304,6181670,3366
"906",9,3,19,62,6188934,6191173,2239
"926",9,1,71,63,6198257,6199983,1726
"936",9,6,76,64,6202922,6207194,4272
"945",9,6,10,65,6210326,6214537,4211
"964",9,2,30,66,6260701,6263313,2612
"985",9,3,49,67,6269684,6272456,2772
"1008",9,4,26,68,6278221,6281306,3085
"1028",9,2,60,69,6287157,6289456,2299
"1037",9,3,13,70,6292442,6295868,3426
"1057",9,4,2,71,6302398,6306017,3619
"1075",9,1,29,72,6312941,6315127,2186
"1096",9,5,123,73,6320791,6324903,4112
"1104",9,5,3,74,6328015,6331474,3459
"1126",9,3,103,75,6337072,6340718,3646
"1134",9,5,117,76,6343890,6347222,3332
"1144",9,3,73,77,6351027,6353200,2173
"1157",9,2,108,78,6356278,6358344,2066
"1166",9,6,64,79,6361190,6363616,2426
"1176",9,5,93,80,6366455,6368434,1979
"1188",9,2,36,81,6371193,6372712,1519
"1206",9,1,23,82,6378324,6380276,1952
"1226",9,5,105,83,6385767,6387893,2126
"1235",9,5,75,84,6390652,6394518,3866
"1246",9,1,83,85,6397783,6401662,3879
"1255",9,3,1,86,6404474,6409132,4658
"1273",9,6,82,87,6415523,6418509,2986
"1286",9,6,112,88,6421241,6423733,2492
"1296",9,2,48,89,6426346,6430071,3725
"13111",9,2,12,90,6437122,6445579,8457
"1336",9,1,89,91,6452064,6463632,11568
"1345",9,2,96,92,6466884,6471229,4345
"1357",9,1,95,93,6474281,6479133,4852
"1365",9,4,38,94,6481812,6485611,3799
"1385",9,6,58,95,6491522,6494347,2825
"1395",9,6,22,96,6497540,6500925,3385
"14111",9,1,41,97,6506983,6510028,3045
"1437",9,4,50,98,6515693,6521191,5498
"1456",9,6,100,99,6531147,6534133,2986
"1466",9,1,125,100,6537858,6540011,2153
"1475",9,6,28,101,6543016,6545808,2792
"1497",9,3,85,102,6554365,6557051,2686
"1505",9,3,31,103,6560310,6563849,3539
"1525",9,1,131,104,6572445,6575064,2619
"1535",9,3,97,105,6578056,6582448,4392
"1545",9,4,14,106,6585687,6591231,5544
"1566",9,2,126,107,6598749,6601661,2912
"1577",9,4,20,108,6604500,6607219,2719
"1595",9,4,62,109,6614303,6616695,2392
"1607",9,3,91,110,6619648,6622627,2979
"1619",9,4,8,111,6625786,6628078,2292
"1638",9,2,72,112,6633656,6635715,2059
"1645",9,5,51,113,6639427,6642339,2912
"1663",9,1,101,114,6647765,6650003,2238
"1676",9,4,68,115,6653069,6657207,4138
"1686",9,1,59,116,6660519,6664851,4332
"1698",9,3,67,117,6668243,6671935,3692
"1706",9,6,52,118,6674587,6678413,3826
"1726",9,6,4,119,6685344,6689615,4271
"1745",9,5,45,120,6694580,6698072,3492
"1766",9,3,127,121,6704243,6706895,2652
"1776",9,5,39,122,6709728,6715532,5804
"1796",9,1,65,123,6722270,6725709,3439
"1806",9,6,88,124,6728661,6735218,6557
"18110",9,4,104,125,6738657,6742196,3539
"1824",9,2,24,126,6756117,6761668,5551
"1844",9,4,122,127,6770119,6774137,4018
"1857",9,5,9,128,6777256,6780075,2819
"1876",9,1,119,129,6786759,6792124,5365
"1886",9,5,33,130,6795136,6800421,5285
"1905",9,6,130,131,6807865,6810890,3025
"19111",9,1,113,132,6813663,6817361,3698
"1927",9,5,57,133,6820520,6823972,3452
"1936",9,5,15,134,6826851,6829610,2759
"1954",9,2,42,135,6837227,6841306,4079
"1977",9,5,27,136,6847750,6852455,4705
"1995",9,1,47,137,6858233,6860219,1986
"2018",9,5,63,138,6866617,6870715,4098
"1017",10,2,11,1,8031732,8034085,2353
"1219",10,3,120,2,8040982,8047473,6491
"1320",10,2,53,3,8050718,8054044,3326
"1519",10,1,58,4,8059802,8062147,2345
"1620",10,5,74,5,8065200,8069038,3838
"1720",10,2,83,6,8072264,8077129,4865
"1820",10,2,5,7,8080821,8086818,5997
"205",10,5,14,8,8094169,8098307,4138
"227",10,5,20,9,8105618,8110690,5072
"249",10,6,63,10,8118487,8121979,3492
"255",10,1,76,11,8124964,8129836,4872
"268",10,4,91,12,8132728,8136633,3905
"278",10,4,97,13,8139806,8142271,2465
"284",10,3,72,14,8145283,8147923,2640
"298",10,6,69,15,8151628,8154240,2612
"307",10,1,16,16,8157379,8164003,6624
"326",10,2,113,17,8169468,8175466,5998
"338",10,3,132,18,8178478,8182683,4205
"346",10,4,49,19,8186002,8191846,5844
"366",10,2,17,20,8198104,8204162,6058
"385",10,3,66,21,8210753,8213405,2652
"398",10,1,64,22,8218870,8218983,113
"406",10,1,106,23,8222435,8225574,3139
"418",10,2,89,24,8228793,8234497,5704
"427",10,6,99,25,8237909,8241062,3153
"435",10,3,84,26,8244267,8248578,4311
"447",10,2,125,27,8251771,8256602,4831
"454",10,4,1,28,8260994,8263826,2832
"473",10,5,8,29,8269264,8271917,2653
"495",10,4,7,30,8278001,8280660,2659
"515",10,1,82,31,8287085,8290530,3445
"528",10,4,55,32,8298560,8302179,3619
"536",10,2,41,33,8305231,8307090,1859
"558",10,2,29,34,8312628,8318553,5925
"576",10,6,33,35,8327470,8331201,3731
"598",10,4,103,36,8336979,8340538,3559
"606",10,3,108,37,8343770,8346496,2726
"617",10,6,135,38,8349788,8352953,3165
"629",10,6,117,39,8356212,8357951,1739
"637",10,6,15,40,8361310,8362969,1659
"657",10,1,136,41,8368474,8371120,2646
"667",10,2,35,42,8374852,8378370,3518
"685",10,2,71,43,8384588,8386967,2379
"697",10,4,25,44,8389920,8392965,3045
"717",10,1,94,45,8398550,8404861,6311
"728",10,5,44,46,8408399,8411192,2793
"745",10,1,112,47,8416517,8425560,9043
"758",10,2,137,48,8429145,8431698,2553
"767",10,6,3,49,8434690,8439048,4358
"786",10,5,68,50,8446053,8448558,2505
"797",10,6,57,51,8451737,8454429,2692
"806",10,1,70,52,8457615,8460394,2779
"817",10,4,31,53,8463479,8467784,4305
"836",10,1,28,54,8473562,8476461,2899
"855",10,3,12,55,8482672,8485325,2653
"876",10,6,75,56,8492109,8495487,3378
"887",10,6,39,57,8498373,8502611,4238
"907",10,2,47,58,8509016,8511315,2299
"927",10,6,105,59,8519066,8523390,4324
"937",10,1,46,60,8526876,8535546,8670
"955",10,4,115,61,8542150,8544982,2832
"965",10,5,26,62,8547875,8549874,1999
"986",10,3,36,63,8556685,8563042,6357
"1009",10,6,111,64,8570007,8574118,4111
"1018",10,5,92,65,8577304,8581862,4558
"1029",10,5,80,66,8708775,8711714,2939
"1038",10,2,131,67,8714853,8717538,2685
"1044",10,2,23,68,8720251,8722550,2299
"1067",10,4,85,69,8727928,8731627,3699
"1076",10,5,104,70,8734739,8738118,3379
"1086",10,6,21,71,8741277,8745581,4304
"1105",10,1,22,72,8752532,8755631,3099
"1127",10,5,122,73,8764382,8766220,1838
"1135",10,5,98,74,8769473,8772532,3059
"1145",10,5,86,75,8775731,8778223,2492
"1158",10,3,30,76,8781175,8783347,2172
"1177",10,2,101,77,8788792,8791625,2833
"1189",10,4,19,78,8794870,8797662,2792
"1207",10,4,109,79,8805386,8809191,3805
"12110",10,2,119,80,8813110,8818228,5118
"1227",10,3,48,81,8821300,8822800,1500
"1247",10,3,54,82,8830744,8833402,2658
"1266",10,2,107,83,8839481,8843092,3611
"1274",10,3,78,84,8846024,8849703,3679
"1287",10,3,102,85,8852755,8855981,3226
"1297",10,3,18,86,8859160,8862125,2965
"13112",10,5,38,87,8869176,8872308,3132
"1337",10,4,61,88,8877633,8879932,2299
"1346",10,1,4,89,8882964,8885263,2299
"1366",10,3,6,90,8891361,8895639,4278
"1386",10,2,95,91,8903017,8907455,4438
"1396",10,3,114,92,8911167,8915979,4812
"1408",10,6,27,93,8919144,8921450,2306
"1425",10,2,59,94,8927414,8929420,2006
"1438",10,4,13,95,8932559,8934898,2339
"1457",10,1,118,96,8939796,8942789,2993
"1467",10,4,67,97,8945994,8947867,1873
"1476",10,4,37,98,8950772,8953818,3046
"1498",10,6,123,99,8960336,8964800,4464
"1506",10,1,124,100,8968472,8970058,1586
"15110",10,5,116,101,8972671,8975716,3045
"1526",10,1,100,102,8978822,8982947,4125
"1536",10,4,121,103,8986212,8988818,2606
"1546",10,4,133,104,8991984,8994576,2592
"1555",10,1,10,105,8997808,8999974,2166
"1578",10,5,56,106,9006058,9008651,2593
"1585",10,3,138,107,9011223,9012996,1773
"1596",10,1,130,108,9016321,9018927,2606
"1608",10,5,62,109,9022372,9025145,2773
"16110",10,3,24,110,9028670,9032202,3532
"1639",10,4,43,111,9038873,9041505,2632
"1656",10,6,45,112,9047597,9052774,5177
"1677",10,3,90,113,9058559,9061598,3039
"1687",10,2,65,114,9064764,9067836,3072
"1699",10,4,127,115,9070642,9073120,2478
"1707",10,6,87,116,9080971,9083896,2925
"17110",10,5,134,117,9087009,9093813,6804
"1727",10,1,52,118,9097018,9100690,3672
"1746",10,5,2,119,9108014,9111073,3059
"1767",10,1,88,120,9118990,9121783,2793
"1777",10,6,9,121,9124915,9128320,3405
"1797",10,5,32,122,9135977,9139796,3819
"18111",10,4,73,123,9145940,9148039,2099
"1825",10,4,79,124,9151185,9154890,3705
"1836",10,2,77,125,9158222,9160748,2526
"1845",10,1,40,126,9163927,9167432,3505
"1865",10,3,60,127,9173323,9177808,4485
"1877",10,3,96,128,9181127,9186119,4992
"1887",10,5,128,129,9189684,9194195,4511
"1896",10,6,129,130,9197448,9200467,3019
"1906",10,3,42,131,9203565,9205611,2046
"1928",10,5,50,132,9213242,9218300,5058
"1945",10,5,110,133,9223911,9226597,2686
"1955",10,3,126,134,9229582,9233674,4092
"1967",10,1,34,135,9236906,9239012,2106
"1985",10,6,93,136,9245223,9247489,2266
"1996",10,6,81,137,9250642,9256859,6217
"2007",10,6,51,138,9260298,9263636,3338
"1019",11,1,75,1,17499641,17505479,5838
"1128",11,4,120,2,17508818,17515255,6437
"1220",11,1,93,3,17518914,17524625,5711
"1327",11,2,136,4,17527671,17533335,5664
"1426",11,6,134,5,17538167,17545224,7057
"1520",11,4,54,6,17550676,17554667,3991
"1728",11,1,81,7,17566877,17572981,6104
"1826",11,4,84,8,17576746,17582177,5431
"1929",11,4,48,9,17585170,17589568,4398
"217",11,6,98,10,17597965,17602710,4745
"228",11,1,45,11,17606382,17611047,4665
"2410",11,4,72,12,17617445,17621483,4038
"256",11,5,85,13,17624802,17629833,5031
"269",11,1,27,14,17635678,17640736,5058
"285",11,1,21,15,17647600,17652751,5151
"308",11,2,34,16,17659116,17663840,4724
"327",11,1,87,17,17672824,17678622,5798
"339",11,5,1,18,17682141,17686152,4011
"358",11,1,105,19,17691890,17695849,3959
"367",11,6,14,20,17699541,17705285,5744
"386",11,2,130,21,17711689,17717714,6025
"399",11,1,111,22,17720920,17726011,5091
"407",11,6,56,23,17731396,17736573,5177
"419",11,4,126,24,17739673,17744377,4704
"428",11,3,119,25,17747709,17753534,5825
"436",11,3,83,26,17756886,17761604,4718
"448",11,5,49,27,17764910,17771434,6524
"467",11,1,129,28,17778518,17782190,3672
"474",11,1,63,29,17785662,17789374,3712
"488",11,1,69,30,17792680,17796118,3438
"496",11,2,40,31,17799544,17804255,4711
"516",11,4,36,32,17810393,17813872,3479
"537",11,2,46,33,17820462,17824528,4066
"559",11,6,86,34,17830632,17834218,3586
"565",11,4,132,35,17837356,17842121,4765
"577",11,6,128,36,17845726,17851904,6178
"586",11,2,100,37,17855030,17859481,4451
"599",11,6,122,38,17862434,17866472,4038
"607",11,5,103,39,17869398,17874263,4865
"618",11,4,78,40,17877428,17880514,3086
"6210",11,3,71,41,17884432,17888644,4212
"638",11,3,131,42,17892369,17896694,4325
"648",11,5,73,43,17901160,17906757,5597
"658",11,3,113,44,17909836,17913668,3832
"668",11,5,25,45,17917087,17921465,4378
"686",11,5,121,46,17927890,17931882,3992
"698",11,2,70,47,17935400,17939938,4538
"707",11,5,31,48,17944050,17947789,3739
"729",11,6,26,49,17954233,17959105,4872
"746",11,6,50,50,17965356,17969168,3812
"768",11,3,65,51,17975239,17978704,3465
"775",11,4,30,52,17981650,17985035,3385
"798",11,5,13,53,17990986,17994765,3779
"818",11,4,90,54,18000576,18005774,5198
"828",11,3,77,55,18009219,18013258,4039
"837",11,6,110,56,18016417,18020102,3685
"847",11,3,47,57,18022961,18027779,4818
"867",11,3,11,58,18033697,18037796,4099
"888",11,3,53,59,18044613,18049698,5085
"908",11,5,37,60,18056469,18060687,4218
"928",11,2,10,61,18067118,18071377,4259
"946",11,4,66,62,18077174,18081126,3952
"956",11,1,15,63,18084758,18088963,4205
"975",11,3,107,64,18094888,18099433,4545
"987",11,2,106,65,18102425,18106883,4458
"996",11,4,60,66,18166601,18171259,4658
"10010",11,5,109,67,18174245,18179163,4918
"10110",11,3,17,68,18182502,18187000,4498
"1039",11,5,55,69,18192305,18196230,3925
"1045",11,2,4,70,18199169,18203135,3966
"1068",11,1,39,71,18208559,18212651,4092
"1087",11,5,7,72,18218522,18223127,4605
"1106",11,4,138,73,18229412,18233583,4171
"11110",11,2,118,74,18236736,18240947,4211
"1129",11,5,61,75,18243980,18248624,4644
"1136",11,1,57,76,18251583,18255322,3739
"1146",11,6,38,77,18257981,18261540,3559
"1167",11,6,104,78,18266924,18271389,4465
"1178",11,1,3,79,18274535,18278293,3758
"1196",11,3,125,80,18285017,18289076,4059
"1208",11,1,9,81,18292208,18298412,6204
"1228",11,4,108,82,18304990,18309802,4812
"1236",11,5,67,83,18312607,18316966,4359
"1248",11,5,127,84,18319865,18324357,4492
"1256",11,2,22,85,18327428,18332713,5285
"1275",11,2,94,86,18339104,18343709,4605
"1288",11,6,80,87,18347794,18353732,5938
"1298",11,6,8,88,18356951,18360677,3726
"13113",11,4,96,89,18366574,18371132,4558
"1328",11,6,116,90,18374158,18381435,7277
"1338",11,3,5,91,18384547,18389332,4785
"1358",11,2,16,92,18396223,18400335,4112
"1375",11,6,2,93,18406459,18410385,3926
"1397",11,6,62,94,18417575,18423566,5991
"1409",11,6,32,95,18426878,18433556,6678
"1427",11,2,112,96,18439254,18445292,6038
"1439",11,3,101,97,18448484,18455661,7177
"1445",11,4,6,98,18458613,18464045,5432
"1468",11,5,43,99,18470369,18474668,4299
"1487",11,5,115,100,18481085,18485630,4545
"1499",11,5,19,101,18489422,18493747,4325
"15111",11,2,76,102,18501518,18505723,4205
"1527",11,3,59,103,18509075,18515805,6730
"1537",11,3,95,104,18519031,18523329,4298
"1547",11,2,64,105,18526268,18532606,6338
"1556",11,6,68,106,18536804,18541036,4232
"1567",11,2,82,107,18544535,18549806,5271
"1579",11,2,58,108,18552825,18556517,3692
"1586",11,4,42,109,18559590,18563821,4231
"1609",11,3,137,110,18571298,18575437,4139
"16111",11,6,44,111,18578489,18582188,3699
"16310",11,6,20,112,18588159,18593184,5025
"1657",11,2,52,113,18598981,18602260,3279
"1678",11,2,124,114,18608251,18612183,3932
"1688",11,3,41,115,18615136,18622513,7377
"1708",11,5,79,116,18630397,18635794,5397
"17111",11,3,23,117,18638707,18644091,5384
"1736",11,2,28,118,18650529,18655860,5331
"1756",11,4,12,119,18662098,18665284,3186
"1778",11,1,117,120,18670895,18674121,3226
"1786",11,4,114,121,18676986,18680871,3885
"1798",11,5,133,122,18684390,18687216,2826
"1807",11,3,89,123,18690748,18695293,4545
"18112",11,3,29,124,18698251,18702377,4126
"1837",11,1,135,125,18708721,18713972,5251
"1846",11,4,24,126,18716971,18720883,3912
"1866",11,6,74,127,18727148,18731532,4384
"1878",11,1,99,128,18734671,18738271,3600
"1888",11,4,18,129,18741122,18744801,3679
"1907",11,5,97,130,18753484,18757510,4026
"19112",11,3,35,131,18760615,18765587,4972
"1937",11,1,33,132,18772317,18775703,3386
"1956",11,1,51,133,18782694,18786499,3805
"1978",11,5,91,134,18792723,18796142,3419
"1986",11,2,88,135,18799141,18802879,3738
"1997",11,1,123,136,18806032,18809464,3432
"2008",11,4,102,137,18813522,18817201,3679
"2019",11,6,92,138,18820193,18823905,3712
"1020",12,5,114,1,19828514,19831999,3485
"1130",12,5,78,2,19835351,19837623,2272
"1229",12,4,125,3,19840709,19843915,3206
"1329",12,6,7,4,19846820,19849779,2959
"1528",12,1,86,5,19857037,19859349,2312
"1625",12,3,82,6,19862121,19865327,3206
"1729",12,4,35,7,19868466,19872971,4505
"1930",12,4,5,8,19879448,19882727,3279
"218",12,1,50,9,19889304,19892543,3239
"235",12,5,102,10,19897821,19901167,3346
"2411",12,2,69,11,19903946,19906738,2792
"257",12,3,112,12,19910017,19912536,2519
"2610",12,4,101,13,19915275,19919047,3772
"279",12,5,60,14,19922592,19926097,3505
"286",12,4,137,15,19929190,19931615,2425
"299",12,6,25,16,19934501,19938060,3559
"315",12,6,103,17,19944131,19948196,4065
"328",12,3,58,18,19951422,19954827,3405
"3310",12,2,117,19,19958912,19961758,2846
"347",12,6,97,20,19964557,19967036,2479
"359",12,4,47,21,19969881,19972867,2986
"377",12,6,115,22,19978398,19981157,2759
"387",12,1,26,23,19984003,19987042,3039
"408",12,5,66,24,19993193,19996991,3798
"4110",12,5,30,25,19999757,20002589,2832
"437",12,3,16,26,20008507,20011486,2979
"455",12,1,98,27,20019456,20022915,3459
"468",12,1,128,28,20026054,20029519,3465
"475",12,5,126,29,20032545,20035130,2585
"489",12,2,33,30,20038083,20040475,2392
"507",12,5,18,31,20046460,20048405,1945
"529",12,6,127,32,20053624,20055849,2225
"538",12,2,123,33,20058782,20062607,3825
"547",12,3,94,34,20065852,20068659,2807
"5510",12,2,39,35,20071883,20075176,3293
"578",12,5,36,36,20081467,20083966,2499
"5910",12,2,57,37,20091496,20094922,3426
"608",12,2,63,38,20097921,20099893,1972
"619",12,4,77,39,20103066,20105658,2592
"6211",12,2,21,40,20108444,20110689,2245
"649",12,5,132,41,20116607,20120272,3665
"659",12,5,6,42,20123471,20126217,2746
"677",12,3,88,43,20132894,20136007,3113
"687",12,2,75,44,20138719,20141918,3199
"699",12,4,71,45,20144657,20146456,1799
"708",12,1,32,46,20149528,20151800,2272
"7210",12,1,74,47,20158212,20161037,2825
"735",12,3,124,48,20164496,20166822,2326
"747",12,3,22,49,20170267,20172820,2553
"769",12,6,61,50,20179670,20183409,3739
"776",12,5,120,51,20186628,20188953,2325
"787",12,4,83,52,20193279,20197017,3738
"799",12,1,56,53,20200669,20204002,3333
"807",12,1,62,54,20207307,20209806,2499
"819",12,2,9,55,20213038,20215557,2519
"838",12,6,55,56,20223114,20225333,2219
"848",12,2,135,57,20228432,20232437,4005
"856",12,2,87,58,20235936,20239588,3652
"868",12,2,129,59,20243334,20245459,2125
"877",12,4,65,60,20248425,20250891,2466
"889",12,1,122,61,20253536,20255322,1786
"895",12,1,8,62,20258381,20260747,2366
"916",12,6,133,63,20268024,20270984,2960
"929",12,3,64,64,20273862,20276554,2692
"938",12,5,24,65,20280047,20282786,2739
"957",12,3,76,66,20336759,20339991,3232
"966",12,1,14,67,20343163,20346449,3286
"988",12,4,119,68,20353393,20356505,3112
"997",12,1,38,69,20359484,20362510,3026
"10111",12,4,41,70,20367674,20370773,3099
"10310",12,6,85,71,20376245,20378803,2558
"1046",12,5,48,72,20381476,20382995,1519
"1069",12,1,80,73,20389213,20391572,2359
"1077",12,3,130,74,20394464,20397336,2872
"1088",12,2,15,75,20400375,20401941,1566
"1107",12,2,51,76,20407073,20409639,2566
"11210",12,1,92,77,20415157,20417849,2692
"1137",12,2,45,78,20420482,20422854,2372
"1159",12,4,95,79,20428592,20431391,2799
"1168",12,3,4,80,20434383,20436769,2386
"11810",12,6,37,81,20442040,20445232,3192
"1209",12,4,53,82,20451531,20454322,2791
"12210",12,4,11,83,20459500,20462139,2639
"1249",12,6,43,84,20467204,20469083,1879
"1267",12,6,79,85,20475388,20478040,2652
"1276",12,4,23,86,20480679,20482705,2026
"1299",12,4,59,87,20488096,20490855,2759
"1305",12,2,3,88,20493781,20497893,4112
"13210",12,1,68,89,20504210,20507396,3186
"1339",12,3,118,90,20510442,20514953,4511
"1347",12,6,13,91,20518119,20521891,3772
"1367",12,3,52,92,20527449,20531021,3572
"1387",12,6,49,93,20536425,20539671,3246
"14010",12,5,72,94,20544376,20547201,2825
"14112",12,3,70,95,20550287,20553412,3125
"1428",12,1,134,96,20556844,20559037,2193
"14310",12,5,96,97,20562063,20565448,3385
"1446",12,1,44,98,20568194,20570146,1952
"1469",12,6,73,99,20575557,20578630,3073
"1477",12,6,19,100,20581695,20583934,2239
"14910",12,5,108,101,20589719,20592751,3032
"1507",12,3,106,102,20595463,20597129,1666
"15112",12,6,67,103,20599842,20601628,1786
"1529",12,5,42,104,20604600,20607252,2652
"1548",12,4,131,105,20614243,20616382,2139
"1557",12,6,31,106,20619661,20622433,2772
"15710",12,5,12,107,20629857,20633110,3253
"1597",12,2,99,108,20638934,20641493,2559
"16010",12,3,34,109,20644519,20646764,2245
"1626",12,2,105,110,20652689,20655335,2646
"16311",12,4,17,111,20658480,20661899,3419
"1658",12,5,54,112,20666924,20669169,2245
"1679",12,3,100,113,20675860,20678979,3119
"1689",12,3,28,114,20681865,20684630,2765
"1709",12,3,136,115,20690055,20692341,2286
"17112",12,3,40,116,20695333,20698626,3293
"1737",12,2,93,117,20704557,20707489,2932
"1747",12,5,84,118,20710401,20713993,3592
"1757",12,6,91,119,20717698,20720091,2393
"1768",12,1,2,120,20723016,20725589,2573
"1787",12,1,116,121,20732326,20734752,2426
"1799",12,4,89,122,20737871,20741230,3359
"1808",12,3,46,123,20744228,20747321,3093
"1827",12,4,29,124,20754218,20757010,2792
"1847",12,6,1,125,20762442,20764781,2339
"1867",12,5,138,126,20771512,20773831,2319
"1879",12,1,20,127,20776743,20778616,1873
"1897",12,5,90,128,20785533,20788172,2639
"1908",12,2,81,129,20791558,20793990,2432
"19113",12,6,109,130,20796842,20799621,2779
"19210",12,3,10,131,20802554,20806106,3552
"1946",12,1,110,132,20812083,20814169,2086
"1957",12,2,111,133,20817215,20819934,2719
"1968",12,4,113,134,20823466,20825512,2046
"1979",12,2,27,135,20828378,20831876,3498
"1998",12,1,104,136,20838307,20840946,2639
"2009",12,6,121,137,20843832,20846490,2658
"20110",12,4,107,138,20850549,20853735,3186
"1030",13,6,24,1,22318127,22321399,3272
"1230",13,5,125,2,22330282,22334401,4119
"1330",13,6,78,3,22337386,22340825,3439
"1429",13,5,5,4,22344091,22347190,3099
"1627",13,6,108,5,22353620,22356859,3239
"1730",13,3,123,6,22359759,22363044,3285
"1828",13,4,40,7,22366269,22369981,3712
"206",13,5,89,8,22376905,22379931,3026
"219",13,4,46,9,22383296,22386255,2959
"236",13,3,21,10,22393639,22396851,3212
"258",13,6,138,11,22403455,22407061,3606
"2611",13,6,6,12,22410000,22412832,2832
"287",13,5,11,13,22418816,22421482,2666
"309",13,5,107,14,22429179,22432658,3479
"316",13,1,55,15,22435777,22438556,2779
"329",13,4,16,16,22441521,22444913,3392
"348",13,6,36,17,22451331,22454057,2726
"368",13,3,45,18,22461081,22464033,2952
"388",13,3,99,19,22470671,22474123,3452
"3910",13,6,42,20,22476968,22479954,2986
"4111",13,2,8,21,22490897,22493942,3045
"438",13,5,65,22,22500326,22502938,2612
"449",13,4,4,23,22506224,22509749,3525
"469",13,2,32,24,22516001,22519213,3212
"4810",13,1,91,25,22525943,22528849,2906
"497",13,1,127,26,22531961,22534920,2959
"508",13,6,126,27,22537706,22540805,3099
"517",13,2,56,28,22544210,22547329,3119
"5210",13,4,106,29,22549975,22552667,2692
"539",13,6,132,30,22555473,22558458,2985
"548",13,2,98,31,22561217,22564150,2933
"5511",13,3,105,32,22566922,22569754,2832
"566",13,5,53,33,22572499,22575538,3039
"587",13,2,104,34,22582223,22585661,3438
"5911",13,4,118,35,22588787,22592066,3279
"609",13,1,13,36,22594998,22598184,3186
"6212",13,1,73,37,22604754,22607993,3239
"639",13,3,69,38,22611025,22614084,3059
"6410",13,2,20,39,22617103,22619822,2719
"669",13,2,92,40,22627879,22631405,3526
"678",13,2,116,41,22634357,22637389,3032
"688",13,2,68,42,22640415,22643927,3512
"6910",13,4,136,43,22646512,22649798,3286
"709",13,5,41,44,22653030,22655775,2745
"7211",13,6,18,45,22662380,22665299,2919
"748",13,3,81,46,22671643,22674549,2906
"759",13,5,23,47,22677174,22679580,2406
"777",13,4,76,48,22685445,22688137,2692
"788",13,4,100,49,22691209,22694048,2839
"7910",13,6,120,50,22697000,22700079,3079
"808",13,3,51,51,22703371,22705990,2619
"829",13,1,19,52,22712248,22715414,3166
"849",13,2,86,53,22723517,22726416,2899
"857",13,5,83,54,22729195,22732107,2912
"869",13,3,15,55,22734746,22737225,2479
"8810",13,2,128,56,22744403,22747775,3372
"896",13,1,121,57,22751001,22754313,3312
"909",13,4,70,58,22757545,22757591,46
"917",13,3,75,59,22760197,22765601,5404
"9210",13,6,66,60,22768720,22772326,3606
"939",13,3,111,61,22775625,22779736,4111
"947",13,5,113,62,22782982,22785967,2985
"958",13,4,64,63,22789386,22792552,3166
"967",13,3,63,64,22795764,22798749,2985
"976",13,3,117,65,22801662,22803881,2219
"989",13,1,79,66,22895927,22899839,3912
"998",13,1,31,67,22902971,22906483,3512
"10112",13,3,27,68,22918665,22923370,4705
"10311",13,5,137,69,22929541,22932373,2832
"1047",13,5,101,70,22935172,22937985,2813
"1058",13,4,52,71,22940704,22943289,2585
"1078",13,3,39,72,22950587,22953286,2699
"1097",13,2,26,73,22960756,22964095,3339
"11111",13,4,94,74,22971859,22975178,3319
"11211",13,4,34,75,22978085,22980902,2817
"1147",13,1,109,76,22988633,22991411,2778
"11510",13,2,134,77,22994451,22997229,2778
"1169",13,3,33,78,22999842,23002581,2739
"11811",13,2,2,79,23009045,23012097,3052
"12010",13,6,90,80,23018702,23021207,2505
"12111",13,1,61,81,23024140,23027732,3592
"12211",13,3,87,82,23030764,23033716,2952
"1237",13,1,7,83,23036668,23040067,3399
"1257",13,1,67,84,23047077,23049457,2380
"1268",13,1,43,85,23052276,23054755,2479
"1289",13,6,96,86,23060772,23063918,3146
"12910",13,5,131,87,23067257,23070163,2906
"1306",13,4,10,88,23072955,23075841,2886
"13211",13,6,114,89,23082971,23085837,2866
"13310",13,5,77,90,23088737,23091008,2271
"1348",13,4,28,91,23094200,23096666,2466
"1368",13,1,25,92,23104450,23107355,2905
"1388",13,1,49,93,23114313,23117558,3245
"14011",13,5,35,94,23123710,23126348,2638
"14210",13,6,54,95,23133792,23136638,2846
"1447",13,6,30,96,23143202,23145854,2652
"14610",13,2,62,97,23152186,23154924,2738
"1478",13,5,29,98,23158030,23160602,2572
"14911",13,4,82,99,23167513,23170179,2666
"1508",13,3,9,100,23173184,23176483,3299
"15210",13,2,14,101,23183947,23188025,4078
"1549",13,4,124,102,23197529,23199961,2432
"1558",13,4,58,103,23202734,23205766,3032
"1568",13,1,103,104,23208612,23211344,2732
"15711",13,2,80,105,23214016,23216901,2885
"1587",13,1,85,106,23219781,23222813,3032
"1598",13,2,50,107,23225672,23228284,2612
"16112",13,1,97,108,23234602,23237474,2872
"1628",13,1,133,109,23240400,23243312,2912
"16312",13,6,84,110,23246131,23248770,2639
"1646",13,2,110,111,23251629,23254148,2519
"1659",13,4,22,112,23257260,23260232,2972
"16710",13,6,72,113,23266290,23268642,2352
"16810",13,5,119,114,23271675,23274680,3005
"16910",13,3,57,115,23277753,23280672,2919
"17010",13,4,112,116,23284130,23286796,2666
"17113",13,5,47,117,23289588,23292074,2486
"1738",13,1,37,118,23298098,23301150,3052
"1758",13,5,59,119,23309134,23312180,3046
"1769",13,6,48,120,23315625,23317917,2292
"1788",13,2,44,121,23324888,23327361,2473
"1809",13,2,74,122,23333525,23336211,2686
"18113",13,1,1,123,23338950,23341529,2579
"1838",13,6,12,124,23348033,23350752,2719
"1858",13,5,71,125,23357996,23360508,2512
"1868",13,3,3,126,23363907,23367113,3206
"1889",13,6,60,127,23375083,23378255,3172
"1898",13,4,88,128,23381261,23384053,2792
"1909",13,4,130,129,23386845,23389698,2853
"19114",13,3,135,130,23392530,23395556,3026
"19211",13,3,129,131,23398548,23400793,2245
"1938",13,1,115,132,23403519,23406371,2852
"1947",13,5,95,133,23409464,23412409,2945
"1958",13,2,38,134,23415402,23418067,2665
"19710",13,3,93,135,23424791,23427450,2659
"1987",13,5,17,136,23431063,23434275,3212
"20010",13,2,122,137,23441625,23443971,2346
"20111",13,6,102,138,23447077,23449776,2699
"1040",14,3,26,1,24758438,24761364,2926
"1238",14,3,128,2,24767062,24770873,3811
"1340",14,3,110,3,24774539,24776571,2032
"1430",14,4,39,4,24779917,24782856,2939
"1629",14,5,34,5,24788381,24791379,2998
"1829",14,3,50,6,24797784,24800236,2452
"207",14,2,109,7,24805901,24808520,2619
"2110",14,4,111,8,24811266,24814964,3698
"229",14,6,107,9,24818429,24821908,3479
"237",14,2,1,10,24825274,24827706,2432
"259",14,1,72,11,24833124,24835690,2566
"2612",14,3,92,12,24838822,24842440,3618
"2710",14,2,121,13,24845733,24848532,2799
"288",14,4,123,14,24851644,24855929,4285
"2910",14,4,87,15,24858941,24862127,3186
"3010",14,2,97,16,24864965,24867405,2440
"317",14,6,131,17,24870224,24872569,2345
"3210",14,6,71,18,24875842,24877841,1999
"3311",14,1,108,19,24880973,24882892,1919
"349",14,3,44,20,24886311,24888337,2026
"369",14,3,14,21,24894601,24898160,3559
"389",14,5,136,22,24903918,24906584,2666
"3911",14,6,35,23,24909622,24912108,2486
"4112",14,2,25,24,24918259,24920605,2346
"439",14,2,13,25,24927909,24931114,3205
"456",14,4,129,26,24937172,24941684,4512
"4610",14,6,53,27,24944703,24947388,2685
"4811",14,3,2,28,24952600,24954906,2306
"509",14,1,96,29,24960790,24963156,2366
"518",14,2,49,30,24966908,24968954,2046
"5310",14,1,84,31,24974059,24976658,2599
"549",14,4,81,32,24979550,24982042,2492
"5512",14,5,82,33,24984888,24987047,2159
"567",14,1,12,34,24989966,24991945,1979
"588",14,3,74,35,24997817,25000155,2338
"5912",14,1,90,36,25003681,25005814,2133
"6010",14,6,83,37,25009372,25012691,3319
"6110",14,5,52,38,25016629,25019668,3039
"6310",14,6,113,39,25024887,25027905,3018
"6411",14,3,104,40,25031117,25033923,2806
"6510",14,4,45,41,25036882,25039568,2686
"679",14,1,36,42,25044919,25046712,1793
"6911",14,6,65,43,25052216,25054982,2766
"7010",14,4,99,44,25058168,25061380,3212
"718",14,4,21,45,25064405,25067124,2719
"736",14,3,62,46,25072849,25075361,2512
"749",14,1,114,47,25078027,25080799,2772
"7510",14,1,30,48,25083625,25085571,1946
"778",14,5,100,49,25091089,25093594,2505
"789",14,3,32,50,25097580,25100159,2579
"809",14,6,119,51,25106950,25110395,3445
"8110",14,5,28,52,25113140,25115733,2593
"839",14,6,29,53,25122024,25125063,3039
"858",14,2,103,54,25130814,25133506,2692
"8610",14,3,56,55,25136152,25138678,2526
"878",14,1,24,56,25141357,25144082,2725
"897",14,5,16,57,25149927,25152706,2779
"918",14,2,79,58,25158644,25161089,2445
"9211",14,6,11,59,25164222,25166594,2372
"948",14,4,69,60,25173585,25175737,2152
"959",14,5,10,61,25179263,25182761,3498
"977",14,5,40,62,25189506,25192718,3212
"999",14,2,127,63,25199542,25202574,3032
"10011",14,4,27,64,25205433,25208199,2766
"10210",14,6,23,65,25213883,25216169,2286
"1048",14,6,5,66,25299178,25301671,2493
"10610",14,2,133,67,25307682,25309821,2139
"1079",14,3,86,68,25312567,25314393,1826
"1089",14,2,43,69,25317339,25318918,1579
"1108",14,4,105,70,25324102,25327135,3033
"11112",14,5,58,71,25330087,25332913,2826
"11212",14,5,4,72,25335785,25338204,2419
"1148",14,1,42,73,25343356,25345075,1719
"11610",14,4,117,74,25352239,25354711,2472
"1179",14,4,15,75,25357644,25359463,1819
"1197",14,1,6,76,25365274,25367500,2226
"12112",14,4,57,77,25373364,25375943,2579
"12212",14,3,38,78,25378876,25381275,2399
"12410",14,3,8,79,25387626,25390085,2459
"1269",14,5,64,80,25395443,25398522,3079
"1277",14,4,9,81,25401561,25404673,3112
"12911",14,5,118,82,25417015,25419407,2392
"1307",14,5,70,83,25422793,25425918,3125
"13114",14,6,137,84,25429217,25431103,1886
"13212",14,2,85,85,25434189,25436921,2732
"13311",14,6,17,86,25440086,25442039,1953
"1359",14,3,116,87,25449096,25452562,3466
"1369",14,5,88,88,25457240,25459292,2052
"1376",14,1,48,89,25462338,25463884,1546
"1398",14,3,20,90,25470369,25472767,2398
"14113",14,1,132,91,25481145,25483597,2452
"14211",14,2,91,92,25486642,25488535,1893
"14311",14,2,7,93,25491547,25493613,2066
"1458",14,6,77,94,25500244,25502617,2373
"14611",14,4,33,95,25506182,25509854,3672
"1488",14,6,125,96,25516265,25518524,2259
"14912",14,6,89,97,25521603,25525834,4231
"1509",14,6,101,98,25528787,25531432,2645
"15113",14,2,73,99,25534338,25536484,2146
"15211",14,1,60,100,25539343,25542122,2779
"1538",14,6,59,101,25545194,25548180,2986
"15410",14,5,124,102,25551705,25554377,2672
"1559",14,1,120,103,25558263,25560089,1826
"1569",14,2,115,104,25563381,25566393,3012
"15712",14,4,135,105,25569618,25573470,3852
"1588",14,2,61,106,25576483,25578995,2512
"1599",14,1,126,107,25581881,25583940,2059
"16011",14,3,122,108,25586685,25588838,2153
"16113",14,4,3,109,25591890,25596049,4159
"16313",14,3,134,110,25603699,25605892,2193
"1647",14,1,138,111,25609004,25611070,2066
"16510",14,5,94,112,25613929,25616688,2759
"1664",14,3,68,113,25619593,25621906,2313
"16711",14,6,95,114,25624518,25627650,3132
"16811",14,2,55,115,25630702,25632428,1726
"16911",14,5,106,116,25635354,25637653,2299
"17011",14,1,78,117,25641772,25644044,2272
"17114",14,5,46,118,25647423,25649915,2492
"1739",14,5,112,119,25657999,25660305,2306
"1748",14,3,98,120,25663531,25665723,2192
"1759",14,1,54,121,25668582,25670628,2046
"1779",14,2,37,122,25676919,25679224,2305
"17910",14,3,80,123,25686342,25689088,2746
"18010",14,5,130,124,25692266,25694652,2386
"18114",14,6,47,125,25697418,25700530,3112
"1839",14,4,93,126,25706501,25708800,2299
"1848",14,4,75,127,25711773,25714512,2739
"1859",14,5,22,128,25717484,25720356,2872
"18710",14,4,51,129,25728946,25731312,2366
"1899",14,2,19,130,25736803,25738662,1859
"19115",14,2,67,131,25748172,25750012,1840
"19212",14,2,31,132,25752904,25755123,2219
"1948",14,4,63,133,25761887,25763940,2053
"1959",14,1,66,134,25766805,25769138,2333
"1969",14,6,41,135,25772637,25775049,2412
"1988",14,5,76,136,25782213,25785372,3159
"1999",14,1,102,137,25788491,25790643,2152
"20011",14,1,18,138,25793629,25796108,2479
"1049",15,5,57,1,26866319,26869571,3252
"1138",15,4,116,2,26872377,26876236,3859
"1239",15,2,54,3,26879095,26882327,3232
"1440",15,4,98,4,26888178,26891690,3512
"1530",15,1,77,5,26894562,26898281,3719
"1630",15,3,133,6,26901060,26904232,3172
"1740",15,1,107,7,26907171,26910736,3565
"1830",15,2,138,8,26913722,26917780,4058
"1939",15,3,55,9,26920399,26924058,3659
"208",15,5,111,10,26927023,26930842,3819
"2111",15,1,89,11,26933601,26937586,3985
"2210",15,3,103,12,26940345,26946816,6471
"238",15,3,121,13,26949908,26952741,2833
"2412",15,5,3,14,26955679,26959738,4059
"2613",15,1,119,15,26965843,26969954,4111
"2711",15,5,129,16,26973000,26976159,3159
"289",15,4,92,17,26979184,26984322,5138
"2911",15,3,67,18,26987348,26991306,3958
"3011",15,5,93,19,26993979,26997251,3272
"318",15,2,12,20,27000223,27004328,4105
"3312",15,3,1,21,27010339,27013398,3059
"3510",15,1,113,22,27018496,27021675,3179
"3610",15,1,29,23,27024421,27027380,2959
"3810",15,6,22,24,27032558,27036603,4045
"409",15,2,90,25,27042781,27046259,3478
"4113",15,4,8,26,27049678,27053830,4152
"4310",15,4,104,27,27059208,27062720,3512
"4410",15,6,34,28,27065772,27069338,3566
"4611",15,3,73,29,27074669,27080340,5671
"476",15,5,21,30,27083272,27087437,4165
"498",15,1,125,31,27092929,27097793,4864
"5010",15,5,45,32,27101159,27104238,3079
"5211",15,4,68,33,27109323,27113681,4358
"5311",15,6,112,34,27116460,27119945,3485
"5410",15,6,88,35,27122784,27126496,3712
"5513",15,1,53,36,27129655,27134027,4372
"579",15,2,72,37,27139372,27142884,3512
"589",15,3,91,38,27147302,27150394,3092
"5913",15,4,32,39,27153180,27156872,3692
"6111",15,5,105,40,27162203,27166282,4079
"6213",15,1,5,41,27169607,27172099,2492
"6412",15,2,96,42,27177837,27182176,4339
"6511",15,1,17,43,27185581,27188927,3346
"6710",15,4,56,44,27194345,27199576,5231
"689",15,6,46,45,27202935,27207753,4818
"7011",15,6,58,46,27214050,27217909,3859
"719",15,5,9,47,27220961,27224960,3999
"737",15,1,65,48,27230731,27232817,2086
"7410",15,5,75,49,27235563,27238388,2825
"7511",15,1,95,50,27241307,27244946,3639
"7610",15,3,25,51,27248191,27251717,3526
"7810",15,4,62,52,27256635,27259047,2412
"7911",15,6,76,53,27261840,27266391,4551
"8010",15,5,51,54,27269257,27272209,2952
"8210",15,2,114,55,27277527,27281432,3905
"8310",15,3,13,56,27284385,27289916,5531
"859",15,6,64,57,27295381,27299266,3885
"8611",15,4,26,58,27303031,27306930,3899
"8811",15,4,134,59,27312447,27315647,3200
"898",15,4,2,60,27318919,27321977,3058
"919",15,6,94,61,27327742,27330701,2959
"9212",15,4,14,62,27333593,27337325,3732
"949",15,3,79,63,27342470,27344542,2072
"9510",15,6,118,64,27347442,27351460,4018
"968",15,5,87,65,27354406,27358084,3678
"978",15,4,128,66,27385834,27389752,3918
"9810",15,2,60,67,27392971,27397463,4492
"9910",15,5,63,68,27400375,27403014,2639
"10012",15,6,82,69,27406366,27409552,3186
"10113",15,1,41,70,27412258,27415663,3405
"10312",15,1,35,71,27422654,27425359,2705
"1059",15,4,20,72,27431797,27435102,3305
"10710",15,4,110,73,27440520,27442679,2159
"10810",15,5,15,74,27445359,27447737,2378
"1109",15,6,28,75,27453016,27455968,2952
"11213",15,6,124,76,27461539,27464265,2726
"1139",15,1,71,77,27466984,27469584,2600
"1149",15,6,40,78,27472575,27476940,4365
"11611",15,4,86,79,27482898,27485310,2412
"11710",15,5,99,80,27488856,27493127,4271
"11812",15,5,27,81,27495893,27498772,2879
"12011",15,2,102,82,27504263,27506043,1780
"12113",15,6,4,83,27509188,27511761,2573
"12310",15,3,7,84,27516999,27521270,4271
"1258",15,3,31,85,27528188,27533406,5218
"1278",15,2,48,86,27538884,27540457,1573
"12912",15,3,85,87,27546268,27551379,5111
"1308",15,4,50,88,27554292,27556344,2052
"13213",15,5,81,89,27561702,27566594,4892
"13312",15,1,137,90,27569480,27572412,2932
"1349",15,2,126,91,27575404,27578089,2685
"13510",15,5,33,92,27580975,27584047,3072
"1377",15,5,39,93,27589859,27593011,3152
"1399",15,6,10,94,27598456,27602061,3605
"14114",15,2,132,95,27607672,27611917,4245
"14212",15,6,70,96,27615256,27618268,3012
"14312",15,2,78,97,27620980,27625192,4212
"1448",15,6,130,98,27627984,27631970,3986
"1459",15,4,122,99,27635695,27637907,2212
"14612",15,2,84,100,27640607,27643392,2785
"1479",15,4,38,101,27645891,27648670,2779
"14913",15,6,16,102,27654155,27657214,3059
"15114",15,3,97,103,27662705,27665097,2392
"15212",15,2,108,104,27668043,27671215,3172
"1539",15,3,43,105,27673968,27677879,3911
"15510",15,4,80,106,27684530,27687343,2813
"15610",15,4,74,107,27690162,27693607,3445
"15713",15,2,36,108,27696346,27699165,2819
"15910",15,2,18,109,27705183,27709488,4305
"16114",15,3,49,110,27714832,27717005,2173
"16314",15,5,117,111,27721943,27724389,2446
"1648",15,6,100,112,27727068,27730260,3192
"16511",15,4,44,113,27733039,27735685,2646
"16712",15,1,131,114,27740723,27744315,3592
"16812",15,1,11,115,27747414,27749673,2259
"17012",15,3,19,116,27755104,27757357,2253
"17210",15,1,23,117,27763208,27766347,3139
"1749",15,2,42,118,27771198,27775204,4006
"17610",15,3,37,119,27781315,27784633,3318
"1789",15,2,6,120,27789471,27793110,3639
"18011",15,2,120,121,27798941,27802534,3593
"18115",15,3,61,122,27805292,27810197,4905
"18210",15,6,52,123,27813249,27816302,3053
"1849",15,2,24,124,27821380,27825851,4471
"1869",15,5,123,125,27834295,27838873,4578
"18711",15,5,69,126,27842692,27845924,3232
"18810",15,1,59,127,27849170,27852362,3192
"18910",15,3,115,128,27855487,27857906,2419
"19010",15,6,136,129,27860879,27863964,3085
"19116",15,1,101,130,27866597,27869309,2712
"19213",15,3,109,131,27872241,27875933,3692
"19310",15,1,47,132,27879220,27881478,2258
"19510",15,2,30,133,27887002,27888881,1879
"19711",15,1,83,134,27893946,27897052,3106
"1989",15,2,66,135,27899871,27903083,3212
"19910",15,6,106,136,27905749,27909907,4158
"20012",15,5,135,137,27913512,27917424,3912
"20112",15,3,127,138,27925581,27928700,3119
"1050",16,4,73,1,29253245,29258743,5498
"1140",16,3,54,2,29262121,29266993,4872
"1350",16,5,98,3,29275144,29282620,7476
"1449",16,4,61,4,29285879,29290724,4845
"1540",16,1,10,5,29294116,29298668,4552
"1750",16,3,84,6,29304879,29309830,4951
"1840",16,5,74,7,29313363,29318880,5517
"1940",16,4,67,8,29322106,29325618,3512
"209",16,6,123,9,29328690,29333488,4798
"2112",16,4,121,10,29336374,29340512,4138
"2211",16,4,13,11,29343705,29348116,4411
"2413",16,1,112,12,29353981,29357640,3659
"2510",16,2,83,13,29360792,29365563,4771
"2614",16,1,106,14,29368555,29372094,3539
"2712",16,1,76,15,29374980,29380044,5064
"2810",16,5,68,16,29383290,29388488,5198
"2912",16,5,38,17,29391640,29395912,4272
"319",16,3,96,18,29401956,29406674,4718
"3211",16,2,77,19,29410140,29414871,4731
"3313",16,5,86,20,29418130,29421862,3732
"3410",16,6,3,21,29425075,29429333,4258
"3611",16,3,42,22,29434864,29440016,5152
"3811",16,5,20,23,29445940,29449705,3765
"4010",16,3,114,24,29456430,29462347,5917
"4114",16,2,113,25,29465606,29470438,4832
"429",16,2,95,26,29473557,29478615,5058
"4311",16,6,15,27,29481640,29484699,3059
"457",16,6,27,28,29490237,29494636,4399
"477",16,2,47,29,29500167,29504239,4072
"499",16,3,90,30,29510216,29514995,4779
"5011",16,2,101,31,29518073,29522885,4812
"519",16,3,108,32,29525884,29531095,5211
"5212",16,1,46,33,29534427,29538573,4146
"5411",16,5,110,34,29544511,29548289,3778
"5514",16,3,138,35,29551741,29556626,4885
"568",16,2,23,36,29559851,29564097,4246
"5810",16,1,64,37,29570008,29575199,5191
"5914",16,2,89,38,29578238,29583629,5391
"6011",16,5,92,39,29587261,29592639,5378
"6112",16,5,116,40,29595778,29600510,4732
"6214",16,6,117,41,29603468,29606528,3060
"6311",16,5,56,42,29609426,29614098,4672
"6413",16,4,103,43,29617603,29621369,3766
"6512",16,2,137,44,29624548,29629692,5144
"6610",16,5,14,45,29633078,29637922,4844
"6810",16,4,109,46,29644680,29649005,4325
"6912",16,2,107,47,29652357,29656815,4458
"7012",16,1,40,48,29660308,29665492,5184
"7212",16,2,11,49,29671743,29676009,4266
"7411",16,4,55,50,29682393,29687511,5118
"7512",16,2,131,51,29690577,29694962,4385
"7611",16,3,120,52,29698027,29702479,4452
"779",16,6,93,53,29706097,29710409,4312
"7811",16,3,48,54,29713315,29716234,2919
"8011",16,6,135,55,29722611,29727823,5212
"8111",16,1,124,56,29730742,29735160,4418
"8211",16,2,53,57,29738665,29743497,4832
"8410",16,4,43,58,29749108,29752960,3852
"8612",16,5,32,59,29758645,29762403,3758
"8812",16,4,49,60,29768394,29772326,3932
"9010",16,5,134,61,29777911,29781523,3612
"9110",16,2,17,62,29784715,29789580,4865
"9310",16,3,60,63,29795184,29800449,5265
"9410",16,3,66,64,29803561,29806727,3166
"9511",16,6,105,65,29809826,29816903,7077
"969",16,6,45,66,29867544,29871296,3752
"9811",16,2,5,67,29877354,29881619,4265
"10013",16,1,58,68,29887557,29891702,4145
"10114",16,2,59,69,29894794,29899146,4352
"10211",16,2,65,70,29902085,29905444,3359
"10313",16,3,6,71,29908389,29913067,4678
"10510",16,3,30,72,29918705,29922591,3886
"10711",16,2,125,73,29928262,29931881,3619
"10811",16,3,72,74,29934613,29938351,3738
"1098",16,2,35,75,29941350,29944589,3239
"11113",16,4,1,76,29950581,29954665,4084
"11310",16,4,133,77,29960863,29963689,2826
"11410",16,2,41,78,29966754,29970806,4052
"11612",16,6,81,79,29976184,29980310,4126
"11711",16,2,119,80,29983315,29987207,3892
"11813",16,4,19,81,29990219,29994318,4099
"12012",16,1,94,82,30002255,30007906,5651
"12114",16,5,104,83,30011152,30014943,3791
"12213",16,1,118,84,30018422,30022181,3759
"12311",16,4,91,85,30025073,30029565,4492
"12411",16,1,4,86,30032724,30036475,3751
"12610",16,6,87,87,30042333,30046745,4412
"1279",16,6,63,88,30049564,30052629,3065
"12810",16,5,122,89,30055441,30057534,2093
"12913",16,4,127,90,30060480,30063199,2719
"1309",16,4,79,91,30066051,30070203,4152
"13115",16,5,128,92,30073102,30077680,4578
"13214",16,5,50,93,30080679,30084251,3572
"13410",16,6,9,94,30090049,30094774,4725
"13610",16,4,25,95,30100472,30103831,3359
"1389",16,4,97,96,30109315,30112514,3199
"13910",16,6,39,97,30115433,30119238,3805
"14115",16,1,82,98,30125063,30129388,4325
"14213",16,4,7,99,30132353,30137331,4978
"14410",16,6,51,100,30143809,30148094,4285
"14613",16,5,8,101,30153799,30158217,4418
"1489",16,4,85,102,30164614,30168540,3926
"14914",16,2,29,103,30171445,30175697,4252
"15115",16,6,57,104,30181582,30185967,4385
"15213",16,6,21,105,30189052,30191898,2846
"15411",16,6,69,106,30197629,30201541,3912
"15511",16,5,62,107,30204626,30209238,4612
"15611",16,3,24,108,30212344,30216989,4645
"1589",16,6,129,109,30224099,30229144,5045
"15911",16,6,99,110,30232436,30236948,4512
"16012",16,3,132,111,30240020,30244299,4279
"16115",16,5,2,112,30247231,30250929,3698
"16315",16,3,102,113,30257420,30260566,3146
"1649",16,1,100,114,30263598,30266957,3359
"16512",16,5,80,115,30270142,30274174,4032
"1665",16,3,126,116,30277459,30282691,5232
"16713",16,1,34,117,30285770,30289815,4045
"16912",16,4,37,118,30295580,30300764,5184
"17115",16,4,31,119,30306262,30310734,4472
"17310",16,5,44,120,30317592,30320770,3178
"17510",16,6,111,121,30326661,30330013,3352
"17611",16,1,52,122,30333366,30337484,4118
"17810",16,1,130,123,30343489,30348347,4858
"17911",16,1,28,124,30351386,30355544,4158
"18116",16,1,88,125,30361555,30364674,3119
"18211",16,3,36,126,30367493,30372045,4552
"18410",16,3,18,127,30378449,30382907,4458
"18610",16,3,12,128,30388865,30392570,3705
"18811",16,4,115,129,30398135,30401427,3292
"18911",16,1,16,130,30404506,30407785,3279
"19117",16,3,78,131,30413096,30416041,2945
"19214",16,1,70,132,30419194,30424225,5031
"19311",16,2,71,133,30427064,30429970,2906
"1949",16,1,22,134,30432835,30436601,3766
"19610",16,5,26,135,30442818,30448610,5792
"19810",16,1,136,136,30455460,30459232,3772
"19911",16,6,33,137,30462418,30466183,3765
"20113",16,6,75,138,30472488,30477272,4784
"1060",17,3,65,1,31411507,31413979,2472
"1150",17,3,23,2,31417325,31421210,3885
"1360",17,3,17,3,31426928,31430493,3565
"1550",17,3,119,4,31437111,31443801,6690
"1640",17,2,4,5,31447094,31450233,3139
"1850",17,5,7,6,31455977,31459296,3319
"2010",17,2,82,7,31466200,31469352,3152
"2113",17,4,138,8,31472984,31476190,3206
"2212",17,5,61,9,31479782,31482647,2865
"239",17,1,75,10,31486086,31489785,3699
"2414",17,2,40,11,31493443,31497608,4165
"2615",17,1,45,12,31503466,31506845,3379
"2811",17,5,91,13,31512277,31515668,3391
"2913",17,1,87,14,31519174,31522586,3412
"3012",17,5,103,15,31525478,31528970,3492
"3110",17,5,85,16,31531776,31535434,3658
"3212",17,6,8,17,31538767,31541425,2658
"3411",17,3,5,18,31548283,31551169,2886
"3612",17,4,54,19,31557366,31560085,2719
"3812",17,4,12,20,31566617,31568862,2245
"4011",17,4,36,21,31574707,31577646,2939
"4210",17,4,84,22,31584156,31588135,3979
"4312",17,4,126,23,31591121,31595386,4265
"4411",17,6,116,24,31598498,31602430,3932
"458",17,2,106,25,31605349,31608761,3412
"4612",17,1,105,26,31611760,31616591,4831
"478",17,1,93,27,31619650,31622395,2745
"4812",17,1,111,28,31625688,31628860,3172
"4910",17,6,122,29,31631632,31634351,2719
"5012",17,1,33,30,31637497,31640929,3432
"5213",17,6,104,31,31647060,31651398,4338
"5312",17,5,73,32,31654657,31658909,4252
"5412",17,4,60,33,31662127,31665640,3513
"5515",17,5,31,34,31669385,31672910,3525
"5710",17,3,53,35,31678475,31681134,2659
"5915",17,1,9,36,31686905,31690284,3379
"6113",17,1,39,37,31696848,31700660,3812
"6312",17,2,46,38,31706585,31710223,3638
"6513",17,3,35,39,31716241,31719373,3132
"6711",17,5,67,40,31726111,31728396,2285
"6811",17,6,68,41,31731509,31735474,3965
"6913",17,1,135,42,31738533,31741845,3312
"7013",17,1,81,43,31745224,31748609,3385
"7110",17,5,37,44,31751488,31755033,3545
"738",17,1,117,45,31760791,31764730,3939
"7412",17,1,129,46,31768122,31772507,4385
"7513",17,5,109,47,31775986,31780071,4085
"7612",17,1,63,48,31783176,31786202,3026
"7710",17,2,112,49,31789354,31793046,3692
"7812",17,3,131,50,31796525,31801109,4584
"7912",17,6,38,51,31804115,31807381,3266
"8112",17,3,113,52,31813318,31816197,2879
"8212",17,3,83,53,31819123,31822788,3665
"8311",17,5,97,54,31825714,31827833,2119
"8411",17,2,28,55,31830779,31834964,4185
"8613",17,4,108,56,31841475,31844400,2925
"879",17,3,29,57,31847539,31851864,4325
"899",17,4,18,58,31859255,31861774,2519
"9111",17,5,43,59,31867738,31870457,2719
"9311",17,6,134,60,31876095,31879274,3179
"9411",17,6,26,61,31882526,31887171,4645
"9610",17,4,78,62,31893835,31896234,2399
"979",17,6,92,63,31899340,31902659,3319
"9812",17,4,24,64,31905344,31908303,2959
"10014",17,4,30,65,31915561,31918339,2778
"10212",17,6,20,66,31948675,31950621,1946
"10410",17,6,128,67,31956159,31961617,5458
"10511",17,2,22,68,31965036,31969234,4198
"10712",17,5,25,69,31975592,31978464,2872
"1099",17,6,14,70,31984242,31988180,3938
"11114",17,1,123,71,31995278,31998943,3665
"11214",17,2,52,72,32001755,32004368,2613
"11411",17,2,94,73,32010066,32012965,2899
"11511",17,5,55,74,32015617,32018216,2599
"11613",17,3,95,75,32021168,32025486,4318
"11712",17,1,3,76,32028572,32033150,4578
"1198",17,3,71,77,32039521,32043113,3592
"12013",17,5,13,78,32046392,32050444,4052
"12214",17,3,107,79,32056722,32059674,2952
"12312",17,3,137,80,32062753,32066132,3379
"12412",17,5,127,81,32069017,32071323,2306
"1259",17,5,1,82,32074235,32076721,2486
"12710",17,1,15,83,32083112,32085491,2379
"12914",17,3,41,84,32092468,32096827,4359
"13116",17,6,32,85,32102638,32105670,3032
"13313",17,4,72,86,32112088,32113967,1879
"13411",17,6,50,87,32116740,32119238,2498
"13611",17,2,118,88,32124990,32127929,2939
"1378",17,4,102,89,32130748,32133307,2559
"13810",17,3,59,90,32136272,32140870,4598
"13911",17,4,42,91,32143929,32147448,3519
"14116",17,2,88,92,32154113,32156838,2725
"14214",17,1,69,93,32159544,32161776,2232
"14313",17,3,89,94,32164775,32168800,4025
"14411",17,4,6,95,32171799,32175937,4138
"14614",17,4,114,96,32182928,32187153,4225
"14710",17,3,47,97,32189913,32192325,2412
"14915",17,2,64,98,32197749,32201481,3732
"15010",17,2,130,99,32204827,32209386,4559
"15116",17,4,48,100,32212104,32214257,2153
"15310",17,1,51,101,32220421,32223153,2732
"15512",17,1,57,102,32228771,32231598,2827
"15612",17,6,80,103,32234856,32237755,2899
"15714",17,2,76,104,32240534,32244859,4325
"15810",17,2,70,105,32248184,32251776,3592
"15912",17,6,62,106,32255315,32258114,2799
"16013",17,2,10,107,32261253,32265025,3772
"16210",17,3,101,108,32271869,32276400,4531
"16316",17,2,58,109,32279972,32283684,3712
"16410",17,5,79,110,32286897,32290335,3438
"16513",17,3,125,111,32293661,32297846,4185
"1666",17,6,86,112,32301145,32303877,2732
"16714",17,6,98,113,32306763,32310321,3558
"16813",17,3,77,114,32313447,32316699,3252
"16913",17,4,120,115,32319778,32322277,2499
"17013",17,4,96,116,32325236,32329421,4185
"17116",17,2,16,117,32332500,32336845,4345
"17311",17,3,11,118,32343189,32346015,2826
"17511",17,6,74,119,32352446,32357437,4991
"17612",17,6,2,120,32361042,32364148,3106
"17811",17,5,133,121,32372698,32375197,2499
"17912",17,4,90,122,32377930,32380762,2832
"18012",17,5,19,123,32383947,32387533,3586
"18212",17,4,66,124,32394057,32396603,2546
"18310",17,6,56,125,32399695,32402754,3059
"18411",17,1,21,126,32405633,32407978,2345
"18611",17,2,124,127,32414050,32417628,3578
"18712",17,2,136,128,32421180,32424406,3226
"18812",17,5,115,129,32427331,32430343,3012
"18912",17,6,110,130,32433263,32435455,2192
"19011",17,2,100,131,32438134,32442006,3872
"19118",17,6,44,132,32444765,32447197,2432
"19312",17,5,121,133,32453515,32456034,2519
"19410",17,5,49,134,32460179,32462658,2479
"19611",17,2,34,135,32467830,32472681,4851
"19811",17,4,132,136,32480052,32483037,2985
"19912",17,1,99,137,32486069,32489582,3513
"20013",17,1,27,138,32492574,32496033,3459
"1070",18,6,37,1,793816,796281,2465
"1240",18,6,61,2,802899,805911,3012
"1370",18,5,72,3,809356,811989,2633
"1450",18,1,38,4,814721,817227,2506
"1650",18,5,12,5,826397,828956,2559
"1860",18,6,133,6,834680,837099,2419
"1950",18,3,88,7,840432,842724,2292
"2020",18,6,127,8,846043,849242,3199
"2114",18,5,60,9,853760,856232,2472
"2213",18,4,137,10,859578,862570,2992
"2310",18,4,83,11,865822,869248,3426
"2415",18,1,86,12,873553,875798,2245
"2511",18,6,55,13,879351,881630,2279
"2616",18,2,33,14,884895,887227,2332
"2812",18,3,10,15,894285,898143,3858
"3013",18,2,15,16,904315,906427,2112
"3213",18,6,25,17,913005,915564,2559
"3412",18,1,116,18,923568,927239,3671
"3511",18,5,6,19,931925,935550,3625
"378",18,6,43,20,942254,945966,3712
"3912",18,5,84,21,951724,954349,2625
"4012",18,4,5,22,958161,961807,3646
"4211",18,5,66,23,967511,970344,2833
"4313",18,6,79,24,976381,978720,2339
"4412",18,2,69,25,982093,984505,2412
"459",18,2,3,26,987650,990136,2486
"479",18,4,65,27,996767,999006,2239
"4813",18,4,17,28,1002291,1005177,2886
"5013",18,2,45,29,1010895,1013114,2219
"5214",18,2,99,30,1018572,1021118,2546
"5313",18,1,110,31,1024543,1026269,1726
"5413",18,2,27,32,1029102,1031954,2852
"569",18,4,77,33,1038491,1041584,3093
"5711",18,1,56,34,1044783,1048368,3585
"5811",18,2,39,35,1051880,1054992,3112
"6012",18,1,32,36,1060770,1063789,3019
"6215",18,6,91,37,1069780,1072312,2532
"6313",18,6,103,38,1077330,1079823,2493
"6414",18,6,1,39,1083642,1087400,3758
"6611",18,1,104,40,1093005,1095217,2212
"6712",18,4,131,41,1098403,1100548,2145
"6812",18,5,96,42,1106100,1108925,2825
"6914",18,1,74,43,1112084,1114723,2639
"7014",18,2,105,44,1117755,1119981,2226
"7111",18,6,67,45,1123120,1126699,3579
"7213",18,6,19,46,1129591,1132417,2826
"7413",18,4,47,47,1138408,1140327,1919
"7613",18,5,24,48,1145805,1149317,3512
"7813",18,3,112,49,1155241,1157407,2166
"7913",18,5,30,50,1160380,1163066,2686
"8113",18,3,70,51,1168517,1172155,3638
"8213",18,5,102,52,1175641,1178913,3272
"8312",18,3,34,53,1182078,1184610,2532
"8510",18,5,126,54,1191122,1193961,2839
"8614",18,1,128,55,1197266,1199745,2479
"8710",18,5,78,56,1202597,1205196,2599
"8813",18,6,85,57,1208488,1212327,3839
"8910",18,1,8,58,1216599,1218978,2379
"9112",18,3,64,59,1227521,1230274,2753
"9213",18,4,113,60,1234679,1237851,3172
"9312",18,4,59,61,1241583,1244282,2699
"9412",18,3,100,62,1247467,1250139,2672
"9512",18,1,80,63,1253518,1255364,1846
"9611",18,6,31,64,1258637,1261336,2699
"9813",18,6,49,65,1267067,1271292,4225
"10015",18,2,57,66,1304053,1306332,2279
"10115",18,3,76,67,1309564,1312543,2979
"10213",18,3,118,68,1315835,1319414,3579
"10314",18,3,124,69,1322880,1324679,1799
"10411",18,5,36,70,1329877,1332156,2279
"10611",18,3,16,71,1339800,1341812,2012
"10812",18,1,50,72,1347817,1350189,2372
"11010",18,5,90,73,1355741,1358746,3005
"11115",18,4,125,74,1361785,1364464,2679
"11215",18,3,28,75,1367676,1370175,2499
"11412",18,2,21,76,1375540,1380525,4985
"11614",18,1,92,77,1387575,1389781,2206
"11713",18,5,138,78,1393173,1395699,2526
"11814",18,2,123,79,1398931,1401177,2246
"1199",18,2,93,80,1404223,1406222,1999
"12014",18,3,106,81,1409641,1411913,2272
"12115",18,6,73,82,1415285,1418544,3259
"12215",18,1,26,83,1421976,1424182,2206
"12413",18,3,130,84,1431253,1433745,2492
"12510",18,1,98,85,1436944,1439470,2526
"12611",18,5,18,86,1442295,1444707,2412
"12811",18,3,136,87,1453504,1455823,2319
"12915",18,4,23,88,1459382,1462688,3306
"13117",18,4,107,89,1469825,1472337,2512
"13215",18,1,44,90,1476062,1480734,4672
"13412",18,5,48,91,1486739,1488185,1446
"13612",18,2,111,92,1494369,1496555,2186
"1379",18,1,14,93,1500067,1502806,2739
"13912",18,5,108,94,1509130,1511783,2653
"14012",18,5,120,95,1514682,1517067,2385
"14117",18,6,121,96,1520166,1524538,4372
"14215",18,1,122,97,1528150,1529856,1706
"14314",18,2,117,98,1533395,1534954,1559
"14412",18,2,9,99,1538733,1540785,2052
"14615",18,1,134,100,1549535,1552214,2679
"14711",18,1,68,101,1555747,1558079,2332
"14810",18,4,89,102,1562484,1564696,2212
"14916",18,4,95,103,1569195,1572507,3312
"15011",18,6,13,104,1575999,1578478,2479
"15214",18,5,132,105,1586515,1588927,2412
"15311",18,6,97,106,1592333,1594685,2352
"15412",18,2,75,107,1598018,1600650,2632
"15513",18,4,53,108,1603735,1605781,2046
"15715",18,5,42,109,1611992,1614438,2446
"15913",18,6,115,110,1620276,1622701,2425
"16014",18,2,81,111,1625954,1629173,3219
"16116",18,6,109,112,1632251,1634831,2580
"16211",18,4,71,113,1638069,1640315,2246
"16317",18,4,29,114,1643707,1645933,2226
"16514",18,3,40,115,1652544,1655083,2539
"16715",18,4,35,116,1661107,1663326,2219
"16914",18,2,129,117,1670857,1674229,3372
"17014",18,1,2,118,1677668,1680001,2333
"17211",18,1,62,119,1685485,1688071,2586
"17312",18,3,46,120,1691750,1694342,2592
"17512",18,3,82,121,1701353,1705711,4358
"17613",18,6,7,122,1709443,1713202,3759
"17812",18,4,11,123,1720152,1722365,2213
"18013",18,2,135,124,1728729,1731568,2839
"18117",18,1,20,125,1736593,1739645,3052
"18311",18,4,101,126,1746276,1749708,3432
"18412",18,3,52,127,1752993,1754972,1979
"18612",18,4,119,128,1760804,1763343,2539
"18713",18,3,22,129,1767675,1770887,3212
"18913",18,5,114,130,1777051,1780124,3073
"19012",18,2,51,131,1783256,1785415,2159
"19215",18,3,4,132,1791386,1793878,2492
"19411",18,5,54,133,1800123,1802155,2032
"19612",18,3,94,134,1807840,1811292,3452
"19712",18,2,87,135,1814791,1817023,2232
"19812",18,3,58,136,1820242,1825833,5591
"19913",18,4,41,137,1829972,1832184,2212
"20114",18,2,63,138,1838069,1839888,1819
"1080",19,2,26,1,3200718,3205456,4738
"1250",19,2,134,2,3213240,3220857,7617
"1380",19,4,58,3,3224283,3229894,5611
"1460",19,3,129,4,3233266,3239144,5878
"1560",19,5,101,5,3242442,3246035,3593
"1660",19,4,136,6,3249287,3254191,4904
"1760",19,5,71,7,3257117,3261676,4559
"1870",19,1,7,8,3264934,3270825,5891
"2021",19,6,6,9,3279469,3285193,5724
"2214",19,4,4,10,3292418,3297762,5344
"2416",19,2,116,11,3305659,3310757,5098
"2512",19,2,86,12,3313749,3317128,3379
"2617",19,1,1,13,3320767,3323906,3139
"2813",19,2,50,14,3330737,3334189,3452
"3014",19,6,126,15,3340066,3346304,6238
"3111",19,3,57,16,3349443,3353488,4045
"3214",19,3,33,17,3356714,3361692,4978
"3413",19,3,99,18,3368389,3373261,4872
"3512",19,5,131,19,3377260,3380805,3545
"3613",19,1,109,20,3383750,3387669,3919
"379",19,5,17,21,3391807,3396732,4925
"3913",19,6,42,22,3403010,3411986,8976
"4115",19,5,95,23,3423736,3437104,13368
"4212",19,6,54,24,3440649,3443788,3139
"4413",19,6,96,25,3450013,3455110,5097
"4510",19,4,118,26,3458270,3461228,2958
"4613",19,1,19,27,3464121,3467473,3352
"4814",19,2,20,28,3476109,3486359,10250
"5014",19,6,60,29,3493204,3498395,5191
"5110",19,3,21,30,3502580,3506532,3952
"5314",19,4,10,31,3513556,3518287,4731
"5516",19,5,65,32,3525618,3530243,4625
"5610",19,4,112,33,3533055,3536634,3579
"5712",19,1,67,34,3539506,3542385,2879
"5812",19,4,88,35,3545424,3549189,3765
"5916",19,1,121,36,3552408,3555294,2886
"6013",19,2,8,37,3558366,3561691,3325
"6216",19,3,27,38,3569175,3573407,4232
"6415",19,6,138,39,3579338,3584489,5151
"6514",19,2,98,40,3587642,3591854,4212
"6612",19,3,81,41,3595199,3598078,2879
"6713",19,1,13,42,3604862,3610506,5644
"6915",19,4,16,43,3617950,3622762,4812
"7112",19,3,39,44,3631239,3639336,8097
"739",19,6,72,45,3645754,3650605,4851
"7414",19,2,14,46,3653984,3659848,5864
"7614",19,6,84,47,3666799,3670664,3865
"7711",19,4,22,48,3673963,3677902,3939
"7914",19,4,64,49,3685859,3689564,3705
"8012",19,3,15,50,3692650,3695835,3185
"8214",19,2,92,51,3702299,3706438,4139
"8313",19,2,122,52,3709397,3711529,2132
"8412",19,5,5,53,3714721,3718986,4265
"8615",19,3,111,54,3727277,3733961,6684
"8711",19,2,56,55,3737466,3742444,4978
"8814",19,5,113,56,3745457,3749682,4225
"8911",19,5,11,57,3754354,3757226,2872
"9113",19,5,77,58,3764503,3767582,3079
"9214",19,1,31,59,3770821,3775112,4291
"9413",19,1,25,60,3784149,3789187,5038
"9612",19,1,85,61,3800097,3804082,3985
"9710",19,1,73,62,3812286,3815864,3578
"9814",19,6,108,63,3819123,3822395,3272
"9911",19,3,105,64,3825374,3828693,3319
"10016",19,4,52,65,3835050,3838975,3925
"10214",19,1,115,66,3874376,3876808,2432
"10315",19,5,89,67,3880213,3884085,3872
"10412",19,2,32,68,3887504,3890743,3239
"10612",19,3,69,69,3897427,3900839,3412
"10713",19,1,127,70,3903911,3907630,3719
"10813",19,6,78,71,3910482,3913981,3499
"10910",19,5,83,72,3916993,3921438,4445
"11011",19,1,49,73,3924777,3931255,6478
"11216",19,5,53,74,3938199,3941311,3112
"11413",19,6,12,75,3947662,3951747,4085
"11615",19,3,93,76,3960637,3963743,3106
"11714",19,5,35,77,3967435,3970914,3479
"11910",19,4,70,78,3977777,3981363,3586
"12015",19,3,9,79,3984468,3991246,6778
"12216",19,5,41,80,3996864,4000542,3678
"12414",19,4,28,81,4006541,4010432,3891
"12612",19,6,90,82,4019102,4023967,4865
"12711",19,3,117,83,4026973,4029899,2926
"12812",19,5,137,84,4032717,4035956,3239
"12916",19,6,132,85,4038668,4042647,3979
"13010",19,6,24,86,4045812,4049678,3866
"13216",19,3,45,87,4058741,4062013,3272
"13413",19,6,120,88,4067531,4071723,4192
"13511",19,6,36,89,4074735,4078534,3799
"13710",19,1,79,90,4084598,4088183,3585
"13811",19,2,2,91,4092542,4096873,4331
"14013",19,3,135,92,4104544,4109282,4738
"14118",19,4,46,93,4112381,4117859,5478
"14315",19,1,37,94,4124164,4128469,4305
"14510",19,6,102,95,4134313,4137925,3612
"14616",19,5,107,96,4141137,4145376,4239
"14712",19,1,91,97,4148261,4151414,3153
"14811",19,1,55,98,4154306,4156591,2285
"14917",19,6,66,99,4159424,4162436,3012
"15012",19,2,44,100,4165635,4168760,3125
"15215",19,5,125,101,4174818,4179936,5118
"15312",19,6,114,102,4183215,4187966,4751
"15413",19,2,38,103,4191005,4195070,4065
"15613",19,4,76,104,4201115,4206320,5205
"15716",19,1,97,105,4209745,4213424,3679
"15811",19,5,59,106,4216357,4220794,4437
"15914",19,2,104,107,4225286,4229444,4158
"16015",19,2,62,108,4232830,4235676,2846
"16117",19,3,51,109,4238574,4242326,3752
"16318",19,3,87,110,4249777,4254122,4345
"16411",19,4,100,111,4257481,4260313,2832
"16515",19,2,128,112,4263445,4270922,7477
"1667",19,1,103,113,4274315,4278999,4684
"16716",19,4,130,114,4282392,4287076,4684
"16814",19,4,94,115,4290309,4294807,4498
"16915",19,5,23,116,4297899,4301425,3526
"17117",19,5,29,117,4308209,4311754,3545
"17313",19,4,124,118,4317899,4322350,4451
"17410",19,4,82,119,4325463,4328628,3165
"17513",19,3,75,120,4331827,4336178,4351
"17614",19,5,47,121,4339571,4343276,3705
"17813",19,3,123,122,4349993,4354605,4612
"17913",19,2,110,123,4357690,4361462,3772
"18014",19,2,74,124,4364628,4369139,4511
"18118",19,2,68,125,4372665,4376257,3592
"18213",19,1,43,126,4379162,4381761,2599
"18413",19,1,133,127,4392784,4396889,4105
"18510",19,4,106,128,4404053,4407499,3446
"18613",19,4,34,129,4410784,4415116,4332
"18813",19,4,40,130,4425452,4430037,4585
"19013",19,1,61,131,4437681,4440873,3192
"19119",19,5,119,132,4443892,4448830,4938
"19216",19,6,18,133,4451903,4454461,2558
"19412",19,6,30,134,4460719,4464431,3712
"19613",19,3,3,135,4470462,4474601,4139
"19813",19,3,63,136,4480198,4484044,3846
"19914",19,6,48,137,4486883,4490015,3132
"20115",19,2,80,138,4496693,4501544,4851
"1090",20,2,103,1,5856397,5859609,3212
"1160",20,1,42,2,5862441,5865700,3259
"1390",20,1,120,3,5872544,5875263,2719
"1470",20,4,93,4,5878302,5882048,3746
"1570",20,3,8,5,5885013,5888592,3579
"1770",20,4,39,6,5894750,5898282,3532
"1960",20,2,31,7,5904493,5908318,3825
"2115",20,1,6,8,5914416,5918407,3991
"2311",20,6,71,9,5924085,5926964,2879
"2417",20,4,87,10,5929943,5934055,4112
"2513",20,4,129,11,5937287,5940153,2866
"2618",20,1,54,12,5942952,5945984,3032
"2814",20,4,9,13,5952675,5956800,4125
"3015",20,4,63,14,5963104,5967922,4818
"3112",20,4,21,15,5971028,5974653,3625
"3314",20,2,109,16,5981751,5985702,3951
"3414",20,5,124,17,5989248,5992473,3225
"3513",20,1,90,18,5995206,5997598,2392
"3614",20,4,99,19,6001097,6004855,3758
"3710",20,2,55,20,6008414,6011020,2606
"3813",20,4,69,21,6014092,6016331,2239
"3914",20,1,126,22,6019983,6022802,2819
"4013",20,3,62,23,6025721,6027907,2186
"4116",20,6,41,24,6030886,6034531,3645
"4314",20,3,104,25,6043181,6046347,3166
"4414",20,6,23,26,6049386,6051398,2012
"4614",20,6,101,27,6057829,6061048,3219
"4710",20,2,133,28,6064140,6066966,2826
"4815",20,5,130,29,6070005,6074763,4758
"4911",20,4,105,30,6077615,6079994,2379
"5015",20,2,19,31,6082800,6085126,2326
"5215",20,2,1,32,6092683,6095089,2406
"5414",20,4,27,33,6101613,6104159,2546
"5611",20,6,95,34,6109850,6112922,3072
"5713",20,2,97,35,6115988,6118273,2285
"5813",20,1,114,36,6121272,6124398,3126
"5917",20,1,18,37,6128050,6130409,2359
"6114",20,6,65,38,6136220,6138273,2053
"6217",20,6,5,39,6141372,6144464,3092
"6416",20,1,72,40,6153667,6156193,2526
"6515",20,3,98,41,6159245,6161691,2446
"6613",20,6,29,42,6164536,6166995,2459
"6813",20,5,10,43,6172834,6174819,1985
"7015",20,2,73,44,6181357,6184269,2912
"7113",20,1,48,45,6187196,6188961,1765
"7310",20,5,22,46,6195272,6198064,2792
"7514",20,4,135,47,6205608,6210106,4498
"7615",20,6,35,48,6213378,6216091,2713
"7814",20,5,82,49,6222482,6224767,2285
"7915",20,1,60,50,6227800,6230432,2632
"8013",20,4,45,51,6233178,6235563,2385
"8215",20,4,57,52,6241961,6245826,3865
"8314",20,4,33,53,6248912,6252490,3578
"8511",20,2,79,54,6258668,6261694,3026
"8616",20,1,24,55,6264573,6267278,2705
"8815",20,5,46,56,6273636,6277162,3526
"9011",20,6,137,57,6283439,6286365,2926
"9114",20,3,68,58,6289804,6292476,2672
"9215",20,4,117,59,6295488,6297840,2352
"9313",20,2,115,60,6300586,6303038,2452
"9414",20,1,66,61,6305731,6307990,2259
"9513",20,6,53,62,6311209,6314168,2959
"9711",20,5,28,63,6319599,6322658,3059
"9912",20,3,128,64,6329715,6333214,3499
"10017",20,4,51,65,6336053,6338352,2299
"10215",20,5,16,66,6391426,6393865,2439
"10413",20,6,11,67,6399876,6404914,5038
"10613",20,6,59,68,6410692,6413318,2626
"10714",20,5,58,69,6416563,6419222,2659
"10814",20,5,106,70,6422141,6424594,2453
"10911",20,2,25,71,6427346,6429545,2199
"11116",20,5,52,72,6435523,6437749,2226
"11311",20,6,113,73,6443194,6445766,2572
"11414",20,3,14,74,6449071,6451617,2546
"11616",20,6,107,75,6458221,6461620,3399
"11715",20,6,77,76,6465212,6467798,2586
"11815",20,1,132,77,6470597,6472503,1906
"11911",20,3,50,78,6475608,6477854,2246
"12116",20,3,122,79,6483812,6485764,1952
"12217",20,6,119,80,6489063,6492862,3799
"12313",20,2,121,81,6496154,6498180,2026
"12415",20,6,125,82,6501225,6503704,2479
"12511",20,2,43,83,6506563,6508383,1820
"12712",20,5,112,84,6513914,6516446,2532
"12813",20,5,136,85,6519192,6521891,2699
"12917",20,1,138,86,6535246,6537412,2166
"13011",20,4,15,87,6540178,6542497,2319
"13217",20,1,36,88,6547868,6550360,2492
"13414",20,2,13,89,6557431,6559584,2153
"13613",20,3,92,90,6565169,6568401,3232
"13711",20,4,123,91,6571686,6575491,3805
"13812",20,3,26,92,6578597,6581529,2932
"14014",20,5,70,93,6587867,6590932,3065
"14119",20,5,40,94,6594524,6597083,2559
"14316",20,3,20,95,6602668,6604827,2159
"14511",20,5,4,96,6610465,6612831,2366
"14713",20,2,37,97,6618369,6620995,2626
"14918",20,4,81,98,6627425,6629538,2113
"15013",20,3,56,99,6642580,6644612,2032
"15117",20,6,89,100,6647891,6650563,2672
"15216",20,2,91,101,6653409,6656148,2739
"15313",20,3,134,102,6659054,6661326,2272
"15414",20,1,102,103,6664065,6665671,1606
"15514",20,4,111,104,6668997,6671342,2345
"15614",20,3,44,105,6674381,6676061,1680
"15812",20,2,127,106,6682612,6684977,2365
"15915",20,2,67,107,6688950,6690742,1792
"16016",20,3,116,108,6694021,6696653,2632
"16118",20,6,17,109,6699965,6702851,2886
"16319",20,3,80,110,6711001,6713874,2873
"16412",20,6,131,111,6716819,6718845,2026
"16516",20,1,12,112,6721784,6723950,2166
"16717",20,2,85,113,6785853,6788346,2493
"16815",20,3,74,114,6791531,6794184,2653
"16916",20,6,47,115,6796876,6799342,2466
"17118",20,1,84,116,6804700,6808645,3945
"17212",20,1,108,117,6811977,6814443,2466
"17314",20,3,32,118,6817355,6819514,2159
"17514",20,3,86,119,6825572,6827585,2013
"17615",20,1,78,120,6830491,6834476,3985
"17710",20,1,96,121,6837494,6839707,2213
"17814",20,4,75,122,6842646,6845772,3126
"17914",20,2,49,123,6848750,6851056,2306
"18119",20,3,110,124,6856774,6859140,2366
"18214",20,5,88,125,6862119,6864498,2379
"18312",20,2,7,126,6867310,6870002,2692
"18511",20,3,2,127,6875907,6878313,2406
"18714",20,3,38,128,6885097,6888209,3112
"18914",20,5,100,129,6893707,6896093,2386
"19014",20,4,3,130,6899065,6902584,3519
"19217",20,1,30,131,6908069,6910248,2179
"19413",20,6,83,132,6915879,6919537,3658
"19511",20,2,61,133,6923016,6925568,2552
"19614",20,5,64,134,6928528,6930833,2305
"19713",20,5,94,135,6933752,6936771,3019
"19814",20,5,76,136,6939663,6941403,1740
"19915",20,5,118,137,6944275,6946954,2679
"20014",20,5,34,138,6949846,6952065,2219
"10100",21,4,20,1,8012207,8017918,5711
"1260",21,1,59,2,8025916,8032260,6344
"13100",21,4,92,3,8035405,8041336,5931
"1480",21,1,23,4,8044942,8050593,5651
"1668",21,6,10,5,8058557,8064954,6397
"1880",21,2,120,6,8071826,8077270,5444
"1970",21,1,5,7,8080622,8086600,5978
"2116",21,5,93,8,8094357,8098495,4138
"2215",21,5,75,9,8101801,8109025,7224
"2312",21,6,70,10,8112624,8120667,8043
"2418",21,2,138,11,8125639,8130310,4671
"2514",21,6,34,12,8133309,8144405,11096
"2713",21,6,130,13,8152109,8158260,6151
"2815",21,3,79,14,8162099,8168689,6590
"2914",21,2,90,15,8172628,8177893,5265
"3016",21,3,37,16,8181385,8188735,7350
"3215",21,3,103,17,8196013,8201164,5151
"3315",21,4,38,18,8205556,8211187,5631
"3514",21,2,114,19,8218178,8224149,5971
"3615",21,2,36,20,8227228,8231760,4532
"3814",21,4,98,21,8239170,8244875,5705
"3915",21,1,95,22,8248134,8254598,6464
"4014",21,2,18,23,8257610,8264154,6544
"4213",21,3,91,24,8272125,8277682,5557
"4315",21,2,12,25,8280802,8286653,5851
"4511",21,6,106,26,8293097,8299201,6104
"4615",21,6,46,27,8302394,8307985,5591
"4816",21,2,132,28,8314476,8321786,7310
"4912",21,6,40,29,8325652,8330670,5018
"5111",21,4,8,30,8337687,8343358,5671
"5315",21,6,58,31,8351303,8358153,6850
"5415",21,4,14,32,8361385,8366623,5238
"5612",21,2,102,33,8374120,8379505,5385
"5714",21,6,64,34,8382757,8387888,5131
"5814",21,3,7,35,8391534,8396059,4525
"6014",21,2,24,36,8406009,8415971,9962
"6218",21,2,78,37,8423149,8427187,4038
"6314",21,3,43,38,8431879,8435664,3785
"6516",21,5,123,39,8442522,8448333,5811
"6614",21,6,28,40,8451532,8456916,5384
"6814",21,6,4,41,8463654,8470451,6797
"7016",21,3,97,42,8477629,8483546,5917
"7114",21,2,96,43,8486666,8491184,4518
"7214",21,6,88,44,8495709,8500647,4938
"7311",21,6,16,45,8503999,8509837,5838
"7515",21,5,21,46,8518214,8522119,3905
"7712",21,1,137,47,8529656,8534514,4858
"7815",21,5,45,48,8537394,8542098,4704
"8014",21,1,119,49,8548510,8554700,6190
"8114",21,3,13,50,8558153,8563124,4971
"8315",21,1,35,51,8569522,8573907,4385
"8512",21,5,63,52,8581657,8587848,6191
"8617",21,4,122,53,8590854,8595079,4225
"8712",21,2,72,54,8598031,8601990,3959
"8816",21,1,41,55,8605522,8610433,4911
"9012",21,3,67,56,8617711,8621909,4198
"9115",21,1,125,57,8625081,8632305,7224
"9216",21,6,76,58,8635404,8642474,7070
"9314",21,4,26,59,8645527,8650791,5264
"9514",21,6,82,60,8658529,8662534,4005
"9613",21,5,87,61,8665613,8670771,5158
"9712",21,5,129,62,8673697,8677149,3452
"9815",21,2,84,63,8680640,8688964,8324
"9913",21,6,112,64,8691883,8696541,4658
"10018",21,2,108,65,8699514,8703279,3765
"10116",21,1,77,66,8773686,8778777,5091
"10216",21,2,30,67,8781557,8785575,4018
"10414",21,4,32,68,8792766,8798344,5578
"10614",21,1,53,69,8805861,8811239,5378
"10815",21,3,55,70,8817557,8821622,4065
"10912",21,5,111,71,8824467,8829232,4765
"11012",21,5,3,72,8832378,8838129,5751
"11217",21,6,100,73,8845113,8850525,5412
"11312",21,6,118,74,8853637,8859881,6244
"11415",21,5,9,75,8864113,8869324,5211
"11617",21,1,83,76,8877748,8883645,5897
"11716",21,2,126,77,8886791,8892775,5984
"11816",21,4,56,78,8896188,8902672,6484
"11912",21,4,74,79,8907144,8911788,4644
"12016",21,4,50,80,8914921,8918706,3785
"12218",21,4,2,81,8926283,8930808,4525
"12416",21,4,68,82,8938665,8944223,5558
"12512",21,1,11,83,8947362,8952940,5578
"12713",21,5,57,84,8961037,8968368,7331
"12814",21,1,47,85,8972753,8976684,3931
"13012",21,3,85,86,8983548,8989566,6018
"13118",21,5,51,87,8992872,8998303,5431
"13314",21,1,29,88,9005121,9010119,4998
"13512",21,1,107,89,9018029,9023294,5265
"13614",21,6,22,90,9026553,9032550,5997
"13813",21,2,60,91,9039815,9044679,4864
"13913",21,6,52,92,9047958,9052403,4445
"14120",21,5,69,93,9059267,9063766,4499
"14216",21,3,73,94,9066771,9071163,4392
"14317",21,3,121,95,9074555,9080633,6078
"14413",21,4,110,96,9084978,9088523,3545
"14512",21,4,62,97,9091849,9095527,3678
"14617",21,2,48,98,9098360,9100812,2452
"14812",21,4,80,99,9108023,9113540,5517
"14919",21,6,94,100,9116866,9122797,5931
"15014",21,4,44,101,9125850,9129448,3598
"15217",21,5,27,102,9136146,9140004,3858
"15415",21,3,133,103,9146389,9150527,4138
"15515",21,1,17,104,9153613,9158351,4738
"15717",21,4,128,105,9165835,9172245,6410
"15813",21,6,124,106,9176071,9183728,7657
"15916",21,5,105,107,9187360,9192398,5038
"16017",21,1,89,108,9195810,9202921,7111
"16119",21,5,33,109,9206193,9212704,6511
"16320",21,2,42,110,9219548,9223087,3539
"16517",21,5,99,111,9230478,9235196,4718
"1669",21,1,113,112,9237968,9241633,3665
"16718",21,5,15,113,9244719,9247991,3272
"16917",21,1,101,114,9254835,9258947,4112
"17015",21,5,135,115,9262026,9267757,5731
"17119",21,4,134,116,9270743,9275554,4811
"17213",21,5,81,117,9278727,9283564,4837
"17315",21,5,39,118,9286610,9290988,4378
"17515",21,3,1,119,9297646,9301105,3459
"17711",21,1,131,120,9307656,9312354,4698
"17815",21,4,116,121,9315419,9320184,4765
"17915",21,3,109,122,9324070,9331187,7117
"18015",21,3,127,123,9334239,9338531,4292
"18120",21,6,136,124,9341537,9347714,6177
"18215",21,2,54,125,9350733,9355018,4285
"18414",21,3,31,126,9364421,9371225,6804
"18614",21,3,25,127,9377737,9384634,6897
"18814",21,3,49,128,9391365,9396336,4971
"19015",21,3,19,129,9402314,9407112,4798
"19218",21,1,71,130,9416475,9419648,3173
"19313",21,2,6,131,9423493,9428824,5331
"19512",21,5,117,132,9435808,9439660,3852
"19615",21,1,65,133,9442839,9447657,4818
"19714",21,4,104,134,9450849,9456994,6145
"19815",21,4,86,135,9460306,9464471,4165
"19916",21,3,115,136,9468190,9473334,5144
"20015",21,2,66,137,9476667,9481631,4964
"20116",21,3,61,138,9498019,9504110,6091
"10101",22,5,92,1,10331611,10335676,4065
"1170",22,3,78,2,10338542,10341981,3439
"1270",22,2,89,3,10345079,10348985,3906
"13101",22,1,58,4,10351770,10354363,2593
"1490",22,1,28,5,10356882,10359774,2892
"1670",22,2,47,6,10366491,10368690,2199
"1890",22,6,9,7,10374895,10378647,3752
"2022",22,6,63,8,10387683,10390929,3246
"2117",22,2,125,9,10394248,10397920,3672
"2216",22,4,133,10,10401119,10405604,4485
"2313",22,4,49,11,10408769,10412728,3959
"2515",22,4,103,12,10418852,10423117,4265
"2619",22,4,31,13,10426703,10431134,4431
"2816",22,2,107,14,10439665,10443250,3585
"2915",22,4,109,15,10446602,10452480,5878
"3017",22,6,57,16,10455992,10459784,3792
"3113",22,5,98,17,10462916,10467121,4205
"3216",22,6,39,18,10470267,10475031,4764
"3415",22,4,19,19,10480656,10483975,3319
"3616",22,1,106,20,10491685,10494311,2626
"3711",22,3,24,21,10497090,10500042,2952
"3916",22,3,138,22,10507093,10511031,3938
"4015",22,5,80,23,10514217,10517809,3592
"4117",22,3,12,24,10521001,10524500,3499
"4316",22,3,54,25,10532463,10535222,2759
"4512",22,2,17,26,10541433,10545199,3766
"4711",22,5,74,27,10550930,10555455,4525
"4817",22,6,51,28,10558667,10562253,3586
"5016",22,2,65,29,10568377,10571289,2912
"5112",22,2,119,30,10574695,10578087,3392
"5216",22,5,122,31,10581026,10583718,2692
"5316",22,6,69,32,10587443,10590556,3113
"5416",22,5,62,33,10594920,10598752,3832
"5517",22,1,124,34,10603258,10606776,3518
"5613",22,4,67,35,10609895,10612867,2972
"5715",22,5,68,36,10615700,10619278,3578
"5815",22,2,41,37,10622130,10624923,2793
"6015",22,1,64,38,10631574,10634746,3172
"6115",22,3,108,39,10637938,10640364,2426
"6219",22,3,18,40,10643303,10645862,2559
"6417",22,5,14,41,10653199,10656917,3718
"6615",22,4,91,42,10663442,10666961,3519
"6714",22,5,26,43,10669779,10673731,3952
"6916",22,6,105,44,10681768,10684881,3113
"7017",22,1,76,45,10687793,10690538,2745
"7115",22,3,66,46,10693464,10696883,3419
"7215",22,3,126,47,10700148,10704367,4219
"7312",22,2,59,48,10707379,10710784,3405
"7415",22,3,72,49,10713950,10717202,3252
"7516",22,5,128,50,10720941,10725326,4385
"7616",22,2,71,51,10728211,10730330,2119
"7713",22,6,27,52,10733456,10737688,4232
"7916",22,5,116,53,10743592,10747910,4318
"8015",22,5,104,54,10752183,10756814,4631
"8115",22,6,75,55,10762012,10766237,4225
"8216",22,1,94,56,10770023,10773661,3638
"8316",22,1,52,57,10776960,10779092,2132
"8513",22,2,95,58,10785483,10788529,3046
"8618",22,5,44,59,10791415,10793827,2412
"8817",22,2,137,60,10799391,10802577,3186
"8912",22,4,121,61,10805343,10808195,2852
"9013",22,3,36,62,10811187,10814087,2900
"9217",22,1,70,63,10820277,10823590,3313
"9315",22,6,81,64,10826808,10831040,4232
"9415",22,3,42,65,10833859,10836644,2785
"9614",22,6,45,66,11042722,11045601,2879
"9816",22,4,115,67,11051339,11054531,3192
"9914",22,5,134,68,11057750,11060849,3099
"10019",22,4,61,69,11064001,11067699,3698
"10117",22,5,8,70,11070978,11074077,3099
"10316",22,6,117,71,11080182,11082534,2352
"10415",22,1,82,72,11085739,11087898,2159
"10512",22,4,85,73,11090778,11094416,3638
"10615",22,4,73,74,11097415,11101700,4285
"10715",22,2,35,75,11108451,11111230,2779
"10913",22,5,2,76,11117661,11121120,3459
"11117",22,4,79,77,11127857,11131576,3719
"11218",22,4,25,78,11135268,11138700,3432
"11416",22,2,23,79,11144511,11146950,2439
"11618",22,1,88,80,11153341,11156080,2739
"11717",22,5,32,81,11159125,11162431,3306
"11913",22,6,93,82,11168635,11171754,3119
"12017",22,2,53,83,11174487,11177299,2812
"12219",22,1,112,84,11182817,11184916,2099
"12314",22,2,11,85,11187962,11190087,2125
"12513",22,1,118,86,11196045,11198398,2353
"12613",22,3,120,87,11201270,11204495,3225
"12714",22,1,34,88,11207221,11210513,3292
"12918",22,5,56,89,11217530,11221109,3579
"13013",22,1,10,90,11224002,11226520,2518
"13218",22,2,83,91,11233492,11236223,2731
"13315",22,1,130,92,11239336,11242874,3538
"13415",22,3,90,93,11245794,11249386,3592
"13513",22,1,16,94,11252445,11255003,2558
"13712",22,5,110,95,11261068,11264193,3125
"13814",22,2,131,96,11267712,11269798,2086
"13914",22,4,97,97,11272663,11275602,2939
"14015",22,3,84,98,11278488,11281913,3425
"14121",22,1,22,99,11285192,11287971,2779
"14318",22,1,100,100,11294422,11296948,2526
"14414",22,4,43,101,11299793,11302412,2619
"14618",22,6,21,102,11308643,11311282,2639
"14813",22,3,30,103,11317487,11320413,2926
"15015",22,5,86,104,11325851,11329083,3232
"15118",22,2,5,105,11333688,11336353,2665
"15314",22,6,3,106,11342984,11346476,3492
"15516",22,5,20,107,11352281,11355146,2865
"15718",22,6,123,108,11361198,11364536,3338
"15814",22,3,96,109,11367669,11370407,2738
"15917",22,1,40,110,11373406,11376279,2873
"16120",22,3,114,111,11383602,11387814,4212
"16212",22,5,50,112,11390746,11393932,3186
"16413",22,5,38,113,11399490,11403182,3692
"16610",22,4,13,114,11409266,11412459,3193
"16816",22,4,37,115,11418083,11421515,3432
"17016",22,4,1,116,11427646,11430552,2906
"17214",22,3,6,117,11436843,11439602,2759
"17411",22,6,111,118,11447066,11450025,2959
"17516",22,6,129,119,11452710,11458188,5478
"17616",22,2,77,120,11462207,11464493,2286
"17712",22,1,136,121,11469164,11472649,3485
"17816",22,3,48,122,11475315,11477101,1786
"18016",22,1,4,123,11482972,11485378,2406
"18216",22,2,29,124,11491249,11494308,3059
"18415",22,6,33,125,11500039,11503412,3373
"18615",22,2,101,126,11509243,11512315,3072
"18715",22,4,127,127,11515007,11518380,3373
"18815",22,4,7,128,11521392,11524171,2779
"19016",22,6,15,129,11529915,11532501,2586
"19219",22,4,55,130,11537872,11540251,2379
"19314",22,6,99,131,11543177,11546209,3032
"19414",22,6,87,132,11549861,11552967,3106
"19513",22,2,113,133,11555626,11558085,2459
"19616",22,3,60,134,11561004,11563809,2805
"19715",22,3,102,135,11566708,11569380,2672
"19816",22,6,135,136,11572553,11577684,5131
"19917",22,3,132,137,11581436,11584755,3319
"20016",22,1,46,138,11588380,11591193,2813
"10102",23,4,24,1,12443165,12447723,4558
"1280",23,5,19,2,12453188,12457033,3845
"14100",23,3,101,3,12463504,12467116,3612
"1580",23,1,3,4,12470315,12473407,3092
"1780",23,2,4,5,12479738,12482597,2859
"1980",23,3,125,6,12487828,12493626,5798
"2023",23,4,138,7,12497045,12501230,4185
"2118",23,6,86,8,12504462,12508168,3706
"2217",23,2,118,9,12511327,12515045,3718
"2314",23,5,91,10,12518110,12522149,4039
"2419",23,4,120,11,12525281,12530493,5212
"2516",23,6,80,12,12533418,12536584,3166
"2620",23,2,136,13,12539436,12543028,3592
"2714",23,6,26,14,12545787,12549172,3385
"2916",23,2,106,15,12555397,12557916,2519
"3018",23,3,59,16,12561161,12565060,3899
"3114",23,2,16,17,12568145,12571231,3086
"3316",23,3,71,18,12577109,12580141,3032
"3416",23,5,73,19,12583033,12587845,4812
"3515",23,4,90,20,12590970,12594183,3213
"3617",23,1,9,21,12597295,12601746,4451
"3815",23,4,42,22,12607531,12611230,3699
"4016",23,1,111,23,12616921,12619980,3059
"4118",23,2,88,24,12622905,12626651,3746
"4214",23,2,112,25,12629563,12634294,4731
"4317",23,4,132,26,12637300,12642998,5698
"4415",23,4,48,27,12645703,12647902,2199
"4616",23,6,92,28,12654727,12661591,6864
"4712",23,5,79,29,12665036,12667882,2846
"4818",23,4,30,30,12670727,12673806,3079
"5017",23,6,44,31,12679671,12681897,2226
"5217",23,2,94,32,12688168,12691826,3658
"5317",23,4,102,33,12695218,12703415,8197
"5417",23,6,110,34,12706168,12709647,3479
"5518",23,4,12,35,12712632,12715058,2426
"5716",23,3,83,36,12720903,12729186,8283
"5816",23,1,21,37,12731865,12734710,2845
"6016",23,1,27,38,12740549,12743814,3265
"6220",23,5,109,39,12749492,12757902,8410
"6315",23,6,14,40,12760921,12764533,3612
"6517",23,2,130,41,12771217,12775329,4112
"6616",23,2,34,42,12778435,12781640,3205
"6815",23,5,85,43,12787778,12791583,3805
"6917",23,3,35,44,12794935,12797407,2472
"7116",23,6,32,45,12804112,12808497,4385
"7313",23,6,38,46,12814261,12818793,4532
"7517",23,6,68,47,12824758,12833201,8443
"7617",23,6,98,48,12836493,12841125,4632
"7714",23,3,113,49,12844177,12849335,5158
"7816",23,2,28,50,12852361,12854926,2565
"8016",23,1,87,51,12860977,12864343,3366
"8116",23,1,99,52,12868141,12871853,3712
"8217",23,3,47,53,12875192,12879710,4518
"8413",23,3,131,54,12885508,12887887,2379
"8514",23,4,72,55,12890680,12898263,7583
"8619",23,2,40,56,12901416,12905161,3745
"8818",23,3,77,57,12912165,12914691,2526
"8913",23,1,75,58,12917776,12921155,3379
"9014",23,3,29,59,12924107,12928632,4525
"9218",23,2,58,60,12934890,12939242,4352
"9316",23,2,70,61,12942600,12947519,4919
"9416",23,3,119,62,12951011,12956828,5817
"9515",23,1,15,63,12959641,12962020,2379
"9713",23,2,10,64,12968324,12971257,2933
"9915",23,1,39,65,12977155,12979087,1932
"10118",23,3,11,66,13180473,13183418,2945
"10317",23,1,69,67,13189076,13191875,2799
"10416",23,4,84,68,13194501,13199919,5418
"10513",23,6,104,69,13203118,13210908,7790
"10616",23,3,95,70,13214367,13217932,3565
"10716",23,6,50,71,13221245,13224443,3198
"10914",23,1,93,72,13230881,13233133,2252
"11013",23,4,126,73,13235992,13242510,6518
"11118",23,6,128,74,13245742,13255425,9683
"11219",23,1,63,75,13258537,13262769,4232
"11313",23,5,67,76,13265808,13269906,4098
"11417",23,3,53,77,13273112,13276477,3365
"11619",23,3,137,78,13281902,13285521,3619
"11718",23,4,54,79,13289092,13291658,2566
"11914",23,2,76,80,13298223,13302801,4578
"12018",23,5,43,81,13307033,13310278,3245
"12220",23,6,62,82,13315529,13319515,3986
"12315",23,2,46,83,13322660,13326625,3965
"12514",23,5,37,84,13333956,13340380,6424
"12715",23,6,2,85,13346731,13353742,7011
"12919",23,3,65,86,13360113,13362192,2079
"13014",23,3,107,87,13365118,13368010,2892
"13119",23,5,49,88,13371316,13374508,3192
"13316",23,1,51,89,13379486,13382805,3319
"13514",23,5,25,90,13387823,13391362,3539
"13713",23,6,74,91,13396640,13400358,3718
"13815",23,5,97,92,13403631,13406969,3338
"13915",23,5,55,93,13410008,13412034,2026
"14016",23,4,6,94,13414766,13419384,4618
"14217",23,3,89,95,13425835,13429507,3672
"14319",23,6,134,96,13432626,13435692,3066
"14415",23,6,20,97,13438851,13447341,8490
"14619",23,1,117,98,13453705,13455791,2086
"14714",23,2,52,99,13458630,13461489,2859
"14920",23,6,122,100,13467054,13470092,3038
"15016",23,4,66,101,13473805,13477063,3258
"15119",23,5,103,102,13481169,13484200,3031
"15218",23,6,116,103,13487153,13491458,4305
"15315",23,5,133,104,13494623,13497982,3359
"15416",23,3,41,105,13500861,13506279,5418
"15615",23,1,81,106,13512050,13514289,2239
"15719",23,1,105,107,13516115,13518201,2086
"15815",23,4,114,108,13520907,13525985,5078
"15918",23,5,61,109,13529284,13532310,3026
"16018",23,4,18,110,13535042,13538520,3478
"16213",23,4,78,111,13543619,13545724,2105
"16321",23,2,64,112,13549890,13553581,3691
"16414",23,5,1,113,13557654,13565077,7423
"16611",23,1,123,114,13574041,13578252,4211
"16719",23,5,127,115,13581578,13584250,2672
"16817",23,4,108,116,13587149,13591294,4145
"16918",23,4,60,117,13594760,13599858,5098
"17017",23,1,135,118,13602990,13606262,3272
"17120",23,6,56,119,13610241,13615252,5011
"17215",23,2,124,120,13618351,13621203,2852
"17316",23,1,57,121,13624075,13627601,3526
"17412",23,1,129,122,13630926,13636764,5838
"17517",23,5,31,123,13640223,13644728,4505
"17713",23,3,5,124,13650299,13653118,2819
"17916",23,3,17,125,13659116,13664054,4938
"18121",23,3,23,126,13670479,13673637,3158
"18313",23,2,22,127,13679042,13686326,7284
"18512",23,5,13,128,13692797,13697095,4298
"18716",23,2,100,129,13702127,13706678,4551
"18816",23,5,121,130,13709544,13714342,4798
"18915",23,6,8,131,13717668,13720747,3079
"19120",23,4,96,132,13737734,13741399,3665
"19220",23,4,36,133,13744505,13746857,2352
"19415",23,2,82,134,13752775,13755947,3172
"19514",23,1,33,135,13759339,13762771,3432
"19716",23,1,45,136,13768589,13771508,2919
"19918",23,5,115,137,13777379,13780218,2839
"20017",23,5,7,138,13783137,13786729,3592
"10103",24,4,47,1,15139663,15142556,2893
"1290",24,5,90,2,15148114,15152605,4491
"13102",24,3,100,3,15155444,15159323,3879
"14101",24,4,53,4,15162275,15166054,3779
"1680",24,6,97,5,15171825,15174537,2712
"1790",24,6,55,6,15177376,15179382,2006
"18100",24,1,44,7,15182567,15184880,2313
"2024",24,6,73,8,15191524,15195749,4225
"2119",24,1,68,9,15199321,15202473,3152
"2218",24,6,37,10,15205386,15208251,2865
"2420",24,2,105,11,15213716,15217135,3419
"2517",24,5,78,12,15220793,15222792,1999
"2621",24,6,31,13,15225925,15229877,3952
"2817",24,4,11,14,15235615,15237694,2079
"3019",24,6,61,15,15244585,15247257,2672
"3115",24,2,93,16,15250469,15252895,2426
"3217",24,1,2,17,15256007,15259999,3992
"3417",24,1,122,18,15266177,15270655,4478
"3516",24,4,131,19,15273927,15277266,3339
"3618",24,4,113,20,15280118,15282004,1886
"3712",24,1,8,21,15285183,15290528,5345
"3917",24,2,75,22,15297158,15300491,3333
"4017",24,6,7,23,15303843,15306175,2332
"4215",24,3,106,24,15312386,15314632,2246
"4318",24,4,89,25,15318171,15320450,2279
"4416",24,1,92,26,15323682,15327301,3619
"4513",24,2,45,27,15331213,15333478,2265
"4713",24,3,94,28,15339816,15343215,3399
"4819",24,3,124,29,15346154,15349672,3518
"4913",24,1,104,30,15352572,15355857,3285
"5018",24,6,91,31,15358836,15361295,2459
"5113",24,5,96,32,15364121,15367892,3771
"5218",24,1,98,33,15371164,15376836,5672
"5318",24,1,134,34,15380275,15383307,3032
"5418",24,6,115,35,15386872,15389598,2726
"5519",24,3,112,36,15392483,15396848,4365
"5614",24,4,95,37,15399954,15403479,3525
"5717",24,4,17,38,15407465,15410817,3352
"5918",24,3,16,39,15417701,15422219,4518
"6116",24,3,58,40,15427710,15431855,4145
"6221",24,2,15,41,15435001,15437926,2925
"6418",24,1,128,42,15445324,15450422,5098
"6518",24,4,83,43,15453387,15457512,4125
"6617",24,3,88,44,15460598,15463130,2532
"6715",24,2,51,45,15468335,15471474,3139
"6918",24,2,99,46,15477365,15482017,4652
"7018",24,6,103,47,15485662,15488474,2812
"7117",24,5,30,48,15491327,15493666,2339
"7314",24,5,108,49,15498877,15502203,3326
"7416",24,5,54,50,15505295,15507794,2499
"7618",24,6,85,51,15515731,15519436,3705
"7715",24,5,36,52,15522942,15525447,2505
"7917",24,1,56,53,15530952,15535111,4159
"8017",24,3,136,54,15538516,15541215,2699
"8117",24,1,80,55,15544474,15548566,4092
"8218",24,2,135,56,15553144,15555636,2492
"8317",24,6,13,57,15559801,15564873,5072
"8515",24,5,138,58,15570611,15573403,2792
"8620",24,3,40,59,15576362,15579615,3253
"8819",24,5,72,60,15585425,15587798,2373
"8914",24,4,137,61,15590464,15594609,4145
"9015",24,5,102,62,15598108,15601266,3158
"9116",24,2,123,63,15604372,15609803,5431
"9219",24,2,129,64,15612609,15617687,5078
"9317",24,2,21,65,15620519,15624671,4152
"9516",24,2,3,66,15669041,15672706,3665
"9714",24,3,28,67,15678531,15682976,4445
"9916",24,5,114,68,15688568,15696897,8329
"10020",24,4,125,69,15699903,15703209,3306
"10119",24,3,130,70,15706387,15709226,2839
"10217",24,5,84,71,15712292,15714478,2186
"10318",24,2,39,72,15717850,15720169,2319
"10514",24,5,6,73,15726846,15731825,4979
"10717",24,4,59,74,15737276,15740315,3039
"10816",24,1,110,75,15743707,15747032,3325
"10915",24,5,12,76,15750038,15752117,2079
"11119",24,5,132,77,15757928,15761041,3113
"11220",24,1,14,78,15764373,15767365,2992
"11418",24,2,111,79,15773629,15777088,3459
"11512",24,3,10,80,15780120,15782612,2492
"11719",24,2,63,81,15788331,15790216,1885
"11817",24,4,29,82,15793775,15795941,2166
"12019",24,1,116,83,15802306,15806444,4138
"12117",24,4,35,84,15811309,15813361,2052
"12316",24,6,1,85,15819706,15822065,2359
"12515",24,4,41,86,15827130,15831554,4424
"12716",24,4,77,87,15837059,15840618,3559
"12815",24,4,107,88,15844223,15846622,2399
"12920",24,5,42,89,15849448,15853026,3578
"13120",24,4,23,90,15859198,15860784,1586
"13317",24,4,101,91,15867155,15870240,3085
"13416",24,2,33,92,15873153,15876805,3652
"13615",24,1,74,93,15884222,15890832,6610
"13714",24,2,117,94,15893825,15896171,2346
"13816",24,6,19,95,15899070,15904441,5371
"14017",24,5,18,96,15912338,15914950,2612
"14218",24,6,109,97,15919955,15922747,2792
"14320",24,5,24,98,15925506,15928685,3179
"14513",24,5,120,99,15934503,15936422,1919
"14620",24,2,57,100,15939301,15941907,2606
"14715",24,3,64,101,15944866,15947158,2292
"14814",24,6,43,102,15950671,15953903,3232
"15017",24,1,62,103,15959041,15961766,2725
"15120",24,3,52,104,15964972,15967711,2739
"15316",24,4,65,105,15974668,15976481,1813
"15417",24,5,126,106,15979346,15983991,4645
"15517",24,1,20,107,15987437,15992408,4971
"15720",24,4,5,108,16000132,16002624,2492
"15919",24,5,60,109,16009709,16012661,2952
"16019",24,3,34,110,16015733,16018879,3146
"16214",24,6,49,111,16025477,16028502,3025
"16415",24,6,67,112,16035440,16037379,1939
"16518",24,1,50,113,16040731,16043190,2459
"16720",24,4,71,114,16048522,16050527,2005
"16818",24,3,4,115,16053539,16055598,2059
"17018",24,6,133,116,16060723,16063689,2966
"17121",24,3,82,117,16066914,16069247,2333
"17216",24,6,79,118,16072226,16074525,2299
"17317",24,6,25,119,16078457,16081522,3065
"17518",24,1,26,120,16087580,16090172,2592
"17714",24,2,87,121,16095837,16102215,6378
"17817",24,2,81,122,16104994,16107439,2445
"17917",24,4,119,123,16110498,16113437,2939
"18017",24,3,46,124,16117129,16119641,2512
"18217",24,1,32,125,16125126,16130137,5011
"18416",24,3,118,126,16136475,16138421,1946
"18513",24,2,9,127,16141980,16144592,2612
"18717",24,3,22,128,16150797,16155455,4658
"18916",24,1,38,129,16161239,16165551,4312
"19121",24,6,121,130,16170936,16175254,4318
"19221",24,3,76,131,16179366,16183538,4172
"19315",24,5,48,132,16186224,16187623,1399
"19515",24,3,70,133,16194127,16197226,3099
"19617",24,2,27,134,16200379,16202864,2485
"19817",24,1,86,135,16208369,16210628,2259
"19919",24,6,127,136,16213867,16217125,3258
"20018",24,5,66,137,16220224,16223790,3566
"20117",24,2,69,138,16227828,16229934,2106
"10104",25,5,23,1,17751073,17754305,3232
"12100",25,4,34,2,17760603,17763801,3198
"14102",25,2,62,3,17772731,17779955,7224
"1590",25,2,32,4,17803693,17814462,10769
"17100",25,5,113,5,17820494,17824372,3878
"18101",25,3,63,6,17828538,17841140,12602
"1990",25,4,4,7,17849004,17856374,7370
"2120",25,2,98,8,17864131,17867177,3046
"2219",25,2,20,9,17870608,17874594,3986
"2421",25,5,35,10,17882738,17886463,3725
"2622",25,3,129,11,17893013,17897132,4119
"2715",25,1,37,12,17903730,17910920,7190
"2917",25,1,97,13,17982208,17986579,4371
"3020",25,4,106,14,17992330,17995982,3652
"3116",25,4,136,15,18000307,18004452,4145
"3218",25,5,95,16,18008044,18013429,5385
"3317",25,2,74,17,18018368,18023665,5297
"3418",25,1,91,18,18028164,18032442,4278
"3517",25,3,21,19,18035408,18039220,3812
"3713",25,4,88,20,18045238,18048130,2892
"3816",25,2,116,21,18054534,18057213,2679
"3918",25,5,131,22,18060758,18064251,3493
"4018",25,2,2,23,18068482,18070515,2033
"4216",25,6,18,24,18078912,18083437,4525
"4417",25,1,7,25,18093313,18097211,3898
"4617",25,6,120,26,18105549,18108408,2859
"4714",25,4,130,27,18112593,18115865,3272
"4820",25,6,48,28,18122562,18124661,2099
"5019",25,5,137,29,18132432,18135084,2652
"5114",25,6,138,30,18141502,18144634,3132
"5219",25,1,85,31,18151785,18156963,5178
"5319",25,2,104,32,18160442,18163594,3152
"5419",25,5,5,33,18167046,18170138,3092
"5615",25,6,72,34,18177242,18180081,2839
"5718",25,1,49,35,18184799,18188251,3452
"5919",25,5,41,36,18195402,18198581,3179
"6117",25,4,28,37,18204312,18207058,2746
"6316",25,2,26,38,18214828,18218280,3452
"6519",25,1,79,39,18226437,18230729,4292
"6618",25,5,89,40,18234934,18237713,2779
"6716",25,3,75,41,18244551,18249209,4658
"6816",25,1,25,42,18252961,18255067,2106
"7019",25,5,53,43,18261605,18265356,3751
"7216",25,3,117,44,18272920,18275699,2779
"7315",25,5,125,45,18280297,18283996,3699
"7417",25,4,112,46,18289414,18291520,2106
"7518",25,6,60,47,18295852,18298784,2932
"7619",25,5,83,48,18302650,18305568,2918
"7716",25,3,135,49,18308860,18312625,3765
"7817",25,2,128,50,18316031,18321982,5951
"7918",25,6,42,51,18325108,18329139,4031
"8118",25,4,52,52,18338856,18341808,2952
"8318",25,3,3,53,18347846,18350591,2745
"8516",25,5,11,54,18357342,18359935,2593
"8713",25,5,29,55,18387551,18390263,2712
"8915",25,6,132,56,18403385,18409103,5718
"9016",25,5,71,57,18413122,18415481,2359
"9117",25,4,100,58,18418886,18421565,2679
"9220",25,3,57,59,18426397,18428696,2299
"9318",25,3,33,60,18433161,18436026,2865
"9517",25,4,22,61,18442791,18446982,4191
"9715",25,3,93,62,18454773,18458358,3585
"9817",25,4,10,63,18462390,18465756,3366
"10021",25,4,70,64,18474526,18478997,4471
"10120",25,2,86,65,18483989,18486401,2412
"10218",25,3,87,66,18637019,18644123,7104
"10319",25,2,38,67,18647296,18649921,2625
"10515",25,1,61,68,18656319,18658511,2192
"10617",25,1,67,69,18661250,18663682,2432
"10718",25,3,45,70,18667908,18670860,2952
"10916",25,1,13,71,18677271,18680916,3645
"11120",25,3,111,72,18686947,18690260,3313
"11221",25,6,90,73,18693152,18695751,2599
"11314",25,6,114,74,18717922,18724733,6811
"11419",25,1,103,75,18729358,18732030,2672
"11513",25,3,99,76,18747631,18751497,3866
"11620",25,4,118,77,18755989,18761440,5451
"11720",25,4,94,78,18765152,18770083,4931
"11818",25,4,40,79,18779620,18783578,3958
"12020",25,2,134,80,18793894,18800012,6118
"12118",25,3,27,81,18811308,18818692,7384
"12317",25,3,69,82,18829315,18831860,2545
"12417",25,5,119,83,18841410,18845362,3952
"12516",25,5,65,84,18851587,18854865,3278
"12614",25,6,66,85,18860916,18864642,3726
"12717",25,4,76,86,18873712,18878150,4438
"12816",25,6,78,87,18884848,18888526,3678
"12921",25,2,44,88,18940180,18943299,3119
"13121",25,1,115,89,18949950,18953249,3299
"13219",25,2,14,90,18956728,18959607,2879
"13417",25,6,12,91,18971582,18974461,2879
"13616",25,4,82,92,18982412,18985157,2745
"13715",25,6,30,93,18987903,18991155,3252
"13916",25,4,124,94,18996900,19000038,3138
"14018",25,4,46,95,19003124,19006636,3512
"14219",25,3,81,96,19013940,19017645,3705
"14321",25,5,17,97,19020837,19023743,2906
"14514",25,6,84,98,19029674,19034779,5105
"14621",25,6,108,99,19039224,19043096,3872
"14716",25,1,55,100,19046128,19048334,2206
"14815",25,3,15,101,19051080,19055818,4738
"15018",25,3,51,102,19061736,19066227,4491
"15219",25,6,36,103,19071545,19073658,2113
"15418",25,1,43,104,19079989,19083655,3666
"15616",25,5,59,105,19090152,19095970,5818
"15721",25,4,58,106,19099395,19102454,3059
"15816",25,1,73,107,19105246,19108585,3339
"15920",25,2,56,108,19114083,19118448,4365
"16020",25,4,16,109,19121867,19124506,2639
"16215",25,6,24,110,19131197,19134522,3325
"16416",25,2,8,111,19142386,19148004,5618
"16612",25,6,126,112,19155415,19158946,3531
"16721",25,6,102,113,19162239,19168183,5944
"16819",25,2,80,114,19172568,19174661,2093
"16919",25,1,1,115,19177906,19180785,2879
"17122",25,5,77,116,19187103,19190421,3318
"17217",25,1,133,117,19194453,19196813,2360
"17318",25,5,101,118,19200405,19202797,2392
"17413",25,2,50,119,19206882,19209947,3065
"17617",25,3,105,120,19215712,19218791,3079
"17715",25,1,31,121,19222136,19225455,3319
"17918",25,1,19,122,19231440,19233465,2025
"18122",25,3,39,123,19242396,19246014,3618
"18314",25,1,109,124,19252019,19254191,2172
"18417",25,1,127,125,19257090,19259383,2293
"18514",25,2,68,126,19262248,19265381,3133
"18616",25,5,47,127,19268293,19270985,2692
"18817",25,4,64,128,19277163,19281588,4425
"18917",25,5,107,129,19284960,19287999,3039
"19017",25,3,9,130,19293263,19296329,3066
"19222",25,1,121,131,19310684,19314089,3405
"19316",25,6,96,132,19350389,19354514,4125
"19416",25,2,110,133,19357999,19360392,2393
"19516",25,3,123,134,19363584,19366364,2780
"19618",25,6,54,135,19371255,19374140,2885
"19818",25,2,122,136,19380371,19382990,2619
"19920",25,2,92,137,19388089,19390214,2125
"20019",25,6,6,138,19394093,19396792,2699
"10105",26,5,28,1,934780,939025,4245
"12101",26,5,88,2,945976,949901,3925
"13103",26,4,39,3,953353,956052,2699
"15100",26,1,84,4,961837,965862,4025
"1690",26,3,2,5,974218,977684,3466
"18102",26,5,118,6,985101,988060,2959
"19100",26,1,72,7,994818,997210,2392
"2025",26,5,46,8,1000609,1004634,4025
"2220",26,6,41,9,1012711,1016290,3579
"2422",26,1,6,10,1023374,1026299,2925
"2623",26,6,125,11,1033843,1036376,2533
"2716",26,2,19,12,1039994,1043226,3232
"2918",26,6,23,13,1052616,1055888,3272
"3117",26,2,7,14,1062646,1067810,5164
"3318",26,2,61,15,1074941,1077687,2746
"3419",26,6,5,16,1080992,1083585,2593
"3619",26,2,79,17,1090756,1093788,3032
"3714",26,1,66,18,1096780,1099039,2259
"3817",26,3,122,19,1102158,1104144,1986
"3919",26,2,55,20,1106843,1109162,2319
"4019",26,1,96,21,1112714,1115166,2452
"4119",26,5,40,22,1119198,1122630,3432
"4319",26,4,105,23,1128648,1131260,2612
"4418",26,2,91,24,1134739,1138451,3712
"4514",26,3,68,25,1141383,1144462,3079
"4618",26,6,137,26,1148281,1151819,3538
"4715",26,1,54,27,1156025,1158490,2465
"4914",26,6,59,28,1166207,1169073,2866
"5020",26,2,109,29,1172432,1176257,3825
"5115",26,5,58,30,1178976,1181742,2766
"5220",26,4,3,31,1185107,1188526,3419
"5420",26,3,98,32,1194897,1199328,4431
"5520",26,4,57,33,1203607,1207645,4038
"5616",26,6,83,34,1210924,1214603,3679
"5719",26,5,124,35,1217802,1221734,3932
"5817",26,3,14,36,1224706,1229277,4571
"6017",26,1,42,37,1236148,1240267,4119
"6222",26,2,85,38,1247251,1250729,3478
"6317",26,5,16,39,1254088,1257414,3326
"6520",26,4,123,40,1263645,1266510,2865
"6619",26,3,104,41,1270122,1272522,2400
"6717",26,4,75,42,1275853,1280738,4885
"6817",26,2,49,43,1284237,1287382,3145
"7020",26,2,31,44,1293074,1295906,2832
"7217",26,1,120,45,1303003,1306589,3586
"7316",26,1,114,46,1310447,1315052,4605
"7418",26,4,111,47,1318471,1321197,2726
"7519",26,5,130,48,1324509,1328194,3685
"7620",26,5,136,49,1331253,1335145,3892
"7717",26,2,103,50,1338137,1342729,4592
"7818",26,3,8,51,1346920,1349713,2793
"8018",26,6,71,52,1357903,1360575,2672
"8119",26,5,64,53,1366420,1369692,3272
"8219",26,6,101,54,1372804,1376017,3213
"8319",26,2,25,55,1378816,1382521,3705
"8517",26,4,63,56,1388758,1391544,2786
"8621",26,3,56,57,1394563,1397642,3079
"8714",26,4,15,58,1400481,1402380,1899
"8916",26,5,10,59,1410017,1412776,2759
"9118",26,1,60,60,1419374,1423139,3765
"9221",26,4,87,61,1425971,1429637,3666
"9319",26,4,93,62,1432656,1435201,2545
"9417",26,3,44,63,1439127,1440759,1632
"9615",26,5,34,64,1446883,1449256,2373
"9818",26,6,65,65,1457073,1459652,2579
"9917",26,6,119,66,1492933,1496725,3792
"10022",26,6,95,67,1500044,1503683,3639
"10121",26,5,4,68,1506735,1509067,2332
"10320",26,6,29,69,1515565,1519790,4225
"10516",26,6,107,70,1525861,1528060,2199
"10618",26,1,78,71,1530759,1533418,2659
"10719",26,5,82,72,1536457,1541728,5271
"10817",26,1,102,73,1544441,1547066,2625
"10917",26,6,47,74,1551065,1554584,3519
"11121",26,6,89,75,1560242,1563514,3272
"11222",26,3,32,76,1566353,1569165,2812
"11420",26,2,133,77,1574950,1577922,2972
"11514",26,2,13,78,1580860,1584559,3699
"11721",26,1,138,79,1590697,1593396,2699
"11819",26,5,106,80,1596082,1598454,2372
"11915",26,1,36,81,1601073,1603052,1979
"12119",26,3,116,82,1609364,1612202,2838
"12221",26,4,135,83,1615355,1617700,2345
"12318",26,5,76,84,1620566,1624205,3639
"12418",26,3,74,85,1627330,1631369,4039
"12517",26,1,48,86,1634068,1636693,2625
"12718",26,4,27,87,1643677,1647489,3812
"12922",26,5,94,88,1653374,1656359,2985
"13015",26,4,21,89,1659332,1663956,4624
"13220",26,4,9,90,1670494,1673487,2993
"13418",26,3,38,91,1679578,1681637,2059
"13617",26,3,92,92,1687175,1691206,4031
"13716",26,4,69,93,1695299,1697058,1759
"13817",26,1,108,94,1700117,1702216,2099
"13917",26,5,52,95,1705348,1707740,2392
"14122",26,4,51,96,1713871,1716531,2660
"14322",26,2,67,97,1724214,1726160,1946
"14416",26,5,112,98,1728999,1731325,2326
"14515",26,4,45,99,1733997,1736176,2179
"14717",26,4,99,100,1742214,1747686,5472
"14816",26,3,86,101,1750745,1752657,1912
"14921",26,2,73,102,1755929,1758408,2479
"15019",26,1,90,103,1762387,1765139,2752
"15121",26,6,17,104,1768378,1773263,4885
"15317",26,4,129,105,1779361,1782453,3092
"15419",26,1,18,106,1785098,1787624,2526
"15617",26,4,33,107,1793135,1796641,3506
"15817",26,1,30,108,1803758,1806204,2446
"16021",26,4,117,109,1811629,1814401,2772
"16121",26,6,11,110,1817646,1820286,2640
"16322",26,1,12,111,1826310,1829455,3145
"16519",26,5,22,112,1835487,1839345,3858
"16722",26,2,37,113,1845156,1847509,2353
"16920",26,3,26,114,1853713,1855832,2119
"17123",26,3,62,115,1865696,1868387,2691
"17218",26,5,100,116,1872126,1874639,2513
"17319",26,6,53,117,1878704,1881429,2725
"17519",26,1,24,118,1889313,1891805,2492
"17716",26,6,77,119,1898630,1901682,3052
"17818",26,6,131,120,1904781,1907140,2359
"17919",26,6,113,121,1910026,1912671,2645
"18018",26,3,110,122,1915657,1917463,1806
"18123",26,3,50,123,1920995,1924607,3612
"18315",26,4,81,124,1930631,1933677,3046
"18418",26,3,134,125,1937482,1940261,2779
"18515",26,2,97,126,1943253,1946239,2986
"18617",26,2,115,127,1948958,1951957,2999
"18718",26,3,20,128,1954776,1957208,2432
"18918",26,2,127,129,1963799,1966491,2692
"19018",26,1,126,130,1971989,1975395,3406
"19122",26,6,35,131,1980834,1983312,2478
"19317",26,3,128,132,1989483,1991862,2379
"19417",26,2,1,133,1995294,1997326,2032
"19619",26,5,70,134,2003811,2006583,2772
"19717",26,1,132,135,2009842,2012334,2492
"19819",26,2,121,136,2015227,2017712,2485
"19921",26,2,43,137,2021205,2023870,2665
"20118",26,3,80,138,2030194,2035433,5239
"10106",27,4,56,1,3224900,3229172,4272
"1180",27,3,133,2,3232611,3235783,3172
"12102",27,3,49,3,3239262,3242167,2905
"14103",27,1,47,4,3248418,3250724,2306
"16100",27,6,58,5,3256968,3260107,3139
"17101",27,6,64,6,3263006,3265965,2959
"18103",27,6,28,7,3268711,3272250,3539
"2026",27,3,7,8,3279467,3282666,3199
"2221",27,6,40,9,3293409,3297487,4078
"2423",27,4,110,10,3304265,3308396,4131
"2518",27,2,48,11,3311242,3314467,3225
"2717",27,4,8,12,3320892,3325403,4511
"2919",27,2,132,13,3331541,3336206,4665
"3021",27,1,107,14,3339172,3341930,2758
"3118",27,4,128,15,3345016,3349854,4838
"3219",27,3,13,16,3353080,3357238,4158
"3420",27,6,10,17,3363309,3366442,3133
"3620",27,3,37,18,3373072,3378690,5618
"3818",27,6,130,19,3384741,3389540,4799
"3920",27,5,45,20,3392778,3396464,3686
"4120",27,6,88,21,3402535,3406800,4265
"4217",27,4,44,22,3409759,3413877,4118
"4419",27,3,67,23,3419555,3422034,2479
"4515",27,1,29,24,3424560,3427132,2572
"4716",27,1,119,25,3434343,3437329,2986
"4821",27,1,59,26,3440747,3444959,4212
"4915",27,6,46,27,3448125,3451650,3525
"5116",27,4,2,28,3457641,3461766,4125
"5320",27,6,118,29,3467837,3472469,4632
"5421",27,4,104,30,3475428,3480406,4978
"5521",27,2,42,31,3483625,3487550,3925
"5720",27,2,72,32,3493361,3495660,2299
"5818",27,4,98,33,3498546,3502558,4012
"5920",27,1,65,34,3505910,3508916,3006
"6018",27,2,126,35,3511934,3516786,4852
"6118",27,2,108,36,3520198,3524297,4099
"6223",27,2,6,37,3527236,3531561,4325
"6419",27,5,9,38,3537945,3541650,3705
"6620",27,2,54,39,3549321,3553732,4411
"6818",27,4,74,40,3560310,3563575,3265
"6919",27,5,129,41,3567021,3570360,3339
"7021",27,5,63,42,3573205,3575871,2666
"7118",27,3,31,43,3578810,3583561,4751
"7317",27,5,27,44,3589626,3592738,3112
"7520",27,3,121,45,3598049,3600562,2513
"7621",27,2,60,46,3603781,3607539,3758
"7718",27,2,90,47,3610851,3614537,3686
"7819",27,3,85,48,3617989,3620828,2839
"7919",27,3,25,49,3623713,3626532,2819
"8120",27,2,114,50,3632297,3636055,3758
"8220",27,6,136,51,3638995,3641880,2885
"8320",27,4,116,52,3644992,3648824,3832
"8414",27,6,124,53,3651703,3654075,2372
"8518",27,4,122,54,3656714,3658374,1660
"8622",27,6,94,55,3661180,3664911,3731
"8715",27,5,135,56,3667784,3670329,2545
"8820",27,1,77,57,3673482,3676194,2712
"8917",27,1,41,58,3678966,3681425,2459
"9119",27,5,111,59,3687370,3690509,3139
"9222",27,1,101,60,3693701,3696560,2859
"9320",27,5,21,61,3699499,3701544,2045
"9518",27,2,66,62,3707616,3709988,2372
"9616",27,2,84,63,3712740,3714733,1993
"9716",27,3,91,64,3717779,3719838,2059
"9819",27,5,3,65,3722743,3725662,2919
"10023",27,6,34,66,3769786,3772705,2919
"10219",27,3,43,67,3778996,3781855,2859
"10417",27,4,86,68,3787440,3789319,1879
"10517",27,3,127,69,3792038,3794350,2312
"10619",27,4,32,70,3797236,3800295,3059
"10818",27,5,81,71,3809052,3811384,2332
"10918",27,1,95,72,3814430,3816935,2505
"11014",27,4,134,73,3820487,3823420,2933
"11122",27,2,36,74,3826452,3828318,1866
"11315",27,3,109,75,3835842,3838347,2505
"11421",27,6,4,76,3841440,3844399,2959
"11621",27,1,113,77,3849970,3851789,1819
"11722",27,4,68,78,3855088,3858407,3319
"11820",27,2,102,79,3861452,3864325,2873
"11916",27,6,106,80,3867164,3869976,2812
"12021",27,5,123,81,3873101,3876167,3066
"12120",27,4,26,82,3879252,3882451,3199
"12319",27,1,5,83,3887843,3890248,2405
"12518",27,3,73,84,3899145,3903130,3985
"12615",27,5,93,85,3906669,3908861,2192
"12719",27,4,14,86,3911714,3917798,6084
"12923",27,6,70,87,3923476,3927855,4379
"13016",27,6,16,88,3930927,3933212,2285
"13221",27,1,17,89,3939823,3944042,4219
"13419",27,5,39,90,3949453,3951592,2139
"13618",27,5,33,91,3959143,3961535,2392
"13818",27,1,53,92,3967780,3971078,3298
"14019",27,1,35,93,3977410,3980622,3212
"14220",27,6,22,94,3988112,3992384,4272
"14417",27,2,78,95,3999108,4000807,1699
"14516",27,5,75,96,4003633,4006972,3339
"14622",27,2,120,97,4009838,4012403,2565
"14718",27,1,11,98,4015242,4017348,2106
"14922",27,5,57,99,4025798,4028011,2213
"15020",27,6,52,100,4031290,4033949,2659
"15220",27,6,76,101,4040613,4043445,2832
"15318",27,6,100,102,4046191,4049336,3145
"15420",27,3,19,103,4052735,4055068,2333
"15618",27,2,12,104,4066157,4070022,3865
"15818",27,5,69,105,4076100,4077979,1879
"15921",27,1,131,106,4080985,4084170,3185
"16022",27,4,38,107,4087029,4089028,1999
"16216",27,1,71,108,4095046,4097498,2452
"16323",27,2,24,109,4100518,4105849,5331
"16520",27,3,103,110,4112846,4116052,3206
"16613",27,3,1,111,4118771,4123722,4951
"16820",27,4,92,112,4131060,4135391,4331
"16921",27,5,87,113,4138764,4142736,3972
"17019",27,6,112,114,4145634,4148920,3286
"17124",27,3,55,115,4151732,4154224,2492
"17219",27,3,97,116,4157317,4160216,2899
"17320",27,1,89,117,4163101,4165467,2366
"17414",27,2,30,118,4168299,4170818,2519
"17618",27,1,137,119,4176516,4180875,4359
"17717",27,2,138,120,4184140,4186633,2493
"17819",27,2,18,121,4189505,4191557,2052
"18019",27,4,20,122,4198215,4200914,2699
"18218",27,5,117,123,4207272,4210670,3398
"18316",27,2,96,124,4213696,4216128,2432
"18419",27,3,61,125,4221007,4223979,2972
"18516",27,3,115,126,4227084,4231183,4099
"18618",27,5,51,127,4234268,4236647,2379
"18818",27,4,50,128,4242999,4247050,4051
"19019",27,4,80,129,4252961,4255287,2326
"19123",27,3,79,130,4258213,4260752,2539
"19223",27,6,82,131,4263624,4265930,2306
"19318",27,1,125,132,4268775,4271015,2240
"19418",27,4,62,133,4273814,4275939,2125
"19517",27,5,15,134,4278732,4280658,1926
"19718",27,1,23,135,4286523,4289021,2498
"19922",27,5,105,136,4295559,4298351,2792
"20020",27,1,83,137,4301437,4304669,3232
"20119",27,5,99,138,4308101,4311526,3425
"10107",28,2,5,1,5518442,5522367,3925
"12103",28,6,87,2,5529298,5538114,8816
"13104",28,4,73,3,5541566,5546665,5099
"14104",28,3,96,4,5550237,5553775,3538
"15101",28,5,32,5,5557667,5562019,4352
"17102",28,4,43,6,5568923,5572202,3279
"19101",28,3,66,7,5579906,5583804,3898
"2027",28,6,21,8,5587263,5592641,5378
"2222",28,4,79,9,5598712,5602897,4185
"2315",28,3,42,10,5606156,5610088,3932
"2519",28,4,127,11,5617192,5621124,3932
"2624",28,2,47,12,5624063,5627548,3485
"2818",28,6,69,13,5633992,5637391,3399
"2920",28,4,85,14,5640477,5645755,5278
"3022",28,3,12,15,5648654,5652126,3472
"3220",28,1,76,16,5658976,5666107,7131
"3319",28,5,104,17,5669226,5672818,3592
"3421",28,4,49,18,5675897,5679276,3379
"3621",28,5,62,19,5685147,5688379,3232
"3715",28,1,112,20,5691365,5693824,2459
"3819",28,2,89,21,5698489,5703233,4744
"3921",28,2,11,22,5706359,5709618,3259
"4121",28,6,57,23,5716902,5721373,4471
"4218",28,3,108,24,5724892,5728804,3912
"4320",28,6,75,25,5732070,5738834,6764
"4420",28,4,7,26,5743459,5747211,3752
"4619",28,5,74,27,5757814,5762672,4858
"4717",28,3,120,28,5766224,5769523,3299
"4822",28,6,15,29,5773154,5776973,3819
"5021",28,5,56,30,5784137,5787742,3605
"5117",28,5,38,31,5790981,5795340,4359
"5321",28,1,106,32,5801544,5804170,2626
"5422",28,5,92,33,5808355,5813493,5138
"5522",28,2,83,34,5817292,5822703,5411
"5617",28,1,58,35,5826262,5830113,3851
"5721",28,2,23,36,5833619,5837384,3765
"5921",28,3,6,37,5843462,5849686,6224
"6119",28,6,129,38,5856657,5859743,3086
"6224",28,6,3,39,5863021,5869286,6265
"6420",28,5,80,40,5875290,5878829,3539
"6521",28,4,13,41,5881834,5885054,3220
"6718",28,2,59,42,5893157,5897075,3918
"6819",28,1,88,43,5901707,5905186,3479
"6920",28,5,44,44,5909331,5912730,3399
"7119",28,4,19,45,5918767,5921306,2539
"7318",28,4,115,46,5928657,5931856,3199
"7419",28,1,40,47,5935275,5938527,3252
"7622",28,2,77,48,5945445,5948097,2652
"7719",28,4,91,49,5951402,5955081,3679
"7820",28,3,138,50,5958280,5961059,2779
"7920",28,1,130,51,5964544,5969349,4805
"8019",28,2,95,52,5972934,5976293,3359
"8121",28,1,124,53,5979485,5983464,3979
"8221",28,3,54,54,5986642,5989382,2740
"8415",28,3,18,55,5996333,6000404,4071
"8623",28,2,17,56,6006682,6013613,6931
"8821",28,6,45,57,6020423,6023782,3359
"9017",28,2,101,58,6030167,6033992,3825
"9120",28,2,65,59,6037011,6041162,4151
"9223",28,1,46,60,6044268,6047634,3366
"9418",28,5,134,61,6054211,6057943,3732
"9519",28,1,34,62,6061355,6066193,4838
"9717",28,3,60,63,6072724,6077802,5078
"9820",28,2,131,64,6081695,6084287,2592
"9918",28,3,24,65,6087265,6091091,3826
"10122",28,6,51,66,6125791,6130050,4259
"10321",28,1,118,67,6136421,6139920,3499
"10418",28,2,29,68,6142758,6147703,4945
"10620",28,3,72,69,6153561,6159152,5591
"10720",28,1,16,70,6162358,6165424,3066
"10919",28,6,105,71,6170742,6174054,3312
"11015",28,6,33,72,6177532,6182464,4932
"11223",28,6,111,73,6189741,6193573,3832
"11316",28,6,81,74,6197432,6203416,5984
"11422",28,6,117,75,6206601,6209401,2800
"11515",28,1,70,76,6212926,6216398,3472
"11622",28,4,121,77,6220803,6227534,6731
"11723",28,4,55,78,6230799,6233378,2579
"11821",28,2,71,79,6236131,6238663,2532
"11917",28,3,114,80,6241795,6247206,5411
"12022",28,4,1,81,6250465,6253464,2999
"12222",28,1,94,82,6262814,6268838,6024
"12320",28,2,113,83,6273017,6278048,5031
"12419",28,6,27,84,6281674,6284546,2872
"12616",28,6,39,85,6290471,6293236,2765
"12817",28,3,48,86,6298701,6300733,2032
"13017",28,2,35,87,6307598,6310663,3065
"13222",28,2,53,88,6333641,6338566,4925
"13420",28,2,107,89,6344364,6347370,3006
"13515",28,1,4,90,6351355,6354754,3399
"13717",28,5,122,91,6360525,6365030,4505
"13819",28,4,67,92,6368988,6373560,4572
"13918",28,4,109,93,6376972,6380351,3379
"14020",28,5,110,94,6384983,6387888,2905
"14123",28,3,36,95,6392326,6394805,2479
"14323",28,5,8,96,6405501,6409087,3586
"14517",28,4,25,97,6415298,6419143,3845
"14719",28,6,135,98,6425934,6428966,3032
"14817",28,5,14,99,6432532,6436037,3505
"15021",28,6,93,100,6443155,6445867,2712
"15122",28,4,61,101,6449172,6452778,3606
"15221",28,1,22,102,6456556,6460941,4385
"15421",28,1,64,103,6469978,6475016,5038
"15518",28,3,30,104,6477855,6480161,2306
"15722",28,3,78,105,6486025,6488644,2619
"15819",28,5,50,106,6492823,6496728,3905
"16023",28,5,20,107,6503412,6506544,3132
"16217",28,5,128,108,6513562,6518746,5184
"16324",28,3,102,109,6521946,6526104,4158
"16417",28,6,123,110,6529216,6533368,4152
"16521",28,3,126,111,6537213,6541252,4039
"16614",28,5,98,112,6546257,6551394,5137
"16723",28,2,41,113,6554447,6558212,3765
"16922",28,1,52,114,6564496,6567302,2806
"17125",28,6,9,115,6573919,6578758,4839
"17321",28,3,90,116,6584929,6587955,3026
"17415",28,2,125,117,6591120,6594313,3193
"17520",28,1,136,118,6597631,6601769,4138
"17619",28,4,133,119,6605161,6607941,2780
"17718",28,5,86,120,6611766,6614618,2852
"17820",28,5,26,121,6617930,6621216,3286
"18020",28,2,137,122,6628799,6630838,2039
"18124",28,1,10,123,6634444,6637576,3132
"18317",28,1,100,124,6645946,6648845,2899
"18420",28,6,99,125,6652164,6655683,3519
"18517",28,1,28,126,6659228,6662787,3559
"18719",28,3,132,127,6669584,6673723,4139
"18819",28,3,84,128,6676875,6679881,3006
"18919",28,4,97,129,6683332,6687571,4239
"19020",28,4,31,130,6693229,6699473,6244
"19224",28,5,68,131,6706004,6709410,3406
"19319",28,4,37,132,6712742,6718406,5664
"19518",28,5,116,133,6725297,6728789,3492
"19620",28,5,2,134,6732401,6736507,4106
"19820",28,2,119,135,6743710,6747402,3692
"19923",28,6,63,136,6750581,6753387,2806
"20021",28,4,103,137,6757219,6761797,4578
"20120",28,1,82,138,6766369,6768821,2452
"10108",29,5,121,1,8106455,8111113,4658
"1190",29,4,30,2,8114219,8118431,4212
"13105",29,5,73,3,8124935,8128680,3745
"14105",29,3,107,4,8131999,8135638,3639
"15102",29,3,113,5,8138783,8142715,3932
"16101",29,5,7,6,8145641,8150746,5105
"18104",29,5,31,7,8158443,8162854,4411
"2028",29,6,86,8,8170345,8175177,4832
"2121",29,1,81,9,8178569,8182121,3552
"2223",29,3,101,10,8185053,8188812,3759
"2316",29,6,104,11,8191991,8195776,3785
"2424",29,1,21,12,8199208,8202860,3652
"2625",29,5,13,13,8209411,8213529,4118
"2819",29,2,82,14,8219760,8222446,2686
"2921",29,5,109,15,8225278,8230269,4991
"3023",29,1,33,16,8233575,8237234,3659
"3221",29,2,10,17,8244365,8247603,3238
"3422",29,5,55,18,8253841,8256687,2846
"3518",29,3,137,19,8259672,8262091,2419
"3622",29,4,72,20,8265004,8268329,3325
"3716",29,5,67,21,8271088,8274160,3072
"3820",29,6,44,22,8277112,8280365,3253
"4020",29,5,97,23,8286529,8289754,3225
"4122",29,2,34,24,8292680,8295286,2606
"4321",29,6,20,25,8303856,8307115,3259
"4516",29,2,94,26,8314672,8318664,3992
"4620",29,1,87,27,8321823,8325201,3378
"4718",29,5,61,28,8328054,8331925,3871
"4823",29,5,43,29,8335171,8338883,3712
"5022",29,4,60,30,8346720,8351758,5038
"5118",29,3,59,31,8355064,8359222,4158
"5221",29,6,62,32,8362594,8366546,3952
"5322",29,3,29,33,8369385,8372831,3446
"5523",29,3,17,34,8379122,8382374,3252
"5722",29,4,132,35,8388505,8392716,4211
"5819",29,1,93,36,8395942,8398501,2559
"5922",29,6,14,37,8401580,8406338,4758
"6120",29,6,110,38,8412029,8414775,2746
"6225",29,4,42,39,8417634,8422039,4405
"6421",29,6,116,40,8428897,8432755,3858
"6522",29,2,106,41,8436660,8439486,2826
"6621",29,2,118,42,8442732,8445404,2672
"6719",29,1,51,43,8448336,8451348,3012
"6921",29,1,3,44,8457333,8460298,2965
"7120",29,6,80,45,8466523,8470455,3932
"7218",29,1,27,46,8473247,8476399,3152
"7420",29,4,18,47,8482403,8486009,3606
"7623",29,6,74,48,8492246,8495932,3686
"7720",29,5,79,49,8499297,8502463,3166
"7821",29,1,135,50,8505995,8509460,3465
"7921",29,5,19,51,8512286,8515805,3519
"8122",29,2,124,52,8523582,8527007,3425
"8222",29,4,102,53,8529753,8532785,3032
"8321",29,5,127,54,8535691,8538503,2812
"8416",29,1,57,55,8541442,8544107,2665
"8519",29,3,89,56,8547146,8551371,4225
"8624",29,2,16,57,8554683,8557549,2866
"8822",29,4,36,58,8564033,8567272,3239
"9018",29,3,83,59,8573624,8576895,3271
"9121",29,2,76,60,8579754,8583053,3299
"9224",29,2,88,61,8586359,8589491,3132
"9321",29,6,128,62,8592410,8597114,4704
"9419",29,6,98,63,8600207,8603799,3592
"9520",29,4,24,64,8607011,8611496,4485
"9718",29,1,75,65,8618607,8622299,3692
"9821",29,4,6,66,8648802,8653474,4672
"10024",29,3,41,67,8659471,8662964,3493
"10220",29,3,47,68,8669068,8672360,3292
"10419",29,1,123,69,8679611,8682797,3186
"10518",29,6,26,70,8685895,8689674,3779
"10721",29,5,1,71,8696125,8699150,3025
"10920",29,6,8,72,8705695,8709347,3652
"11123",29,2,28,73,8715338,8718903,3565
"11317",29,3,11,74,8725454,8728159,2705
"11516",29,6,2,75,8734437,8737903,3466
"11724",29,6,50,76,8743980,8748679,4699
"11918",29,3,77,77,8754430,8757222,2792
"12023",29,4,90,78,8759928,8763200,3272
"12121",29,6,134,79,8765972,8770278,4306
"12223",29,1,15,80,8773110,8775609,2499
"12420",29,2,64,81,8781320,8783886,2566
"12519",29,3,131,82,8786865,8789457,2592
"12617",29,2,52,83,8792076,8795328,3252
"12818",29,6,92,84,8801159,8804925,3766
"12924",29,1,9,85,8808244,8810896,2652
"13122",29,2,136,86,8817420,8820539,3119
"13223",29,1,63,87,8823718,8826630,2912
"13318",29,3,71,88,8829623,8832622,2999
"13421",29,5,25,89,8835560,8838846,3286
"13619",29,3,5,90,8844650,8847762,3112
"13820",29,3,65,91,8854300,8857205,2905
"13919",29,1,111,92,8860058,8862990,2932
"14021",29,2,100,93,8865983,8868101,2118
"14124",29,5,37,94,8870814,8873913,3099
"14324",29,5,115,95,8879951,8883016,3065
"14418",29,2,4,96,8886295,8888774,2479
"14623",29,1,39,97,8894751,8897137,2386
"14818",29,2,130,98,8903348,8906381,3033
"14923",29,5,103,99,8909833,8914238,4405
"15022",29,4,126,100,8917317,8920915,3598
"15123",29,1,99,101,8924441,8926713,2272
"15222",29,4,48,102,8929399,8931345,1946
"15422",29,4,108,103,8938249,8941694,3445
"15519",29,2,112,104,8944673,8947046,2373
"15619",29,6,38,105,8949885,8953230,3345
"15820",29,6,32,106,8959734,8963153,3419
"16024",29,5,133,107,8969178,8973169,3991
"16122",29,1,105,108,8976142,8978174,2032
"16218",29,1,45,109,8980987,8983632,2645
"16418",29,3,23,110,8989910,8993022,3112
"16615",29,3,119,111,8999020,9003511,4491
"16724",29,5,85,112,9006497,9010562,4065
"16821",29,2,22,113,9013588,9016400,2812
"17020",29,4,54,114,9022971,9026670,3699
"17220",29,2,46,115,9033174,9035473,2299
"17416",29,4,84,116,9041931,9045656,3725
"17521",29,4,120,117,9048808,9051134,2326
"17620",29,4,12,118,9054160,9057192,3032
"17821",29,4,66,119,9063083,9066102,3019
"17920",29,3,125,120,9068934,9071300,2366
"18021",29,4,96,121,9074452,9077678,3226
"18125",29,3,95,122,9080723,9083762,3039
"18219",29,5,49,123,9086881,9090093,3212
"18421",29,5,91,124,9096891,9101335,4444
"18518",29,4,78,125,9103921,9106407,2486
"18619",29,1,117,126,9112551,9115097,2546
"18720",29,4,138,127,9118449,9121888,3439
"18820",29,2,70,128,9125054,9127859,2805
"18920",29,3,53,129,9132977,9135663,2686
"19124",29,6,122,130,9141407,9143307,1900
"19225",29,1,69,131,9146206,9148525,2319
"19320",29,3,35,132,9151344,9154116,2772
"19519",29,6,56,133,9160607,9163786,3179
"19621",29,4,114,134,9166805,9170323,3518
"19719",29,2,58,135,9173396,9176388,2992
"19821",29,6,68,136,9179394,9184265,4871
"19924",29,2,40,137,9187297,9190356,3059
"20121",29,1,129,138,9196441,9199166,2725
"10109",30,3,16,1,1226979,1231004,4025
"12104",30,5,84,2,1237721,1241913,4192
"13106",30,4,107,3,1245272,1249697,4425
"14106",30,5,72,4,1254069,1258633,4564
"15103",30,6,73,5,1261533,1266151,4618
"16102",30,4,29,6,1269729,1274821,5092
"18105",30,6,43,7,1281792,1285350,3558
"2029",30,5,126,8,1291175,1295273,4098
"2122",30,2,93,9,1299072,1302884,3812
"2224",30,2,135,10,1306869,1312140,5271
"2317",30,5,48,11,1315319,1317392,2073
"2520",30,4,47,12,1323223,1326322,3099
"2718",30,3,82,13,1332940,1336118,3178
"2820",30,2,129,14,1339244,1343742,4498
"2922",30,6,7,15,1346828,1350906,4078
"3119",30,1,2,16,1357564,1361842,4278
"3320",30,4,137,17,1368586,1371472,2886
"3423",30,4,11,18,1375150,1378623,3473
"3623",30,2,69,19,1384240,1387606,3366
"3717",30,3,76,20,1391384,1395943,4559
"3821",30,2,81,21,1398928,1402434,3506
"3922",30,1,116,22,1405746,1410924,5178
"4021",30,3,130,23,1415062,1419174,4112
"4123",30,3,46,24,1422400,1426052,3652
"4322",30,2,63,25,1434009,1437734,3725
"4421",30,5,36,26,1441453,1444918,3465
"4621",30,2,99,27,1451336,1454361,3025
"4719",30,6,79,28,1458333,1462225,3892
"4824",30,6,25,29,1466250,1470022,3772
"5023",30,6,133,30,1476613,1480685,4072
"5119",30,1,80,31,1484270,1488182,3912
"5222",30,1,98,32,1519544,1522682,3138
"5323",30,1,92,33,1526068,1531859,5791
"5423",30,3,22,34,1535438,1538796,3358
"5618",30,6,37,35,1545361,1549193,3832
"5820",30,6,67,36,1556044,1559729,3685
"5923",30,2,123,37,1563554,1567706,4152
"6019",30,4,35,38,1571111,1575210,4099
"6226",30,6,85,39,1582354,1587185,4831
"6318",30,6,1,40,1591284,1594523,3239
"6523",30,1,20,41,1601973,1603932,1959
"6720",30,5,96,42,1609924,1613356,3432
"6820",30,6,109,43,1616715,1619700,2985
"6922",30,2,27,44,1622585,1625424,2839
"7121",30,2,57,45,1631376,1634954,3578
"7219",30,5,42,46,1638613,1641685,3072
"7421",30,6,55,47,1648023,1650662,2639
"7521",30,4,65,48,1653661,1656993,3332
"7624",30,4,77,49,1659912,1662571,2659
"7721",30,3,70,50,1665756,1669841,4085
"7822",30,2,111,51,1673394,1676985,3591
"7922",30,2,15,52,1679938,1682723,2785
"8123",30,3,106,53,1689761,1692306,2545
"8223",30,1,104,54,1695805,1699290,3485
"8322",30,1,128,55,1701990,1707581,5591
"8417",30,6,19,56,1710606,1713179,2573
"8625",30,2,87,57,1722002,1725501,3499
"8716",30,1,134,58,1728640,1732272,3632
"8823",30,5,114,59,1735444,1739369,3925
"8918",30,5,12,60,1742488,1745573,3085
"9122",30,3,34,61,1752218,1755236,3018
"9322",30,1,50,62,1763834,1767185,3351
"9521",30,4,5,63,1772737,1776295,3558
"9719",30,1,110,64,1782753,1786265,3512
"9822",30,5,54,65,1790024,1792796,2772
"10025",30,5,30,66,1859711,1862443,2732
"10221",30,4,53,67,1870361,1873979,3618
"10420",30,2,21,68,1879924,1883342,3418
"10621",30,3,112,69,1891133,1893805,2672
"10722",30,6,103,70,1897091,1900922,3831
"10819",30,5,90,71,1903928,1907647,3719
"10921",30,6,97,72,1910759,1914517,3758
"11016",30,5,66,73,1917637,1920435,2798
"11124",30,2,105,74,1923221,1926780,3559
"11224",30,3,118,75,1929692,1932991,3299
"11318",30,5,6,76,1939129,1943034,3905
"11517",30,1,74,77,1950744,1953583,2839
"11623",30,3,88,78,1956722,1961234,4512
"11725",30,6,121,79,1964279,1967538,3259
"11822",30,3,94,80,1970410,1975342,4932
"11919",30,6,31,81,1978507,1982952,4445
"12122",30,4,59,82,1990536,1994268,3732
"12224",30,5,18,83,1997280,2000206,2926
"12421",30,3,100,84,2006224,2011455,5231
"12520",30,6,49,85,2014721,2018812,4091
"12720",30,4,113,86,2024190,2027789,3599
"12819",30,1,68,87,2030795,2034127,3332
"12925",30,2,51,88,2036979,2040624,3645
"13123",30,1,44,89,2046482,2048721,2239
"13319",30,4,23,90,2079637,2082855,3218
"13516",30,5,132,91,2089266,2093145,3879
"13620",30,1,122,92,2096970,2099229,2259
"13718",30,1,38,93,2103048,2106207,3159
"13920",30,2,33,94,2112691,2117103,4412
"14125",30,2,39,95,2125853,2129585,3732
"14325",30,1,8,96,2135423,2138428,3005
"14518",30,1,26,97,2145259,2149671,4412
"14720",30,1,14,98,2158308,2162073,3765
"14924",30,3,124,99,2167637,2170876,3239
"15023",30,4,89,100,2174162,2178640,4478
"15124",30,3,64,101,2182225,2186957,4732
"15223",30,6,127,102,2191955,2195587,3632
"15319",30,5,138,103,2198973,2205643,6670
"15423",30,4,83,104,2209382,2213314,3932
"15520",30,2,45,105,2216346,2219192,2846
"15723",30,6,61,106,2225343,2229061,3718
"15821",30,2,9,107,2232320,2236832,4512
"16025",30,4,71,108,2243696,2247215,3519
"16123",30,2,75,109,2253046,2258030,4984
"16219",30,3,52,110,2261616,2265295,3679
"16419",30,1,32,111,2272712,2278023,5311
"16616",30,5,120,112,2284141,2287106,2965
"16725",30,2,3,113,2290799,2294664,3865
"16923",30,1,56,114,2302108,2305853,3745
"17021",30,5,108,115,2309219,2312297,3078
"17126",30,4,95,116,2315696,2318641,2945
"17221",30,6,13,117,2321754,2324493,2739
"17417",30,4,119,118,2332403,2335409,3006
"17522",30,5,102,119,2338614,2342333,3719
"17621",30,6,91,120,2345998,2350137,4139
"17719",30,6,115,121,2353495,2356341,2846
"17822",30,4,131,122,2359586,2362619,3033
"17921",30,3,28,123,2365271,2367970,2699
"18126",30,3,136,124,2374974,2378153,3179
"18220",30,4,17,125,2382771,2385450,2679
"18422",30,4,41,126,2391888,2394800,2912
"18620",30,5,78,127,2400725,2405023,4298
"18721",30,4,125,128,2408229,2411574,3345
"18821",30,3,4,129,2414546,2417452,2906
"19021",30,1,62,130,2423076,2426901,3825
"19125",30,3,40,131,2431007,2434825,3818
"19321",30,5,24,132,2442663,2446474,3811
"19520",30,5,60,133,2453445,2457624,4179
"19622",30,3,10,134,2461162,2464994,3832
"19822",30,3,58,135,2472725,2476377,3652
"19925",30,1,86,136,2480022,2482907,2885
"20022",30,4,101,137,2487233,2491344,4111
"20122",30,2,117,138,2507385,2510171,2786
"10123",31,2,116,1,3401355,3406620,5265
"11100",31,1,61,2,3409992,3414324,4332
"12105",31,6,48,3,3417969,3421028,3059
"14107",31,6,78,4,3427393,3431044,3651
"15104",31,6,6,5,3434363,3438408,4045
"17103",31,1,115,6,3445193,3449971,4778
"18106",31,6,126,7,3453143,3457708,4565
"19102",31,4,52,8,3460573,3464839,4266
"2123",31,3,33,9,3471216,3477047,5831
"2318",31,6,42,10,3483765,3487530,3765
"2521",31,6,138,11,3494414,3498626,4212
"2626",31,1,31,12,3501612,3507003,5391
"2821",31,4,28,13,3513207,3519378,6171
"3024",31,4,76,14,3525550,3531087,5537
"3120",31,1,85,15,3534266,3538638,4372
"3222",31,1,133,16,3541963,3546262,4299
"3321",31,2,32,17,3549461,3553632,4171
"3519",31,3,27,18,3560243,3564209,3966
"3718",31,2,92,19,3570080,3575198,5118
"3822",31,6,114,20,3578030,3583961,5931
"3923",31,5,59,21,3587167,3592071,4904
"4022",31,2,134,22,3595177,3599835,4658
"4124",31,4,118,23,3603207,3607219,4012
"4219",31,2,44,24,3610665,3615723,5058
"4422",31,5,107,25,3622061,3625826,3765
"4517",31,6,108,26,3628745,3633363,4618
"4622",31,6,90,27,3636375,3640647,4272
"4720",31,1,55,28,3643693,3646925,3232
"4825",31,5,23,29,3650677,3653975,3298
"5024",31,6,24,30,3660006,3663765,3759
"5223",31,1,7,31,3669849,3674961,5112
"5424",31,2,80,32,3681072,3685657,4585
"5524",31,6,66,33,3688496,3692794,4298
"5619",31,4,4,34,3695867,3699738,3871
"5821",31,5,101,35,3705443,3709182,3739
"5924",31,1,91,36,3712181,3716006,3825
"6020",31,5,137,37,3718525,3722383,3858
"6121",31,2,56,38,3725349,3730400,5051
"6227",31,2,98,39,3733419,3738877,5458
"6319",31,2,122,40,3742129,3745861,3732
"6422",31,2,128,41,3749047,3753998,4951
"6524",31,1,1,42,3757091,3760403,3312
"6721",31,4,58,43,3766721,3771139,4418
"6821",31,3,45,44,3773798,3777397,3599
"7022",31,5,5,45,3783641,3787193,3552
"7220",31,5,77,46,3793777,3798562,4785
"7319",31,5,125,47,3801461,3805639,4178
"7422",31,4,64,48,3808512,3812730,4218
"7522",31,1,73,49,3815563,3820781,5218
"7625",31,2,14,50,3823806,3829071,5265
"7823",31,2,104,51,3835328,3838307,2979
"7923",31,1,103,52,3841013,3845838,4825
"8020",31,3,51,53,3849077,3852295,3218
"8224",31,5,83,54,3858473,3863298,4825
"8323",31,4,16,55,3866497,3870869,4372
"8520",31,5,65,56,3876680,3880798,4118
"8626",31,5,113,57,3883957,3888069,4112
"8717",31,3,3,58,3891121,3895346,4225
"8919",31,5,41,59,3902650,3906016,3366
"9123",31,3,75,60,3913626,3918471,4845
"9225",31,2,74,61,3921523,3925535,4012
"9323",31,3,9,62,3928507,3933912,5405
"9522",31,4,40,63,3941889,3945901,4012
"9720",31,4,136,64,3952479,3956504,4025
"9823",31,2,62,65,3959363,3963654,4291
"9919",31,6,96,66,4005372,4009757,4385
"10026",31,2,2,67,4012897,4017095,4198
"10222",31,3,57,68,4023333,4028377,5044
"10322",31,6,102,69,4031210,4036221,5011
"10421",31,1,109,70,4039260,4044038,4778
"10519",31,6,60,71,4047497,4051062,3565
"10622",31,4,22,72,4054181,4059606,5425
"10820",31,5,95,73,4065870,4070748,4878
"10922",31,5,17,74,4074000,4078059,4059
"11125",31,5,131,75,4084050,4088555,4505
"11225",31,1,127,76,4091707,4096932,5225
"11319",31,1,25,77,4100017,4104982,4965
"11518",31,4,112,78,4110947,4115925,4978
"11624",31,3,129,79,4118924,4124142,5218
"11726",31,3,81,80,4127101,4132459,5358
"11823",31,3,69,81,4135544,4141329,5785
"11920",31,3,39,82,4144388,4149905,5517
"12123",31,2,20,83,4156170,4160475,4305
"12321",31,1,79,84,4166593,4172217,5624
"12422",31,6,72,85,4175076,4180701,5625
"12521",31,5,29,86,4184080,4188078,3998
"12721",31,3,99,87,4194929,4199694,4765
"12820",31,4,34,88,4202553,4208271,5718
"13018",31,3,21,89,4214975,4220366,5391
"13224",31,4,130,90,4226611,4231049,4438
"13320",31,3,111,91,4234148,4239439,5291
"13422",31,2,26,92,4242371,4247430,5059
"13621",31,3,105,93,4254554,4260938,6384
"13719",31,2,110,94,4264350,4268795,4445
"13821",31,3,135,95,4273200,4278252,5052
"13921",31,5,47,96,4281157,4285549,4392
"14126",31,4,100,97,4291893,4296771,4878
"14221",31,6,132,98,4299784,4304755,4971
"14326",31,4,70,99,4308074,4313385,5311
"14419",31,3,87,100,4316224,4323355,7131
"14519",31,6,36,101,4325947,4329586,3639
"14721",31,1,19,102,4335637,4342441,6804
"14925",31,2,68,103,4348619,4353770,5151
"15024",31,3,63,104,4357036,4360888,3852
"15125",31,3,123,105,4363840,4370131,6291
"15224",31,2,86,106,4372923,4377129,4206
"15320",31,6,12,107,4380614,4384299,3685
"15521",31,2,38,108,4390650,4395209,4559
"15724",31,4,94,109,4400953,4405145,4192
"15822",31,2,50,110,4407844,4412122,4278
"16026",31,5,119,111,4418233,4422945,4712
"16124",31,6,54,112,4426091,4430289,4198
"16325",31,6,120,113,4436280,4439752,3472
"16420",31,6,84,114,4442884,4448562,5678
"16522",31,1,121,115,4452001,4456712,4711
"16617",31,4,10,116,4459738,4463417,3679
"16822",31,4,82,117,4469861,4472887,3026
"16924",31,5,89,118,4476239,4482456,6217
"17022",31,1,13,119,4485342,4491400,6058
"17222",31,3,15,120,4497571,4502409,4838
"17418",31,4,124,121,4508487,4512678,4191
"17523",31,4,88,122,4516231,4521915,5684
"17622",31,6,30,123,4525001,4531485,6484
"17823",31,2,8,124,4537783,4542174,4391
"18022",31,3,117,125,4548239,4552624,4385
"18127",31,5,35,126,4555323,4559874,4551
"18318",31,5,11,127,4566665,4570364,3699
"18519",31,1,37,128,4576082,4580913,4831
"18722",31,1,49,129,4586978,4591589,4611
"18921",31,4,46,130,4597254,4601399,4145
"19126",31,4,106,131,4607244,4611002,3758
"19226",31,5,71,132,4614001,4617786,3785
"19322",31,5,53,133,4620719,4624930,4211
"19521",31,1,43,134,4630922,4635067,4145
"19720",31,1,67,135,4641104,4644623,3519
"19823",31,3,93,136,4647675,4650894,3219
"19926",31,6,18,137,4653840,4658525,4685
"20123",31,1,97,138,4664649,4668868,4219
"10124",32,3,116,1,5794632,5801883,7251
"11101",32,5,112,2,5804902,5809520,4618
"12106",32,2,73,3,5812426,5816644,4218
"13107",32,3,68,4,5819563,5823188,3625
"14108",32,6,107,5,5825940,5832738,6798
"15105",32,2,7,6,5835677,5838916,3239
"17104",32,4,123,7,5847752,5852264,4512
"18107",32,4,93,8,5855223,5858295,3072
"19103",32,1,24,9,5861188,5864247,3059
"2124",32,5,130,10,5870771,5875616,4845
"2225",32,2,79,11,5879174,5882733,3559
"2319",32,1,30,12,5885679,5888617,2938
"2522",32,3,80,13,5894669,5898447,3778
"2627",32,3,44,14,5901413,5904132,2719
"2822",32,3,134,15,5909716,5913515,3799
"2923",32,3,86,16,5916407,5921259,4852
"3025",32,2,97,17,5924111,5927770,3659
"3121",32,6,89,18,5931135,5934454,3319
"3223",32,4,63,19,5937373,5939619,2246
"3322",32,1,72,20,5942491,5947349,4858
"3424",32,4,105,21,5950135,5954813,4678
"3520",32,2,85,22,5957912,5961777,3865
"3624",32,2,115,23,5965849,5968908,3059
"3719",32,6,47,24,5971680,5976385,4705
"3924",32,2,31,25,5982690,5986715,4025
"4125",32,4,69,26,5993366,5996251,2885
"4220",32,2,103,27,5999170,6001782,2612
"4323",32,5,76,28,6004635,6009979,5344
"4423",32,1,138,29,6013125,6016690,3565
"4518",32,6,131,30,6019816,6024094,4278
"4623",32,2,121,31,6026927,6030225,3298
"4721",32,3,32,32,6033104,6036723,3619
"4916",32,2,133,33,6043661,6047166,3505
"5025",32,6,59,34,6050171,6053697,3526
"5120",32,4,51,35,6056815,6060074,3259
"5324",32,4,135,36,6066085,6071756,5671
"5425",32,3,26,37,6074949,6079040,4091
"5620",32,2,49,38,6085905,6089537,3632
"5822",32,4,27,39,6095048,6099200,4152
"6021",32,3,2,40,6104891,6108656,3765
"6228",32,4,75,41,6116120,6123077,6957
"6320",32,3,56,42,6126070,6130575,4505
"6423",32,1,132,43,6133547,6136426,2879
"6525",32,2,67,44,6139212,6142251,3039
"6622",32,4,3,45,6145010,6150408,5398
"6822",32,5,70,46,6156765,6160144,3379
"6923",32,1,18,47,6162916,6166402,3486
"7122",32,3,20,48,6172586,6175358,2772
"7320",32,4,45,49,6181936,6185082,3146
"7523",32,1,126,50,6191333,6194725,3392
"7626",32,5,46,51,6197744,6201295,3551
"7824",32,5,58,52,6207113,6211812,4699
"7924",32,5,52,53,6214644,6218403,3759
"8124",32,5,34,54,6225460,6228925,3465
"8324",32,1,120,55,6236083,6239954,3871
"8418",32,5,16,56,6243074,6245646,2572
"8627",32,1,90,57,6251664,6254976,3312
"8718",32,6,119,58,6257995,6261926,3931
"8824",32,6,5,59,6264706,6268364,3658
"9019",32,3,62,60,6274455,6278101,3646
"9124",32,3,74,61,6280940,6283698,2758
"9226",32,4,33,62,6286604,6289316,2712
"9420",32,5,82,63,6295128,6297820,2692
"9523",32,1,96,64,6300772,6303411,2639
"9617",32,1,84,65,6306250,6311215,4965
"9721",32,3,14,66,6358191,6361610,3419
"9920",32,4,117,67,6368154,6370606,2452
"10027",32,1,48,68,6374405,6377071,2666
"10223",32,2,43,69,6384102,6386894,2792
"10422",32,2,13,70,6392751,6397930,5179
"10623",32,4,81,71,6404421,6408459,4038
"10723",32,5,100,72,6411345,6414097,2752
"10821",32,1,60,73,6417189,6421021,3832
"10923",32,2,37,74,6423887,6428605,4718
"11126",32,5,64,75,6437169,6440880,3711
"11226",32,3,8,76,6444946,6449117,4171
"11423",32,6,41,77,6456475,6459667,3192
"11625",32,3,110,78,6480973,6485524,4551
"11727",32,1,6,79,6488350,6494434,6084
"11921",32,2,19,80,6499945,6502584,2639
"12124",32,1,36,81,6510088,6513340,3252
"12322",32,6,101,82,6519651,6522970,3319
"12423",32,4,21,83,6525982,6530234,4252
"12618",32,2,61,84,6536805,6540324,3519
"12722",32,4,111,85,6543463,6546288,2825
"12821",32,5,106,86,6549220,6552013,2793
"12926",32,1,108,87,6554965,6557984,3019
"13019",32,3,92,88,6560957,6564848,3891
"13124",32,4,99,89,6567774,6571919,4145
"13225",32,2,1,90,6575138,6578710,3572
"13423",32,4,87,91,6585014,6590112,5098
"13517",32,6,113,92,6592924,6596803,3879
"13622",32,4,129,93,6599589,6603687,4098
"13720",32,4,9,94,6606819,6611044,4225
"13922",32,1,114,95,6617149,6621247,4098
"14022",32,2,127,96,6624100,6626752,2652
"14127",32,2,91,97,6629744,6633236,3492
"14222",32,6,71,98,6636202,6639914,3712
"14327",32,5,124,99,6642879,6645918,3039
"14420",32,6,83,100,6648724,6651409,2685
"14520",32,5,94,101,6654255,6659153,4898
"14624",32,5,118,102,6662226,6665131,2905
"14722",32,5,28,103,6667844,6671656,3812
"14926",32,3,122,104,6677920,6680219,2299
"15025",32,5,4,105,6683318,6686743,3425
"15225",32,3,38,106,6692794,6696693,3899
"15424",32,6,95,107,6702278,6705756,3478
"15522",32,6,65,108,6708702,6712794,4092
"15620",32,6,77,109,6715719,6719258,3539
"15725",32,4,15,110,6722024,6724163,2139
"15922",32,6,11,111,6730187,6732866,2679
"16125",32,3,128,112,6739297,6743955,4658
"16220",32,6,17,113,6747154,6752139,4985
"16421",32,6,137,114,6758344,6762096,3752
"16523",32,4,39,115,6764714,6768107,3393
"16726",32,5,88,116,6774584,6777556,2972
"16823",32,6,29,117,6780489,6787546,7057
"17023",32,1,102,118,6793457,6795710,2253
"17127",32,6,125,119,6798455,6801994,3539
"17223",32,1,42,120,6805593,6809851,4258
"17419",32,1,12,121,6816122,6818501,2379
"17623",32,1,78,122,6824726,6827618,2892
"17720",32,1,66,123,6830830,6833982,3152
"17824",32,2,109,124,6836948,6840107,3159
"17922",32,4,57,125,6842926,6845785,2859
"18023",32,3,50,126,6848704,6851949,3245
"18221",32,3,104,127,6857827,6861605,3778
"18319",32,3,98,128,6864544,6868323,3779
"18423",32,5,136,129,6871209,6874974,3765
"18520",32,2,55,130,6877999,6880759,2760
"18621",32,5,22,131,6883937,6886503,2566
"18822",32,2,25,132,6892387,6895606,3219
"19022",32,5,40,133,6901477,6905089,3612
"19227",32,6,35,134,6911980,6915565,3585
"19419",32,1,54,135,6922470,6925262,2792
"19623",32,5,10,136,6932613,6935772,3159
"19824",32,6,23,137,6941649,6945095,3446
"20023",32,6,53,138,6950779,6954371,3592
"10125",33,4,74,1,8222251,8226656,4405
"11102",33,2,30,2,8229648,8234446,4798
"13108",33,3,43,3,8240071,8242963,2892
"15106",33,6,22,4,8249221,8253199,3978
"17105",33,3,67,5,8259418,8262056,2638
"18108",33,3,115,6,8265149,8269114,3965
"19104",33,6,76,7,8273026,8278797,5771
"2030",33,6,130,8,8282189,8287593,5404
"2125",33,5,105,9,8290399,8294698,4299
"2226",33,1,77,10,8298190,8302515,4325
"2320",33,4,38,11,8305980,8311418,5438
"2523",33,2,126,12,8317603,8323081,5478
"2628",33,2,36,13,8326366,8329091,2725
"2823",33,5,15,14,8337222,8341600,4378
"3026",33,4,2,15,8347932,8352576,4644
"3224",33,1,53,16,8359767,8362146,2379
"3425",33,2,72,17,8367304,8369730,2426
"3521",33,6,34,18,8373376,8378307,4931
"3720",33,4,68,19,8384605,8389149,4544
"3823",33,6,52,20,8393521,8398313,4792
"4023",33,4,128,21,8404617,8412727,8110
"4126",33,3,7,22,8415633,8418965,3332
"4324",33,1,119,23,8425803,8430448,4645
"4424",33,4,26,24,8433593,8441997,8404
"4624",33,5,3,25,8450240,8454878,4638
"4826",33,5,135,26,8461083,8466014,4931
"4917",33,3,109,27,8469287,8472765,3478
"5026",33,5,129,28,8475611,8480196,4585
"5121",33,1,131,29,8505540,8508958,3418
"5224",33,1,11,30,8511864,8514677,2813
"5426",33,3,19,31,8520181,8522567,2386
"5621",33,1,101,32,8531824,8534903,3079
"5723",33,6,112,33,8537755,8541760,4005
"5823",33,1,41,34,8544906,8548517,3611
"6022",33,1,83,35,8555068,8558574,3506
"6122",33,5,93,36,8561659,8565711,4052
"6229",33,4,44,37,8568750,8572882,4132
"6424",33,3,85,38,8578460,8582345,3885
"6526",33,2,138,39,8585291,8587976,2685
"6623",33,5,21,40,8590875,8596193,5318
"6823",33,6,124,41,8601805,8605043,3238
"6924",33,5,81,42,8608522,8612534,4012
"7023",33,2,96,43,8615719,8620884,5165
"7123",33,6,46,44,8623856,8628535,4679
"7321",33,4,104,45,8634326,8637984,3658
"7423",33,4,8,46,8641490,8646555,5065
"7627",33,3,25,47,8653819,8656671,2852
"7825",33,4,116,48,8661969,8665834,3865
"7925",33,5,99,49,8669439,8672658,3219
"8021",33,1,23,50,8675517,8680409,4892
"8225",33,1,47,51,8686180,8691431,5251
"8419",33,4,86,52,8698576,8703647,5071
"8521",33,6,136,53,8708125,8710771,2646
"8628",33,6,64,54,8714177,8723366,9189
"8719",33,1,89,55,8727112,8730597,3485
"8825",33,4,98,56,8772828,8775800,2972
"8920",33,3,31,57,8778833,8782025,3192
"9125",33,2,54,58,8789822,8792634,2812
"9324",33,6,28,59,8799945,8803996,4051
"9524",33,2,84,60,8811380,8818731,7351
"9618",33,5,39,61,8821943,8826528,4585
"9824",33,6,106,62,8831720,8834125,2405
"9921",33,1,65,63,8837005,8841823,4818
"10028",33,4,110,64,8845082,8847520,2438
"10126",33,5,33,65,8850806,8854351,3545
"10323",33,6,82,66,8912210,8915555,3345
"10423",33,2,90,67,8919987,8923073,3086
"10520",33,5,117,68,8926445,8929384,2939
"10624",33,3,13,69,8932356,8935775,3419
"10822",33,2,42,70,8940826,8944785,3959
"11017",33,6,70,71,8951682,8956107,4425
"11127",33,1,17,72,8959339,8962385,3046
"11320",33,3,97,73,8968989,8971348,2359
"11424",33,2,24,74,8975227,8979698,4471
"11626",33,5,75,75,8986116,8990301,4185
"11728",33,4,50,76,8993440,8997112,3672
"11922",33,3,79,77,9002210,9006708,4498
"12024",33,5,63,78,9010874,9014765,3891
"12125",33,4,62,79,9019064,9022063,2999
"12225",33,2,66,80,9025282,9028267,2985
"12323",33,1,29,81,9032159,9036451,4292
"12522",33,3,91,82,9041922,9045761,3839
"12619",33,3,61,83,9048920,9051679,2759
"12723",33,6,94,84,9054771,9059302,4531
"12822",33,1,107,85,9062295,9066100,3805
"12927",33,6,10,86,9068959,9073390,4431
"13125",33,6,58,87,9080988,9084893,3905
"13226",33,2,102,88,9088365,9091517,3152
"13321",33,5,9,89,9095096,9100061,4965
"13518",33,3,37,90,9105246,9111903,6657
"13721",33,4,92,91,9118134,9121599,3465
"13822",33,6,16,92,9124432,9128857,4425
"14023",33,6,4,93,9135095,9138447,3352
"14223",33,2,78,94,9151422,9153727,2305
"14328",33,6,88,95,9157866,9161205,3339
"14421",33,5,123,96,9165077,9170521,5444
"14521",33,5,27,97,9175340,9178485,3145
"14723",33,3,1,98,9184816,9188121,3305
"14927",33,2,114,99,9196819,9199890,3071
"15026",33,2,12,100,9207548,9211773,4225
"15226",33,1,95,101,9274656,9277082,2426
"15321",33,4,14,102,9280054,9284399,4345
"15523",33,2,6,103,9290897,9297708,6811
"15726",33,1,71,104,9302746,9305411,2665
"15823",33,2,108,105,9308350,9311736,3386
"15923",33,5,51,106,9370121,9373766,3645
"16126",33,2,60,107,9379605,9383710,4105
"16221",33,3,49,108,9386802,9390201,3399
"16422",33,5,57,109,9397871,9400990,3119
"16524",33,3,73,110,9404355,9407581,3226
"16618",33,5,69,111,9416524,9419483,2959
"16727",33,3,103,112,9424421,9427626,3205
"16824",33,2,120,113,9430612,9434271,3659
"16925",33,3,55,114,9437776,9439322,1546
"17024",33,2,48,115,9443627,9444973,1346
"17224",33,1,59,116,9452358,9454904,2546
"17322",33,5,87,117,9458329,9464633,6304
"17420",33,2,18,118,9479701,9482520,2819
"17624",33,5,111,119,9488984,9491703,2719
"17721",33,4,20,120,9495735,9498320,2585
"17923",33,4,122,121,9504552,9506931,2379
"18024",33,4,80,122,9510063,9512795,2732
"18128",33,4,32,123,9516487,9520706,4219
"18320",33,6,40,124,9526997,9530463,3466
"18521",33,4,134,125,9537226,9541258,4032
"18622",33,1,35,126,9544817,9547163,2346
"18823",33,6,118,127,9554660,9557685,3025
"18922",33,4,56,128,9562004,9565489,3485
"19023",33,2,132,129,9568415,9572647,4232
"19127",33,6,100,130,9576618,9579550,2932
"19228",33,1,113,131,9584202,9588021,3819
"19323",33,3,121,132,9590866,9593472,2606
"19420",33,1,5,133,9598097,9601389,3292
"19624",33,3,127,134,9609140,9611112,1972
"19721",33,5,45,135,9614678,9618190,3512
"19927",33,3,133,136,9625061,9627233,2172
"20024",33,1,137,137,9631032,9635263,4231
"20124",33,1,125,138,9641574,9644367,2793
"10127",34,6,81,1,772970,778168,5198
"11103",34,6,63,2,781374,786485,5111
"12107",34,5,68,3,789351,794155,4804
"13109",34,5,8,4,797541,802499,4958
"15107",34,1,88,5,809570,814035,4465
"16103",34,5,32,6,816921,821206,4285
"18109",34,5,20,7,828037,832555,4518
"2031",34,4,121,8,840292,844117,3825
"2126",34,2,107,9,846916,850781,3865
"2227",34,2,137,10,853507,857372,3865
"2321",34,6,21,11,860271,865616,5345
"2524",34,5,110,12,871480,876552,5072
"2629",34,4,79,13,879890,885808,5918
"2719",34,2,35,14,889020,892526,3506
"2924",34,5,80,15,899930,903835,3905
"3027",34,3,108,16,907174,913205,6031
"3122",34,1,124,17,916397,919889,3492
"3225",34,5,62,18,922635,927173,4538
"3323",34,6,123,19,930138,934650,4512
"3426",34,6,111,20,938502,943287,4785
"3522",34,6,9,21,946299,951064,4765
"3721",34,1,40,22,958581,962960,4379
"3925",34,6,87,23,970090,974962,4872
"4024",34,2,125,24,978301,982986,4685
"4127",34,3,96,25,986045,990430,4385
"4221",34,3,24,26,993562,1000053,6491
"4425",34,5,86,27,1006930,1012968,6038
"4519",34,4,7,28,1016353,1021971,5618
"4722",34,1,82,29,1030595,1033967,3372
"4827",34,2,59,30,1036939,1041171,4232
"4918",34,5,50,31,1044436,1048528,4092
"5122",34,5,104,32,1055146,1059144,3998
"5225",34,4,91,33,1062583,1068081,5498
"5325",34,5,44,34,1071306,1075391,4085
"5525",34,4,55,35,1083222,1086401,3179
"5622",34,1,28,36,1089333,1092985,3652
"5824",34,1,106,37,1100622,1103541,2919
"5925",34,2,71,38,1110491,1114943,4452
"6023",34,4,97,39,1139294,1143559,4265
"6123",34,1,34,40,1146705,1150897,4192
"6321",34,1,58,41,1158367,1162146,3779
"6425",34,2,131,42,1164998,1169397,4399
"6527",34,1,118,43,1172369,1176434,4065
"6624",34,3,54,44,1179719,1182845,3126
"6824",34,4,37,45,1191435,1198919,7484
"7024",34,2,101,46,1206343,1211015,4672
"7124",34,1,22,47,1213873,1218452,4579
"7322",34,4,109,48,1225323,1228681,3358
"7424",34,2,77,49,1259297,1263388,4091
"7524",34,6,99,50,1266840,1271559,4719
"7628",34,4,67,51,1274745,1278250,3505
"7722",34,2,113,52,1281109,1286287,5178
"7826",34,1,4,53,1289692,1293284,3592
"8022",34,2,119,54,1299855,1304366,4511
"8125",34,2,41,55,1307706,1310784,3078
"8325",34,4,49,56,1316855,1323113,6258
"8522",34,5,14,57,1328944,1333802,4858
"8720",34,5,134,58,1339853,1343159,3306
"8826",34,6,45,59,1346291,1349383,3092
"9020",34,6,117,60,1355508,1359126,3618
"9126",34,6,57,61,1362219,1365744,3525
"9227",34,3,72,62,1368610,1372934,4324
"9325",34,3,114,63,1376027,1380085,4058
"9421",34,2,29,64,1383344,1387189,3845
"9619",34,3,66,65,1393660,1397672,4012
"9722",34,2,95,66,1458336,1462268,3932
"9825",34,3,84,67,1465780,1470898,5118
"9922",34,1,94,68,1474111,1478875,4764
"10029",34,2,47,69,1481814,1484100,2286
"10224",34,2,23,70,1490624,1494723,4099
"10424",34,3,90,71,1500761,1504213,3452
"10521",34,5,98,72,1507658,1510797,3139
"10625",34,3,138,73,1513749,1517455,3706
"10724",34,1,16,74,1520367,1523165,2798
"10924",34,3,120,75,1603936,1608107,4171
"11018",34,4,61,76,1611406,1615465,4059
"11128",34,6,39,77,1618244,1622895,4651
"11321",34,6,69,78,1629026,1632225,3199
"11425",34,2,83,79,1635371,1640009,4638
"11519",34,2,89,80,1643061,1648126,5065
"11627",34,3,30,81,1651072,1654877,3805
"11824",34,5,92,82,1661201,1665100,3899
"11923",34,4,127,83,1668312,1672044,3732
"12025",34,1,70,84,1675170,1679335,4165
"12126",34,4,103,85,1682727,1686985,4258
"12226",34,6,51,86,1689964,1694256,4292
"12424",34,1,52,87,1700460,1704005,3545
"12620",34,4,25,88,1710250,1713715,3465
"12823",34,2,53,89,1719353,1722705,3352
"13020",34,6,27,90,1728323,1732302,3979
"13227",34,4,13,91,1738179,1742291,4112
"13424",34,3,132,92,1747622,1751208,3586
"13519",34,6,75,93,1754027,1758659,4632
"13623",34,3,48,94,1761251,1763550,2299
"13823",34,2,17,95,1770134,1775006,4872
"14024",34,3,12,96,1782016,1784729,2713
"14224",34,1,46,97,1790913,1795178,4265
"14422",34,4,43,98,1801236,1804562,3326
"14625",34,1,112,99,1811066,1814425,3359
"14724",34,3,36,100,1817490,1821402,3912
"14928",34,3,6,101,1827606,1832451,4845
"15126",34,2,65,102,1840055,1843334,3279
"15227",34,4,1,103,1846066,1849838,3772
"15425",34,4,115,104,1855476,1859061,3585
"15524",34,2,11,105,1861867,1865486,3619
"15727",34,6,93,106,1871917,1875962,4045
"15824",34,3,42,107,1878834,1881746,2912
"16027",34,1,130,108,1890223,1894162,3939
"16127",34,3,126,109,1897374,1902765,5391
"16222",34,3,102,110,1905837,1908796,2959
"16326",34,5,56,111,1911749,1916553,4804
"16423",34,4,85,112,1919579,1923777,4198
"16525",34,6,129,113,1926810,1931628,4818
"16619",34,4,133,114,1934887,1938645,3758
"16728",34,5,128,115,1941784,1946676,4892
"16825",34,3,60,116,1950414,1955126,4712
"16926",34,6,135,117,1958398,1962883,4485
"17025",34,1,64,118,1966388,1970413,4025
"17128",34,1,76,119,1973513,1978191,4678
"17225",34,6,3,120,1981350,1985408,4058
"17421",34,5,2,121,1992246,1995411,3165
"17625",34,4,73,122,2003528,2008019,4491
"17722",34,5,74,123,2011052,2015010,3958
"17825",34,2,5,124,2017790,2021448,3658
"18025",34,6,15,125,2027759,2030491,2732
"18222",34,5,38,126,2036795,2040341,3546
"18424",34,1,100,127,2046412,2050064,3652
"18522",34,5,116,128,2053030,2056928,3898
"18623",34,4,31,129,2059767,2064272,4505
"18824",34,6,105,130,2074082,2080426,6344
"18923",34,6,33,131,2083652,2088450,4798
"19128",34,3,78,132,2094528,2097393,2865
"19229",34,5,26,133,2100419,2104157,3738
"19421",34,3,18,134,2112274,2119519,7245
"19625",34,4,19,135,2125823,2129375,3552
"19825",34,5,122,136,2137658,2142944,5286
"19928",34,1,10,137,2146462,2149654,3192
"20125",34,1,136,138,2156152,2160497,4345
"10128",35,4,108,1,3395920,3399879,3959
"11104",35,5,79,2,3403071,3406796,3725
"12108",35,5,67,3,3412234,3415373,3139
"13126",35,5,43,4,3418312,3420791,2479
"15108",35,1,27,5,3427882,3430474,2592
"17106",35,2,130,6,3436458,3440031,3573
"18129",35,2,28,7,3443689,3446875,3186
"2032",35,3,83,8,3453472,3456971,3499
"2127",35,3,23,9,3459577,3462256,2679
"2322",35,3,17,10,3467780,3471019,3239
"2525",35,1,33,11,3477624,3480629,3005
"2720",35,4,96,12,3486694,3491552,4858
"2824",35,5,55,13,3494797,3497023,2226
"2925",35,2,46,14,3500682,3503447,2765
"3123",35,4,42,15,3509365,3512457,3092
"3324",35,4,48,16,3518122,3522387,4265
"3523",35,6,44,17,3528725,3531777,3052
"3722",35,1,51,18,3537948,3541140,3192
"3926",35,2,40,19,3546971,3549990,3019
"4128",35,2,82,20,3557188,3559906,2718
"4222",35,5,37,21,3562659,3566537,3878
"4426",35,1,15,22,3573888,3576580,2692
"4625",35,1,99,23,3582345,3585684,3339
"4723",35,2,52,24,3588782,3591535,2753
"4919",35,2,4,25,3599505,3602877,3372
"5123",35,6,134,26,3609168,3613207,4039
"5226",35,1,129,27,3616126,3621117,4991
"5326",35,3,131,28,3624296,3626575,2279
"5427",35,4,90,29,3629461,3633119,3658
"5526",35,3,101,30,3636198,3638651,2453
"5623",35,3,119,31,3642549,3645934,3385
"5724",35,6,2,32,3649160,3651866,2706
"5926",35,3,47,33,3658130,3660836,2706
"6124",35,2,16,34,3666614,3669306,2692
"6322",35,2,136,35,3675703,3679022,3319
"6426",35,1,135,36,3682394,3686060,3666
"6528",35,6,80,37,3689625,3693064,3439
"6625",35,1,87,38,3697249,3701714,4465
"6722",35,6,32,39,3706186,3709331,3145
"6925",35,3,71,40,3715129,3717388,2259
"7025",35,1,39,41,3720421,3722779,2358
"7221",35,1,21,42,3728644,3731050,2406
"7425",35,6,74,43,3740600,3743578,2978
"7525",35,3,41,44,3746924,3749323,2399
"7723",35,3,107,45,3755861,3758580,2719
"7827",35,2,112,46,3761385,3763671,2286
"7926",35,6,122,47,3767623,3769682,2059
"8023",35,3,11,48,3772601,3774907,2306
"8226",35,2,64,49,3784484,3787516,3032
"8326",35,5,7,50,3790608,3794753,4145
"8523",35,4,72,51,3801011,3803143,2132
"8629",35,6,104,52,3807501,3809501,2000
"8721",35,6,38,53,3813779,3816006,2227
"8921",35,4,30,54,3821683,3824129,2446
"9127",35,1,75,55,3829240,3831519,2279
"9228",35,2,124,56,3834585,3836897,2312
"9326",35,2,34,57,3839456,3843115,3659
"9525",35,1,45,58,3849366,3851319,1953
"9723",35,4,36,59,3857430,3860149,2719
"9923",35,2,88,60,3866240,3868592,2352
"10030",35,2,10,61,3871504,3874677,3173
"10225",35,5,73,62,3881081,3883847,2766
"10324",35,6,26,63,3886939,3889505,2566
"10522",35,6,92,64,3896589,3900167,3578
"10626",35,3,113,65,3903366,3906078,2712
"10725",35,1,93,66,3957680,3960318,2638
"10823",35,4,78,67,3963331,3966523,3192
"10925",35,6,14,68,3970955,3974473,3518
"11129",35,6,62,69,3980865,3983650,2785
"11227",35,5,31,70,3986762,3989194,2432
"11426",35,4,84,71,3994606,3997398,2792
"11520",35,2,22,72,4001537,4005175,3638
"11729",35,3,65,73,4010713,4013206,2493
"11825",35,4,6,74,4017064,4020483,3419
"12026",35,3,53,75,4025534,4030986,5452
"12227",35,5,19,76,4036217,4038623,2406
"12425",35,1,105,77,4044634,4047387,2753
"12523",35,3,137,78,4056090,4059095,3005
"12621",35,3,35,79,4094342,4097128,2786
"12824",35,5,121,80,4103539,4105725,2186
"12928",35,1,111,81,4108810,4111076,2266
"13021",35,2,118,82,4115594,4118340,2746
"13127",35,3,125,83,4121326,4123971,2645
"13228",35,2,106,84,4126757,4128816,2059
"13322",35,6,50,85,4131702,4133868,2166
"13520",35,1,3,86,4140272,4142885,2613
"13722",35,4,54,87,4148916,4151148,2232
"13923",35,6,128,88,4157226,4159785,2559
"14025",35,6,20,89,4162737,4164863,2126
"14225",35,2,70,90,4171541,4199923,28382
"14329",35,5,103,91,4202929,4205128,2199
"14423",35,6,86,92,4214292,4216111,1819
"14522",35,5,61,93,4218897,4221329,2432
"14626",35,5,13,94,4226047,4228293,2246
"14819",35,4,24,95,4234151,4236550,2399
"15027",35,3,95,96,4242481,4244840,2359
"15127",35,1,117,97,4247699,4249525,1826
"15228",35,6,56,98,4252444,4255316,2872
"15322",35,3,29,99,4258602,4261207,2605
"15525",35,5,133,100,4267558,4270038,2480
"15621",35,3,59,101,4273423,4275102,1679
"15728",35,3,77,102,4277888,4280773,2885
"15825",35,4,132,103,4283499,4285938,2439
"15924",35,4,60,104,4289317,4292249,2932
"16028",35,2,94,105,4295848,4298327,2479
"16128",35,6,68,106,4301166,4304612,3446
"16223",35,4,18,107,4307370,4309363,1993
"16424",35,1,9,108,4316314,4319379,3065
"16620",35,5,85,109,4327916,4330822,2906
"16729",35,3,89,110,4359191,4361770,2579
"16826",35,5,127,111,4365396,4367815,2419
"16927",35,6,116,112,4373406,4375119,1713
"17026",35,6,110,113,4378177,4380277,2100
"17129",35,1,69,114,4383282,4385102,1820
"17226",35,5,91,115,4393052,4395478,2426
"17323",35,2,100,116,4401836,4405434,3598
"17422",35,1,57,117,4411032,4413758,2726
"17524",35,4,138,118,4437036,4439708,2672
"17626",35,4,102,119,4442474,4444706,2232
"17723",35,5,115,120,4448438,4450258,1820
"17826",35,1,123,121,4453237,4455256,2019
"17924",35,6,8,122,4458901,4461433,2532
"18130",35,5,25,123,4473016,4475628,2612
"18321",35,4,126,124,4481979,4484592,2613
"18425",35,2,58,125,4487437,4490030,2593
"18523",35,5,97,126,4492989,4495354,2365
"18624",35,6,98,127,4499040,4502192,3152
"18723",35,1,63,128,4505790,4508223,2433
"18825",35,2,76,129,4511069,4513628,2559
"18924",35,5,1,130,4517106,4519726,2620
"19129",35,5,109,131,4526743,4529682,2939
"19230",35,1,81,132,4532554,4535213,2659
"19324",35,4,66,133,4538079,4540531,2452
"19422",35,4,114,134,4543323,4546276,2953
"19522",35,4,12,135,4549201,4551227,2026
"19722",35,4,120,136,4558831,4561237,2406
"19826",35,3,5,137,4564142,4567088,2946
"20025",35,5,49,138,4573152,4576178,3026
"10129",36,5,12,1,221658,226682,5024
"12109",36,6,79,2,233247,237831,4584
"13128",36,3,52,3,240964,243823,2859
"15109",36,3,88,4,249900,254266,4366
"16104",36,4,23,5,257364,260763,3399
"18131",36,1,50,6,266488,270819,4331
"2033",36,3,118,7,277950,283861,5911
"2128",36,5,42,8,287367,291192,3825
"2323",36,2,99,9,297130,300396,3266
"2425",36,5,6,10,304100,310378,6278
"2630",36,1,80,11,316589,320401,3812
"2721",36,6,67,12,323753,326972,3219
"2825",36,1,110,13,329744,332950,3206
"2926",36,1,26,14,336655,340187,3532
"3124",36,6,133,15,348644,351836,3192
"3226",36,4,95,16,354782,359360,4578
"3325",36,6,7,17,362746,368264,5518
"3524",36,6,25,18,374714,378466,3752
"3723",36,2,123,19,384504,392001,7497
"3824",36,6,55,20,394880,397193,2313
"3927",36,3,10,21,400545,404917,4372
"4129",36,4,107,22,411288,415026,3738
"4223",36,4,53,23,418092,422130,4038
"4427",36,5,54,24,427335,431860,4525
"4626",36,2,69,25,439111,441690,2579
"4724",36,6,43,26,444555,448008,3453
"4920",36,4,137,27,453646,458623,4977
"5027",36,4,11,28,461729,464555,2826
"5227",36,3,28,29,471325,477210,5885
"5428",36,1,86,30,483048,487226,4178
"5527",36,2,15,31,490432,493617,3185
"5725",36,2,63,32,499728,505066,5338
"5825",36,4,71,33,507992,511024,3032
"5927",36,1,68,34,513797,516796,2999
"6024",36,1,92,35,520607,525286,4679
"6125",36,1,32,36,528618,531790,3172
"6323",36,3,34,37,538247,543399,5152
"6529",36,3,130,38,550090,553575,3485
"6626",36,4,17,39,556974,562179,5205
"6825",36,6,103,40,568723,573188,4465
"6926",36,4,89,41,576500,580599,4099
"7026",36,6,13,42,584697,589015,4318
"7222",36,6,37,43,596393,603423,7030
"7426",36,2,57,44,609681,612813,3132
"7526",36,5,126,45,616279,622136,5857
"7629",36,1,14,46,625302,629887,4585
"7828",36,4,77,47,636165,640576,4411
"7927",36,4,47,48,643962,646734,2772
"8126",36,1,2,49,654258,656710,2452
"8327",36,3,16,50,664787,667467,2680
"8524",36,4,59,51,675097,681021,5924
"8630",36,6,115,52,684480,687772,3292
"8722",36,2,27,53,691078,694323,3245
"8922",36,3,112,54,701315,704393,3078
"9021",36,3,46,55,707625,710624,2999
"9229",36,4,101,56,716235,719781,3546
"9327",36,2,51,57,722813,724972,2159
"9526",36,5,78,58,731063,735555,4492
"9620",36,6,61,59,738714,744371,5657
"9724",36,6,85,60,747770,751782,4012
"9826",36,3,76,61,754728,758320,3592
"9924",36,2,75,62,761305,766497,5192
"10031",36,3,124,63,770109,772528,2419
"10130",36,2,21,64,775520,779332,3812
"10325",36,4,29,65,785736,790768,5032
"10523",36,5,96,66,830966,835631,4665
"10627",36,2,117,67,838783,841816,3033
"10726",36,6,73,68,845048,849119,4071
"10824",36,1,20,69,852192,855824,3632
"11019",36,3,64,70,862548,867279,4731
"11130",36,1,128,71,870638,875650,5012
"11228",36,1,62,72,879075,882874,3799
"11322",36,1,56,73,886279,890071,3792
"11427",36,3,136,74,893296,896322,3026
"11521",36,2,81,75,899681,902133,2452
"11628",36,1,98,76,905052,908498,3446
"11730",36,4,41,77,911503,914929,3426
"11924",36,6,19,78,921573,924512,2939
"12127",36,4,113,79,933682,938306,4624
"12228",36,1,116,80,941539,945450,3911
"12324",36,6,31,81,948529,952275,3746
"12524",36,3,70,82,959872,964563,4691
"12622",36,3,58,83,968109,972141,4032
"12724",36,5,72,84,975160,977918,2758
"12825",36,6,97,85,981911,986202,4291
"12929",36,6,49,86,989828,993773,3945
"13129",36,1,8,87,1000384,1002603,2219
"13323",36,1,134,88,1009241,1011906,2665
"13425",36,5,48,89,1016384,1019377,2993
"13624",36,5,102,90,1026641,1028933,2292
"13723",36,5,18,91,1031685,1034398,2713
"13924",36,5,108,92,1040442,1043395,2953
"14026",36,3,22,93,1047220,1050432,3212
"14226",36,2,111,94,1056916,1060042,3126
"14330",36,5,84,95,1063207,1066759,3552
"14424",36,5,36,96,1069925,1073670,3745
"14627",36,4,5,97,1080108,1083486,3378
"14820",36,5,30,98,1089251,1091570,2319
"15028",36,6,91,99,1097555,1100347,2792
"15128",36,6,127,100,1103266,1106198,2932
"15229",36,1,104,101,1109210,1114182,4972
"15323",36,3,106,102,1117420,1119513,2093
"15426",36,2,39,103,1122825,1125084,2259
"15622",36,5,114,104,1134761,1139432,4671
"15729",36,6,121,105,1142498,1145870,3372
"15826",36,2,3,106,1148529,1152382,3853
"16029",36,4,35,107,1158372,1161124,2752
"16224",36,5,66,108,1169108,1171554,2446
"16327",36,2,93,109,1174680,1176699,2019
"16425",36,6,109,110,1180017,1183396,3379
"16526",36,1,38,111,1186742,1189734,2992
"16730",36,1,44,112,1195065,1197691,2626
"16928",36,5,132,113,1203722,1206688,2966
"17027",36,2,33,114,1209580,1212866,3286
"17227",36,4,65,115,1218337,1220702,2365
"17324",36,3,94,116,1224848,1228886,4038
"17423",36,5,138,117,1232018,1235171,3153
"17525",36,2,87,118,1240136,1243641,3505
"17627",36,5,24,119,1246753,1250445,3692
"17827",36,3,40,120,1256656,1260834,4178
"18026",36,1,74,121,1267565,1271717,4152
"18132",36,5,90,122,1275169,1277935,2766
"18223",36,4,131,123,1281907,1285212,3305
"18322",36,4,125,124,1287824,1291456,3632
"18426",36,2,105,125,1294788,1297501,2713
"18524",36,2,9,126,1301286,1305491,4205
"18724",36,2,45,127,1311496,1313955,2459
"18925",36,4,119,128,1320033,1324491,4458
"19024",36,2,129,129,1327277,1331302,4025
"19130",36,5,60,130,1334500,1338579,4079
"19231",36,2,135,131,1341998,1345510,3512
"19325",36,3,82,132,1350195,1352454,2259
"19423",36,4,83,133,1355526,1360071,4545
"19523",36,5,120,134,1362890,1365816,2926
"19626",36,1,122,135,1368575,1370294,1719
"19723",36,3,4,136,1373360,1375998,2638
"19929",36,3,100,137,1383896,1387281,3385
"20026",36,6,1,138,1391860,1394632,2772
