"","sub","cond","item","seq","start_time","end_time","duration_ms","deg","prev"
"10",1,2,128,1,558738,569913,11175,"0","orth"
"11",1,2,80,2,573159,581249,8090,"0","orth"
"12",1,3,45,3,585081,591698,6617,"0","mask"
"14",1,4,52,4,597543,602548,5005,"20","valid"
"16",1,4,16,5,608972,612111,3139,"20","valid"
"18",1,1,85,6,618695,625519,6824,"0","valid"
"19",1,2,62,7,628831,632577,3746,"0","orth"
"20",1,1,7,8,636455,650823,14368,"0","valid"
"22",1,3,15,9,658207,660659,2452,"0","mask"
"24",1,3,3,10,666744,672349,5605,"0","mask"
"26",1,2,98,11,680119,686683,6564,"0","orth"
"27",1,5,101,12,690588,697832,7244,"20","orth"
"28",1,2,26,13,701658,708222,6564,"0","orth"
"30",1,6,54,14,714786,719105,4319,"20","mask"
"32",1,5,107,15,726489,731646,5157,"20","orth"
"33",1,5,47,16,735325,738597,3272,"20","orth"
"35",1,2,2,17,744362,748461,4099,"0","orth"
"37",1,5,59,18,754525,759090,4565,"20","orth"
"38",1,2,44,19,762802,766354,3552,"0","orth"
"40",1,3,105,20,772245,775810,3565,"0","mask"
"41",1,4,58,21,778856,785247,6391,"20","valid"
"42",1,6,102,22,788132,792884,4752,"20","mask"
"43",1,6,126,23,796236,800687,4451,"20","mask"
"44",1,5,23,24,803813,809364,5551,"20","orth"
"46",1,1,25,25,815482,818081,2599,"0","valid"
"48",1,1,49,26,824919,829730,4811,"0","valid"
"50",1,5,131,27,835815,842945,7130,"20","orth"
"51",1,5,53,28,846004,849316,3312,"20","orth"
"53",1,5,95,29,855274,860065,4791,"20","orth"
"54",1,3,69,30,863571,871148,7577,"0","mask"
"55",1,5,11,31,874161,886076,11915,"20","orth"
"57",1,3,123,32,891840,901803,9963,"0","mask"
"58",1,3,117,33,905002,907754,2752,"0","mask"
"59",1,2,32,34,911013,916431,5418,"0","orth"
"61",1,2,104,35,922343,927880,5537,"0","orth"
"62",1,6,66,36,930919,935231,4312,"20","mask"
"63",1,6,60,37,938783,944101,5318,"20","mask"
"64",1,3,135,38,947473,955530,8057,"0","mask"
"65",1,6,42,39,958662,966819,8157,"20","mask"
"67",1,6,138,40,974063,980687,6624,"20","mask"
"68",1,2,134,41,983666,987705,4039,"0","orth"
"69",1,3,129,42,990824,998374,7550,"0","mask"
"70",1,5,83,43,1002360,1014142,11782,"20","orth"
"71",1,2,110,44,1017594,1022825,5231,"0","orth"
"72",1,4,40,45,1026317,1037146,10829,"20","valid"
"74",1,5,71,46,1044524,1048136,3612,"20","orth"
"75",1,4,76,47,1051428,1054114,2686,"20","valid"
"76",1,2,122,48,1057226,1059845,2619,"0","orth"
"77",1,4,118,49,1062917,1066909,3992,"20","valid"
"78",1,4,100,50,1069754,1072587,2833,"20","valid"
"79",1,1,37,51,1075633,1081590,5957,"0","valid"
"81",1,5,17,52,1087555,1093306,5751,"20","orth"
"83",1,1,61,53,1099649,1104747,5098,"0","valid"
"84",1,4,4,54,1107959,1110932,2973,"20","valid"
"86",1,4,64,55,1116496,1119608,3112,"20","valid"
"87",1,4,22,56,1122327,1127232,4905,"20","valid"
"89",1,4,88,57,1133497,1143466,9969,"20","valid"
"90",1,5,125,58,1148030,1151775,3745,"20","orth"
"91",1,5,89,59,1154634,1160299,5665,"20","orth"
"92",1,6,36,60,1163225,1166823,3598,"20","mask"
"94",1,3,33,61,1174187,1178092,3905,"0","mask"
"96",1,1,19,62,1184603,1188368,3765,"0","valid"
"98",1,5,65,63,1194513,1198397,3884,"20","orth"
"99",1,2,92,64,1203423,1206754,3331,"0","orth"
"100",1,5,41,65,1209933,1214631,4698,"20","orth"
"102",1,1,121,66,1286758,1293282,6524,"0","valid"
"103",1,4,28,67,1296308,1300013,3705,"20","valid"
"105",1,4,70,68,1305778,1310523,4745,"20","valid"
"106",1,1,109,69,1313635,1318166,4531,"0","valid"
"107",1,3,39,70,1320946,1331621,10675,"0","mask"
"109",1,2,14,71,1337679,1341904,4225,"0","orth"
"111",1,4,112,72,1349682,1352394,2712,"20","valid"
"112",1,3,87,73,1356699,1365096,8397,"0","mask"
"113",1,6,48,74,1368015,1378091,10076,"20","mask"
"115",1,1,13,75,1390326,1400049,9723,"0","valid"
"117",1,5,119,76,1405367,1409659,4292,"20","orth"
"118",1,4,136,77,1412804,1417323,4519,"20","valid"
"119",1,1,67,78,1420388,1423221,2833,"0","valid"
"120",1,1,133,79,1426706,1428878,2172,"0","valid"
"121",1,3,93,80,1433004,1436529,3525,"0","mask"
"122",1,3,51,81,1439948,1442694,2746,"0","mask"
"124",1,5,113,82,1448565,1455189,6624,"20","orth"
"125",1,6,114,83,1458215,1464325,6110,"20","mask"
"126",1,2,20,84,1467544,1470750,3206,"0","orth"
"128",1,4,82,85,1477140,1481438,4298,"20","valid"
"129",1,5,35,86,1485250,1489069,3819,"20","orth"
"131",1,1,55,87,1495466,1498652,3186,"0","valid"
"132",1,2,38,88,1501791,1507115,5324,"0","orth"
"134",1,5,137,89,1512620,1516792,4172,"20","orth"
"135",1,1,43,90,1519731,1526261,6530,"0","valid"
"137",1,4,124,91,1532146,1537371,5225,"20","valid"
"138",1,2,68,92,1540696,1546787,6091,"0","orth"
"139",1,1,73,93,1549827,1554024,4197,"0","valid"
"140",1,6,90,94,1557177,1564607,7430,"20","mask"
"141",1,3,9,95,1567886,1571312,3426,"0","mask"
"143",1,2,56,96,1577676,1584906,7230,"0","orth"
"144",1,4,34,97,1587985,1591291,3306,"20","valid"
"146",1,3,75,98,1597368,1602367,4999,"0","mask"
"147",1,1,115,99,1605679,1608791,3112,"0","valid"
"148",1,4,94,100,1613096,1616994,3898,"20","valid"
"149",1,5,5,101,1620214,1626084,5870,"20","orth"
"151",1,3,57,102,1632989,1636894,3905,"0","mask"
"152",1,6,120,103,1640346,1643451,3105,"20","mask"
"153",1,6,24,104,1646831,1650849,4018,"20","mask"
"155",1,5,29,105,1657247,1662824,5577,"20","orth"
"157",1,3,27,106,1669369,1672007,2638,"0","mask"
"159",1,6,78,107,1677099,1679005,1906,"20","mask"
"160",1,6,30,108,1681877,1683970,2093,"20","mask"
"162",1,1,79,109,1689821,1692633,2812,"0","valid"
"163",1,3,21,110,1695506,1698851,3345,"0","mask"
"165",1,6,18,111,1704556,1708314,3758,"20","mask"
"167",1,6,108,112,1713805,1724735,10930,"20","mask"
"168",1,2,74,113,1728080,1734098,6018,"0","orth"
"169",1,4,46,114,1737230,1739782,2552,"20","valid"
"171",1,6,132,115,1745420,1748433,3013,"20","mask"
"172",1,1,97,116,1754997,1757742,2745,"0","valid"
"173",1,1,103,117,1781967,1787098,5131,"0","valid"
"174",1,4,130,118,1790957,1794596,3639,"20","valid"
"175",1,3,99,119,1798654,1803972,5318,"0","mask"
"176",1,1,31,120,1807291,1813209,5918,"0","valid"
"178",1,6,6,121,1820526,1823672,3146,"20","mask"
"180",1,2,116,122,1829363,1832501,3138,"0","orth"
"181",1,2,50,123,1835420,1838533,3113,"0","orth"
"183",1,6,72,124,1843911,1847409,3498,"20","mask"
"184",1,5,77,125,1851255,1854833,3578,"20","orth"
"185",1,6,84,126,1858299,1863277,4978,"20","mask"
"186",1,4,10,127,1866736,1869955,3219,"20","valid"
"188",1,3,111,128,1876159,1882770,6611,"0","mask"
"189",1,1,127,129,1886715,1889681,2966,"0","valid"
"190",1,4,106,130,1892506,1895312,2806,"20","valid"
"191",1,3,81,131,1898091,1899997,1906,"0","mask"
"192",1,3,63,132,1903129,1904928,1799,"0","mask"
"193",1,2,8,133,1907954,1909753,1799,"0","orth"
"195",1,1,1,134,1916164,1918136,1972,"0","valid"
"197",1,6,12,135,1924141,1927447,3306,"20","mask"
"199",1,6,96,136,1933564,1937143,3579,"20","mask"
"200",1,1,91,137,1939969,1942094,2125,"0","valid"
"201",1,2,86,138,1944920,1946406,1486,"0","orth"
"101",2,4,57,1,2978401,2983212,4811,"20","valid"
"1110",2,5,136,2,2986291,2994049,7758,"20","orth"
"123",2,3,20,3,2999311,3004083,4772,"0","mask"
"1410",2,3,38,4,3013626,3018313,4687,"0","mask"
"164",2,1,6,5,3026934,3031509,4575,"0","valid"
"1810",2,6,17,6,3038536,3045778,7242,"20","mask"
"202",2,5,70,7,3058054,3066557,8503,"20","orth"
"21",2,2,55,8,3072663,3076918,4255,"0","orth"
"221",2,3,86,9,3083951,3089853,5902,"0","mask"
"23",2,3,122,10,3114528,3118267,3739,"0","mask"
"241",2,4,39,11,3124725,3130941,6216,"20","valid"
"261",2,6,101,12,3137817,3141451,3634,"20","mask"
"271",2,2,115,13,3145890,3149079,3189,"0","orth"
"281",2,5,130,14,3152243,3157367,5124,"20","orth"
"29",2,4,33,15,3162799,3166943,4144,"20","valid"
"31",2,5,124,16,3177356,3180937,3581,"20","orth"
"321",2,5,64,17,3187049,3190775,3726,"20","orth"
"331",2,3,50,18,3194625,3198547,3922,"0","mask"
"351",2,6,35,19,3205665,3210332,4667,"20","mask"
"371",2,2,37,20,3219110,3224868,5758,"0","orth"
"39",2,5,58,21,3232948,3238471,5523,"20","orth"
"401",2,2,25,22,3244341,3248334,3993,"0","orth"
"421",2,3,26,23,3256740,3261753,5013,"0","mask"
"441",2,4,27,24,3269845,3275643,5798,"20","valid"
"461",2,4,75,25,3283402,3290736,7334,"20","valid"
"47",2,3,80,26,3297377,3300958,3581,"0","mask"
"481",2,1,72,27,3304737,3308344,3607,"0","valid"
"49",2,4,21,28,3313280,3318247,4967,"20","valid"
"511",2,3,98,29,3327196,3332817,5621,"0","mask"
"52",2,6,65,30,3343393,3348138,4745,"20","mask"
"531",2,2,31,31,3352439,3356831,4392,"0","orth"
"551",2,3,116,32,3366381,3371394,5013,"0","mask"
"56",2,1,30,33,3376820,3379663,2843,"0","valid"
"581",2,2,73,34,3387284,3390232,2948,"0","orth"
"591",2,4,81,35,3395063,3398730,3667,"20","valid"
"60",2,5,4,36,3404697,3410181,5484,"20","orth"
"621",2,5,112,37,3419685,3423725,4040,"20","orth"
"631",2,5,82,38,3428503,3432157,3654,"20","orth"
"641",2,1,60,39,3439785,3445295,5510,"0","valid"
"651",2,2,79,40,3451321,3454877,3556,"0","orth"
"66",2,6,71,41,3458610,3461707,3097,"20","mask"
"671",2,3,68,42,3465388,3470185,4797,"0","mask"
"681",2,3,32,43,3475343,3478421,3078,"0","mask"
"701",2,3,104,44,3490461,3494350,3889,"0","mask"
"711",2,6,107,45,3500272,3504253,3981,"20","mask"
"721",2,1,66,46,3508672,3511966,3294,"0","valid"
"73",2,3,8,47,3518881,3522300,3419,"0","mask"
"751",2,1,18,48,3533542,3538373,4831,"0","valid"
"771",2,1,114,49,3568179,3571394,3215,"0","valid"
"781",2,4,117,50,3574480,3577689,3209,"20","valid"
"791",2,2,121,51,3580702,3583605,2903,"0","orth"
"80",2,6,131,52,3586670,3590409,3739,"20","mask"
"811",2,6,119,53,3593821,3598435,4614,"20","mask"
"82",2,6,29,54,3603233,3606364,3131,"20","mask"
"841",2,1,42,55,3615384,3618659,3275,"0","valid"
"861",2,4,111,56,3626836,3630601,3765,"20","valid"
"871",2,5,118,57,3634347,3637608,3261,"20","orth"
"88",2,1,12,58,3641863,3645831,3968,"0","valid"
"901",2,4,69,59,3654564,3657479,2915,"20","valid"
"911",2,3,44,60,3660133,3663290,3157,"0","mask"
"93",2,1,36,61,3671329,3674061,2732,"0","valid"
"95",2,5,22,62,3682977,3686794,3817,"20","orth"
"97",2,5,46,63,3694795,3698043,3248,"20","orth"
"991",2,5,76,64,3704939,3710064,5125,"20","orth"
"1001",2,4,9,65,3713391,3716869,3478,"20","valid"
"1021",2,1,138,66,3785585,3789546,3961,"0","valid"
"1031",2,3,14,67,3793181,3797050,3869,"0","mask"
"1051",2,6,95,68,3807711,3811404,3693,"20","mask"
"1061",2,2,19,69,3814495,3817731,3236,"0","orth"
"108",2,5,34,70,3827457,3831595,4138,"20","orth"
"110",2,4,15,71,3840399,3843687,3288,"20","valid"
"1121",2,4,3,72,3851112,3853988,2876,"20","valid"
"114",2,6,59,73,3861329,3865473,4144,"20","mask"
"1151",2,3,74,74,3870669,3874695,4026,"0","mask"
"116",2,5,10,75,3878121,3882925,4804,"20","orth"
"1181",2,5,106,76,3889815,3893050,3235,"20","orth"
"1191",2,2,133,77,3896717,3900272,3555,"0","orth"
"1201",2,1,54,78,3903325,3906587,3262,"0","valid"
"1221",2,6,11,79,3918372,3920843,2471,"20","mask"
"1241",2,2,13,80,3928124,3932033,3909,"0","orth"
"1261",2,4,105,81,3940393,3943119,2726,"20","valid"
"127",2,3,128,82,3946609,3950439,3830,"0","mask"
"1281",2,1,132,83,3953564,3957904,4340,"0","valid"
"1291",2,2,127,84,3961629,3964244,2615,"0","orth"
"130",2,4,123,85,3967297,3971382,4085,"20","valid"
"1311",2,3,92,86,3974604,3979147,4543,"0","mask"
"1321",2,4,63,87,3982245,3985239,2994,"20","valid"
"133",2,6,53,88,3988089,3991775,3686,"20","mask"
"1351",2,5,52,89,3998893,4001854,2961,"20","orth"
"1371",2,1,96,90,4009535,4013038,3503,"0","valid"
"1381",2,5,40,91,4017234,4021208,3974,"20","orth"
"1401",2,6,83,92,4028209,4032660,4451,"20","mask"
"1411",2,1,84,93,4036733,4039582,2849,"0","valid"
"142",2,3,56,94,4045282,4049596,4314,"0","mask"
"1431",2,3,110,95,4052838,4055590,2752,"0","mask"
"1441",2,4,93,96,4064564,4067623,3059,"20","valid"
"145",2,5,100,97,4071506,4074454,2948,"20","orth"
"1461",2,2,1,98,4077624,4080840,3216,"0","orth"
"1481",2,3,62,99,4094919,4098619,3700,"0","mask"
"1491",2,2,109,100,4102149,4105966,3817,"0","orth"
"150",2,2,103,101,4110169,4114280,4111,"0","orth"
"1511",2,1,90,102,4117516,4121744,4228,"0","valid"
"1521",2,1,48,103,4126673,4128869,2196,"0","valid"
"154",2,6,23,104,4139144,4142465,3321,"20","mask"
"156",2,5,16,105,4150158,4154106,3948,"20","orth"
"158",2,6,5,106,4172807,4176304,3497,"20","mask"
"1601",2,4,87,107,4183160,4186246,3086,"20","valid"
"161",2,6,125,108,4189095,4191886,2791,"20","mask"
"1621",2,1,126,109,4194619,4197991,3372,"0","valid"
"1631",2,6,41,110,4201057,4203953,2896,"20","mask"
"1651",2,1,24,111,4212528,4215378,2850,"0","valid"
"1671",2,1,78,112,4222961,4226078,3117,"0","valid"
"1681",2,1,102,113,4229353,4232314,2961,"0","valid"
"1691",2,1,120,114,4235465,4240543,5078,"0","valid"
"170",2,3,2,115,4244335,4247171,2836,"0","mask"
"1721",2,4,51,116,4255224,4258309,3085,"20","valid"
"1741",2,3,134,117,4265989,4269264,3275,"0","mask"
"1751",2,6,137,118,4284180,4288317,4137,"20","mask"
"1761",2,1,108,119,4292148,4296318,4170,"0","valid"
"177",2,6,113,120,4299351,4301998,2647,"20","mask"
"1781",2,4,99,121,4304992,4308221,3229,"20","valid"
"179",2,5,28,122,4313947,4317313,3366,"20","orth"
"1811",2,4,129,123,4326320,4330281,3961,"20","valid"
"182",2,4,135,124,4336386,4340576,4190,"20","valid"
"1831",2,6,77,125,4344413,4348178,3765,"20","mask"
"1841",2,2,61,126,4352283,4355270,2987,"0","orth"
"1851",2,5,88,127,4359061,4363198,4137,"20","orth"
"1861",2,2,91,128,4366186,4369349,3163,"0","orth"
"187",2,6,47,129,4372055,4374585,2530,"20","mask"
"1891",2,2,49,130,4383402,4386376,2974,"0","orth"
"1911",2,4,45,131,4393834,4396351,2517,"20","valid"
"1931",2,2,85,132,4403913,4408430,4517,"0","orth"
"194",2,2,43,133,4412005,4414803,2798,"0","orth"
"196",2,2,97,134,4420993,4425039,4046,"0","orth"
"1971",2,2,67,135,4428360,4431026,2666,"0","orth"
"198",2,2,7,136,4435805,4439523,3718,"0","orth"
"2001",2,6,89,137,4448269,4451773,3504,"20","mask"
"2011",2,5,94,138,4454910,4459394,4484,"20","orth"
"104",3,4,116,1,8027426,8031218,3792,"20","valid"
"1111",3,4,20,2,8034437,8037082,2645,"20","valid"
"13",3,2,102,3,8042480,8044973,2493,"0","orth"
"1412",3,4,110,4,8047718,8050590,2872,"20","valid"
"15",3,1,17,5,8053743,8057148,3405,"0","valid"
"17",3,2,138,6,8062540,8065359,2819,"0","orth"
"1812",3,4,68,7,8068617,8071483,2866,"20","valid"
"1910",3,5,51,8,8076821,8079073,2252,"20","orth"
"211",3,6,82,9,8083998,8085937,1939,"20","mask"
"222",3,1,53,10,8088943,8091509,2566,"0","valid"
"242",3,2,72,11,8096434,8098626,2192,"0","orth"
"25",3,3,133,12,8101519,8103904,2385,"0","mask"
"262",3,6,16,13,8106703,8109009,2306,"20","mask"
"282",3,1,107,14,8115353,8118026,2673,"0","valid"
"291",3,1,131,15,8120831,8123310,2479,"0","valid"
"301",3,4,8,16,8126343,8129881,3538,"20","valid"
"322",3,4,80,17,8135140,8137165,2025,"20","valid"
"332",3,6,70,18,8140011,8142390,2379,"20","mask"
"34",3,1,113,19,8145076,8147009,1933,"0","valid"
"352",3,6,58,20,8149868,8153373,3505,"20","mask"
"36",3,2,6,21,8156352,8158997,2645,"0","orth"
"381",3,2,114,22,8164542,8167315,2773,"0","orth"
"391",3,3,31,23,8170420,8173359,2939,"0","mask"
"411",3,4,98,24,8179396,8183495,4099,"20","valid"
"422",3,1,83,25,8186721,8189913,3192,"0","valid"
"431",3,4,44,26,8192752,8195317,2565,"20","valid"
"45",3,6,10,27,8200709,8204194,3485,"20","mask"
"471",3,4,56,28,8210198,8213924,3726,"20","valid"
"482",3,3,1,29,8216896,8220508,3612,"0","mask"
"501",3,5,45,30,8225713,8229012,3299,"20","orth"
"521",3,5,69,31,8234643,8237842,3199,"20","orth"
"532",3,5,3,32,8240780,8244133,3353,"20","orth"
"552",3,4,92,33,8249198,8253989,4791,"20","valid"
"561",3,3,25,34,8257041,8260593,3552,"0","mask"
"582",3,2,90,35,8265372,8268617,3245,"0","orth"
"592",3,4,86,36,8271296,8274708,3412,"20","valid"
"601",3,1,119,37,8277820,8282032,4212,"0","valid"
"611",3,1,71,38,8284811,8287370,2559,"0","valid"
"622",3,2,24,39,8290122,8293275,3153,"0","orth"
"642",3,3,127,40,8299246,8301971,2725,"0","mask"
"652",3,6,88,41,8305157,8307976,2819,"20","mask"
"661",3,5,57,42,8310901,8314034,3133,"20","orth"
"672",3,2,12,43,8316819,8319525,2706,"0","orth"
"691",3,6,46,44,8325256,8329108,3852,"20","mask"
"712",3,6,64,45,8335999,8338705,2706,"20","mask"
"722",3,3,61,46,8341543,8345828,4285,"0","mask"
"731",3,1,29,47,8349034,8351886,2852,"0","valid"
"752",3,3,67,48,8357444,8361303,3859,"0","mask"
"761",3,4,74,49,8364428,8368194,3766,"20","valid"
"772",3,2,42,50,8371166,8373078,1912,"0","orth"
"792",3,3,73,51,8379403,8381735,2332,"0","mask"
"801",3,5,21,52,8384521,8386507,1986,"20","orth"
"821",3,6,4,53,8392418,8394590,2172,"20","mask"
"842",3,1,23,54,8399269,8400928,1659,"0","valid"
"862",3,2,66,55,8405680,8408059,2379,"0","orth"
"872",3,2,78,56,8411351,8413517,2166,"0","orth"
"881",3,5,9,57,8416582,8419275,2693,"20","orth"
"902",3,1,137,58,8424366,8426812,2446,"0","valid"
"912",3,1,47,59,8430204,8433370,3166,"0","valid"
"931",3,1,65,60,8438488,8440254,1766,"0","valid"
"941",3,2,126,61,8443066,8445265,2199,"0","orth"
"951",3,1,11,62,8448071,8449897,1826,"0","valid"
"971",3,3,55,63,8457034,8459493,2459,"0","mask"
"981",3,5,111,64,8462492,8467297,4805,"20","orth"
"992",3,2,96,65,8470270,8473688,3418,"0","orth"
"1002",3,4,2,66,8501278,8504377,3099,"20","valid"
"1022",3,5,129,67,8509788,8514600,4812,"20","orth"
"1032",3,6,52,68,8517752,8520131,2379,"20","mask"
"1052",3,5,105,69,8525389,8529274,3885,"20","orth"
"1062",3,3,121,70,8532453,8535325,2872,"0","mask"
"1071",3,1,41,71,8538284,8541290,3006,"0","valid"
"1091",3,4,26,72,8546561,8549160,2599,"20","valid"
"1112",3,3,7,73,8556637,8561982,5345,"0","mask"
"1131",3,5,39,74,8569913,8573371,3458,"20","orth"
"1152",3,5,75,75,8579316,8582728,3412,"20","orth"
"1161",3,3,19,76,8585600,8587933,2333,"0","mask"
"1182",3,3,43,77,8593391,8599675,6284,"0","mask"
"1202",3,1,5,78,8605600,8609425,3825,"0","valid"
"1222",3,1,125,79,8614956,8618608,3652,"0","valid"
"1231",3,6,106,80,8621281,8623479,2198,"20","mask"
"1242",3,4,62,81,8626199,8628917,2718,"20","valid"
"1251",3,6,28,82,8631597,8634769,3172,"20","mask"
"1271",3,2,48,83,8640473,8641926,1453,"0","orth"
"1292",3,6,22,84,8647591,8650956,3365,"20","mask"
"1312",3,1,59,85,8656334,8659906,3572,"0","valid"
"1322",3,4,122,86,8662872,8665064,2192,"20","valid"
"1331",3,5,33,87,8668096,8671895,3799,"20","orth"
"1352",3,5,99,88,8677633,8680332,2699,"20","orth"
"136",3,2,54,89,8683404,8685504,2100,"0","orth"
"1382",3,3,13,90,8691794,8696679,4885,"0","mask"
"1402",3,5,117,91,8701504,8703823,2319,"20","orth"
"1413",3,4,128,92,8706822,8710241,3419,"20","valid"
"1421",3,4,32,93,8713260,8716232,2972,"20","valid"
"1442",3,4,14,94,8721397,8725162,3765,"20","valid"
"1462",3,5,135,95,8730527,8735771,5244,"20","orth"
"1471",3,6,100,96,8738650,8743089,4439,"20","mask"
"1482",3,6,136,97,8746568,8750166,3598,"20","mask"
"1492",3,4,134,98,8753372,8756431,3059,"20","valid"
"1501",3,5,123,99,8759316,8763295,3979,"20","orth"
"1512",3,2,120,100,8766054,8769926,3872,"0","orth"
"1522",3,2,18,101,8773058,8775503,2445,"0","orth"
"1541",3,3,109,102,8781248,8786506,5258,"0","mask"
"1551",3,6,124,103,8789432,8792691,3259,"20","mask"
"1561",3,2,60,104,8795536,8799335,3799,"0","orth"
"1571",3,3,79,105,8802301,8806792,4491,"0","mask"
"1581",3,4,38,106,8809797,8812830,3033,"20","valid"
"1602",3,5,87,107,8818501,8822846,4345,"20","orth"
"1611",3,1,89,108,8825892,8829390,3498,"0","valid"
"1622",3,6,94,109,8832456,8835981,3525,"20","mask"
"1632",3,2,84,110,8838700,8842539,3839,"0","orth"
"1641",3,6,34,111,8845571,8850043,4472,"20","mask"
"166",3,3,49,112,8856127,8860352,4225,"0","mask"
"1682",3,4,104,113,8865190,8868942,3752,"20","valid"
"1692",3,1,95,114,8871961,8875827,3866,"0","valid"
"1701",3,5,81,115,8879119,8881925,2806,"20","orth"
"1711",3,2,108,116,8884950,8888089,3139,"0","orth"
"1722",3,6,76,117,8890888,8894926,4038,"20","mask"
"1731",3,1,77,118,8897785,8900504,2719,"0","valid"
"1742",3,3,115,119,8903376,8906409,3033,"0","mask"
"1752",3,6,118,120,8909581,8913753,4172,"20","mask"
"1762",3,4,50,121,8916725,8919137,2412,"20","valid"
"1782",3,3,97,122,8924242,8927648,3406,"0","mask"
"1791",3,1,101,123,8930886,8934458,3572,"0","valid"
"1801",3,2,30,124,8936917,8939670,2753,"0","orth"
"1821",3,3,37,125,8944535,8948773,4238,"0","mask"
"1842",3,2,36,126,8954198,8957124,2926,"0","orth"
"1862",3,1,35,127,8962702,8965574,2872,"0","valid"
"1881",3,3,85,128,8971585,8975776,4191,"0","mask"
"1892",3,6,40,129,8979162,8984766,5604,"20","mask"
"1912",3,6,112,130,8990378,8993610,3232,"20","mask"
"1921",3,5,27,131,8996429,9000701,4272,"20","orth"
"1941",3,6,130,132,9006192,9009744,3552,"20","mask"
"1951",3,5,63,133,9012723,9015615,2892,"20","orth"
"1961",3,5,93,134,9018334,9021320,2986,"20","orth"
"1972",3,3,91,135,9024905,9030916,6011,"0","mask"
"1981",3,5,15,136,9033995,9037120,3125,"20","orth"
"2002",3,2,132,137,9042392,9046004,3612,"0","orth"
"2012",3,3,103,138,9049010,9053494,4484,"0","mask"
"1010",4,3,24,1,3537753,3543749,5996,"0","mask"
"1210",4,1,82,2,3550059,3554353,4294,"0","valid"
"1310",4,5,92,3,3557943,3562961,5018,"20","orth"
"1414",4,3,48,4,3566009,3569407,3398,"0","mask"
"1610",4,4,127,5,3575320,3579503,4183,"20","valid"
"1710",4,5,32,6,3582687,3587685,4998,"20","orth"
"1913",4,2,137,7,3598307,3602021,3714,"0","orth"
"203",4,1,40,8,3605309,3609584,4275,"0","valid"
"223",4,1,10,9,3615929,3620707,4778,"0","valid"
"243",4,4,31,10,3627484,3631889,4405,"20","valid"
"263",4,6,135,11,3638757,3643991,5234,"20","mask"
"272",4,5,50,12,3647163,3651317,4154,"20","orth"
"292",4,3,66,13,3657124,3660909,3785,"0","mask"
"302",4,4,115,14,3663777,3667581,3804,"20","valid"
"311",4,6,9,15,3671402,3675937,4535,"20","mask"
"333",4,2,101,16,3683519,3686533,3014,"0","orth"
"341",4,2,125,17,3689577,3692678,3101,"0","orth"
"353",4,3,72,18,3695913,3699627,3714,"0","mask"
"361",4,5,86,19,3702956,3706519,3563,"20","orth"
"372",4,6,129,20,3710042,3716671,6629,"20","mask"
"382",4,6,57,21,3720686,3724648,3962,"20","mask"
"392",4,2,89,22,3728160,3732312,4152,"0","orth"
"402",4,5,62,23,3735953,3739821,3868,"20","orth"
"412",4,5,116,24,3743105,3747274,4169,"20","orth"
"423",4,5,38,25,3750512,3754142,3630,"20","orth"
"442",4,2,35,26,3760506,3763068,2562,"0","orth"
"462",4,6,21,27,3770245,3773095,2850,"20","mask"
"483",4,3,60,28,3779788,3783450,3662,"0","mask"
"491",4,3,18,29,3786593,3790731,4138,"0","mask"
"512",4,4,67,30,3796792,3799227,2435,"20","valid"
"522",4,1,16,31,3802873,3805995,3122,"0","valid"
"541",4,6,81,32,3812350,3815910,3560,"20","mask"
"553",4,3,36,33,3819753,3822966,3213,"0","mask"
"571",4,1,88,34,3829950,3832999,3049,"0","valid"
"583",4,3,132,35,3835942,3839411,3469,"0","mask"
"593",4,2,131,36,3844653,3848042,3389,"0","orth"
"602",4,3,96,37,3851217,3854370,3153,"0","mask"
"612",4,2,77,38,3857393,3860447,3054,"0","orth"
"623",4,5,134,39,3864333,3868302,3969,"20","orth"
"632",4,5,14,40,3872100,3876366,4266,"20","orth"
"653",4,3,114,41,3883266,3886935,3669,"0","mask"
"662",4,3,54,42,3890394,3892866,2472,"0","mask"
"682",4,1,130,43,3903970,3907141,3171,"0","valid"
"692",4,6,99,44,3911333,3914592,3259,"20","mask"
"702",4,6,15,45,3917887,3920521,2634,"20","mask"
"723",4,2,5,46,3926663,3929293,2630,"0","orth"
"741",4,4,37,47,3935973,3940064,4091,"20","valid"
"762",4,6,33,48,3946644,3950379,3735,"20","mask"
"782",4,3,42,49,3957266,3960653,3387,"0","mask"
"802",4,1,118,50,3967612,3971006,3394,"0","valid"
"812",4,4,73,51,3974584,3977495,2911,"20","valid"
"822",4,4,61,52,3981034,3984648,3614,"20","valid"
"831",4,2,59,53,3987838,3991221,3383,"0","orth"
"843",4,4,103,54,3996022,4000061,4039,"20","valid"
"85",4,4,133,55,4003462,4006528,3066,"20","valid"
"863",4,4,19,56,4009824,4012828,3004,"20","valid"
"882",4,4,109,57,4019541,4024751,5210,"20","valid"
"891",4,6,51,58,4027945,4031288,3343,"20","mask"
"913",4,5,128,59,4037154,4041839,4685,"20","orth"
"921",4,4,25,60,4045672,4049164,3492,"20","valid"
"942",4,1,22,61,4055421,4058561,3140,"0","valid"
"961",4,6,123,62,4064810,4068731,3921,"20","mask"
"972",4,2,83,63,4072428,4076192,3764,"0","orth"
"982",4,1,4,64,4081566,4084929,3363,"0","valid"
"1003",4,4,49,65,4092686,4096051,3365,"20","valid"
"1023",4,5,110,66,4130847,4134478,3631,"20","orth"
"1033",4,3,12,67,4138044,4141555,3511,"0","mask"
"1053",4,6,63,68,4148000,4150866,2866,"20","mask"
"1063",4,4,91,69,4154377,4158069,3692,"20","valid"
"1072",4,3,78,70,4161302,4164184,2882,"0","mask"
"1081",4,3,108,71,4167274,4171430,4156,"0","mask"
"1092",4,6,45,72,4179286,4183172,3886,"20","mask"
"1113",4,4,43,73,4189832,4192948,3116,"20","valid"
"1132",4,1,34,74,4201401,4204618,3217,"0","valid"
"1153",4,1,58,75,4212770,4216554,3784,"0","valid"
"1162",4,3,90,76,4219920,4223497,3577,"0","mask"
"1171",4,2,107,77,4233305,4236467,3162,"0","orth"
"1183",4,1,124,78,4240300,4243090,2790,"0","valid"
"1192",4,5,2,79,4246249,4249272,3023,"20","orth"
"1211",4,1,112,80,4255861,4258238,2377,"0","valid"
"1223",4,6,39,81,4262632,4265589,2957,"20","mask"
"1243",4,2,53,82,4272867,4276293,3426,"0","orth"
"1262",4,1,46,83,4282230,4284855,2625,"0","valid"
"1282",4,5,80,84,4291760,4295653,3893,"20","orth"
"1293",4,4,79,85,4299803,4303798,3995,"20","valid"
"1301",4,2,113,86,4309040,4312198,3158,"0","orth"
"1313",4,5,104,87,4316779,4320162,3383,"20","orth"
"1323",4,3,84,88,4324341,4327653,3312,"0","mask"
"1332",4,2,71,89,4331794,4334470,2676,"0","orth"
"1341",4,6,75,90,4337623,4341710,4087,"20","mask"
"1353",4,5,20,91,4345815,4349331,3516,"20","orth"
"1372",4,2,41,92,4356829,4359948,3119,"0","orth"
"1391",4,5,74,93,4366219,4369573,3354,"20","orth"
"1403",4,1,28,94,4373459,4376968,3509,"0","valid"
"1422",4,6,105,95,4383172,4386549,3377,"20","mask"
"1432",4,2,29,96,4389537,4393161,3624,"0","orth"
"1451",4,1,136,97,4399496,4402804,3308,"0","valid"
"1463",4,4,97,98,4405698,4408622,2924,"20","valid"
"1472",4,3,30,99,4411522,4414234,2712,"0","mask"
"1493",4,1,70,100,4422631,4426250,3619,"0","valid"
"1502",4,5,98,101,4429519,4433113,3594,"20","orth"
"1513",4,2,11,102,4436356,4438825,2469,"0","orth"
"1531",4,5,68,103,4445718,4450502,4784,"20","orth"
"1542",4,3,138,104,4454321,4457832,3511,"0","mask"
"1552",4,4,85,105,4461420,4465696,4276,"20","valid"
"1562",4,2,119,106,4469449,4473419,3970,"0","orth"
"1572",4,4,1,107,4477218,4480796,3578,"20","valid"
"1591",4,6,117,108,4487628,4490499,2871,"20","mask"
"1603",4,4,13,109,4493452,4496687,3235,"20","valid"
"1623",4,1,64,110,4503109,4507150,4041,"0","valid"
"1633",4,3,102,111,4511880,4515810,3930,"0","mask"
"1642",4,3,126,112,4519405,4523115,3710,"0","mask"
"1652",4,1,52,113,4526746,4530197,3451,"0","valid"
"1672",4,6,87,114,4538277,4542462,4185,"20","mask"
"1683",4,3,120,115,4545679,4549457,3778,"0","mask"
"1693",4,6,93,116,4552710,4555837,3127,"20","mask"
"1702",4,1,106,117,4558918,4561946,3028,"0","valid"
"1712",4,1,94,118,4565458,4569386,3928,"0","valid"
"1723",4,2,65,119,4572586,4575201,2615,"0","orth"
"1732",4,5,8,120,4578534,4582338,3804,"20","orth"
"1753",4,4,121,121,4588612,4591956,3344,"20","valid"
"1763",4,2,95,122,4595630,4598530,2900,"0","orth"
"1771",4,4,7,123,4601959,4606097,4138,"20","valid"
"1792",4,2,17,124,4613275,4616780,3505,"0","orth"
"1813",4,2,23,125,4623357,4626389,3032,"0","orth"
"1832",4,3,6,126,4633913,4637639,3726,"0","mask"
"1852",4,6,111,127,4644136,4647146,3010,"20","mask"
"1863",4,5,122,128,4650276,4653392,3116,"20","orth"
"1871",4,5,44,129,4656858,4659984,3126,"20","orth"
"1893",4,1,76,130,4666164,4669747,3583,"0","valid"
"1901",4,4,55,131,4673366,4676237,2871,"20","valid"
"1914",4,5,56,132,4679517,4683302,3785,"20","orth"
"1922",4,6,3,133,4686797,4690201,3404,"20","mask"
"1942",4,2,47,134,4696785,4699691,2906,"0","orth"
"1962",4,5,26,135,4706029,4708881,2852,"20","orth"
"1982",4,6,27,136,4715846,4718982,3136,"20","mask"
"2003",4,6,69,137,4725267,4727751,2484,"20","mask"
"2013",4,1,100,138,4730328,4732817,2489,"0","valid"
"1011",5,3,113,1,6012393,6015650,3257,"0","mask"
"1114",5,4,102,2,6018779,6024407,5628,"20","valid"
"1212",5,1,135,3,6028437,6031723,3286,"0","valid"
"1314",5,1,69,4,6035664,6038821,3157,"0","valid"
"1415",5,5,61,5,6042964,6047546,4582,"20","orth"
"1510",5,2,10,6,6052228,6057916,5688,"0","orth"
"1713",5,2,100,7,6065553,6070245,4692,"0","orth"
"1814",5,3,125,8,6076505,6081955,5450,"0","mask"
"1915",5,2,22,9,6087189,6090479,3290,"0","orth"
"212",5,5,7,10,6097423,6100061,2638,"20","orth"
"231",5,5,109,11,6108094,6113206,5112,"20","orth"
"244",5,3,53,12,6116201,6119394,3193,"0","mask"
"264",5,6,98,13,6127354,6130316,2962,"20","mask"
"273",5,2,28,14,6133536,6136798,3262,"0","orth"
"293",5,6,116,15,6142855,6149836,6981,"20","mask"
"303",5,6,44,16,6154198,6156653,2455,"20","mask"
"323",5,3,41,17,6164203,6169316,5113,"0","mask"
"342",5,4,60,18,6177747,6182652,4905,"20","valid"
"354",5,1,117,19,6187316,6191495,4179,"0","valid"
"362",5,4,72,20,6194439,6197821,3382,"20","valid"
"373",5,1,33,21,6203170,6207622,4452,"0","valid"
"393",5,6,128,22,6215231,6221717,6486,"20","mask"
"403",5,2,136,23,6226196,6232645,6449,"0","orth"
"413",5,4,108,24,6236071,6240515,4444,"20","valid"
"424",5,3,65,25,6244745,6249365,4620,"0","mask"
"432",5,5,127,26,6252318,6256057,3739,"20","orth"
"443",5,5,55,27,6261461,6264426,2965,"20","orth"
"451",5,6,8,28,6268085,6272922,4837,"20","mask"
"472",5,4,36,29,6282694,6289132,6438,"20","valid"
"492",5,4,66,30,6330982,6336241,5259,"20","valid"
"502",5,5,25,31,6339667,6343433,3766,"20","orth"
"523",5,2,16,32,6351655,6354953,3298,"0","orth"
"542",5,1,27,33,6363008,6367975,4967,"0","valid"
"562",5,5,43,34,6374287,6377702,3415,"20","orth"
"584",5,6,134,35,6386257,6388834,2577,"20","mask"
"594",5,1,87,36,6392280,6396074,3794,"0","valid"
"603",5,3,47,37,6399304,6401736,2432,"0","mask"
"624",5,2,76,38,6409169,6415018,5849,"0","orth"
"633",5,2,130,39,6419391,6423729,4338,"0","orth"
"643",5,2,58,40,6427407,6431312,3905,"0","orth"
"654",5,2,64,41,6434481,6439113,4632,"0","orth"
"663",5,5,97,42,6443374,6446997,3623,"20","orth"
"673",5,1,15,43,6452251,6455329,3078,"0","valid"
"693",5,3,89,44,6462938,6468093,5155,"0","mask"
"703",5,2,4,45,6471381,6477966,6585,"0","orth"
"724",5,4,24,46,6489542,6493409,3867,"20","valid"
"742",5,5,91,47,6499894,6502826,2932,"20","orth"
"753",5,6,110,48,6505921,6508682,2761,"20","mask"
"763",5,4,84,49,6511612,6516467,4855,"20","valid"
"773",5,6,26,50,6519663,6524092,4429,"20","mask"
"793",5,6,38,51,6533303,6536381,3078,"20","mask"
"813",5,6,86,52,6542871,6547849,4978,"20","mask"
"823",5,3,29,53,6551049,6554285,3236,"0","mask"
"844",5,2,106,54,6560918,6563230,2312,"0","orth"
"851",5,3,83,55,6571604,6578018,6414,"0","mask"
"864",5,3,11,56,6583149,6589649,6500,"0","mask"
"883",5,6,92,57,6597458,6603003,5545,"20","mask"
"892",5,5,85,58,6607087,6610668,3581,"20","orth"
"903",5,4,18,59,6615864,6618389,2525,"20","valid"
"922",5,2,88,60,6625074,6627973,2899,"0","orth"
"932",5,2,124,61,6631999,6635730,3731,"0","orth"
"943",5,6,56,62,6639457,6644207,4750,"20","mask"
"952",5,4,12,63,6648060,6650484,2424,"20","valid"
"973",5,6,50,64,6656786,6659456,2670,"20","mask"
"993",5,6,62,65,6668488,6670870,2382,"20","mask"
"1004",5,3,17,66,6731604,6736754,5150,"0","mask"
"1024",5,1,57,67,6752883,6755869,2986,"0","valid"
"1034",5,4,96,68,6758965,6761737,2772,"20","valid"
"1041",5,5,13,69,6764700,6768581,3881,"20","orth"
"1064",5,3,95,70,6774687,6778664,3977,"0","mask"
"1073",5,3,71,71,6782221,6784428,2207,"0","mask"
"1082",5,1,39,72,6787596,6791139,3543,"0","valid"
"1101",5,1,21,73,6799230,6801516,2286,"0","valid"
"1122",5,3,5,74,6807928,6812976,5048,"0","mask"
"1141",5,3,131,75,6820156,6827181,7025,"0","mask"
"1154",5,4,114,76,6831711,6837217,5506,"20","valid"
"1163",5,4,132,77,6841887,6844727,2840,"20","valid"
"1172",5,2,82,78,6848099,6851670,3571,"0","orth"
"1184",5,1,3,79,6859090,6865620,6530,"0","valid"
"1203",5,5,37,80,6880354,6883819,3465,"20","orth"
"1224",5,5,133,81,6891632,6894532,2900,"20","orth"
"1232",5,4,6,82,6897994,6902259,4265,"20","valid"
"1252",5,1,45,83,6908503,6912514,4011,"0","valid"
"1272",5,5,49,84,6922359,6926524,4165,"20","orth"
"1294",5,4,120,85,6934848,6934860,12,"20","valid"
"1302",5,6,74,86,6937926,6943971,6045,"20","mask"
"1315",5,1,63,87,6947359,6951374,4015,"0","valid"
"1324",5,1,129,88,6955773,6959998,4225,"0","valid"
"1333",5,5,1,89,6963244,6966643,3399,"20","orth"
"1354",5,3,77,90,6974642,6979205,4563,"0","mask"
"1361",5,1,99,91,6982565,6986352,3787,"0","valid"
"1373",5,5,31,92,6989968,6993532,3564,"20","orth"
"1392",5,3,137,93,7001964,7006968,5004,"0","mask"
"1404",5,6,122,94,7010345,7013402,3057,"20","mask"
"1416",5,5,67,95,7019930,7022574,2644,"20","orth"
"1423",5,1,81,96,7028339,7031877,3538,"0","valid"
"1433",5,2,70,97,7036413,7040829,4416,"0","orth"
"1443",5,3,107,98,7044349,7047661,3312,"0","mask"
"1452",5,6,14,99,7051671,7056350,4679,"20","mask"
"1473",5,1,111,100,7064493,7066938,2445,"0","valid"
"1483",5,4,30,101,7069893,7072562,2669,"20","valid"
"1503",5,4,48,102,7078951,7081155,2204,"20","valid"
"1523",5,5,79,103,7088066,7091119,3053,"20","orth"
"1532",5,4,54,104,7094305,7097542,3237,"20","valid"
"1553",5,5,121,105,7104038,7108457,4419,"20","orth"
"1563",5,6,80,106,7111981,7114822,2841,"20","mask"
"1573",5,6,68,107,7117833,7121381,3548,"20","mask"
"1582",5,3,23,108,7124477,7126949,2472,"0","mask"
"1604",5,2,94,109,7135383,7139699,4316,"0","orth"
"1612",5,1,9,110,7145609,7153821,8212,"0","valid"
"1634",5,4,42,111,7161812,7164989,3177,"20","valid"
"1653",5,6,104,112,7175065,7177742,2677,"20","mask"
"1661",5,6,20,113,7180863,7183408,2545,"20","mask"
"1684",5,2,112,114,7193446,7195524,2078,"0","orth"
"1694",5,3,35,115,7199865,7203236,3371,"0","mask"
"1714",5,5,73,116,7209874,7211951,2077,"20","orth"
"1724",5,5,19,117,7215090,7217636,2546,"20","orth"
"1743",5,6,2,118,7226003,7229052,3049,"20","mask"
"1764",5,1,75,119,7237005,7242315,5310,"0","valid"
"1772",5,3,119,120,7245986,7250124,4138,"0","mask"
"1783",5,3,101,121,7256302,7258954,2652,"0","mask"
"1793",5,4,90,122,7262386,7265504,3118,"20","valid"
"1802",5,2,46,123,7270859,7273402,2543,"0","orth"
"1822",5,5,103,124,7282166,7285364,3198,"20","orth"
"1833",5,2,52,125,7289197,7291736,2539,"0","orth"
"1853",5,1,51,126,7298370,7301607,3237,"0","valid"
"1872",5,2,118,127,7308324,7310951,2627,"0","orth"
"1882",5,2,34,128,7314174,7316967,2793,"0","orth"
"1902",5,1,105,129,7323174,7325836,2662,"0","valid"
"1916",5,4,78,130,7329018,7331047,2029,"20","valid"
"1923",5,1,123,131,7336776,7340284,3508,"0","valid"
"1932",5,6,32,132,7377750,7381356,3606,"20","mask"
"1952",5,5,115,133,7387435,7389959,2524,"20","orth"
"1963",5,4,126,134,7392945,7397025,4080,"20","valid"
"1973",5,2,40,135,7400462,7404834,4372,"0","orth"
"1991",5,4,138,136,7413831,7418864,5033,"20","valid"
"2004",5,3,59,137,7423083,7429278,6195,"0","mask"
"2014",5,1,93,138,7432584,7434729,2145,"0","valid"
"1012",6,3,94,1,8209418,8214795,5377,"0","mask"
"1115",6,1,104,2,8219681,8222699,3018,"0","valid"
"1213",6,6,61,3,8225871,8228710,2839,"20","mask"
"1316",6,4,65,4,8231743,8234848,3105,"20","valid"
"1417",6,3,46,5,8239073,8241679,2606,"0","mask"
"1613",6,5,132,6,8249003,8252761,3758,"20","orth"
"1715",6,3,124,7,8256067,8261005,4938,"0","mask"
"1815",6,4,17,8,8264477,8269282,4805,"20","valid"
"204",6,4,137,9,8275673,8280285,4612,"20","valid"
"213",6,6,73,10,8283377,8287489,4112,"20","mask"
"224",6,1,92,11,8291181,8294439,3258,"0","valid"
"232",6,5,84,12,8297532,8301983,4451,"20","orth"
"245",6,5,120,13,8305615,8309307,3692,"20","orth"
"251",6,4,77,14,8312459,8316038,3579,"20","valid"
"265",6,2,123,15,8319757,8323449,3692,"0","orth"
"274",6,3,34,16,8326688,8329966,3278,"0","mask"
"294",6,1,56,17,8336444,8341049,4605,"0","valid"
"304",6,5,78,18,8344481,8347353,2872,"20","orth"
"312",6,6,31,19,8350719,8355150,4431,"20","mask"
"334",6,2,75,20,8366213,8370658,4445,"0","orth"
"343",6,2,45,21,8373797,8377009,3212,"0","orth"
"363",6,6,49,22,8383000,8386126,3126,"20","mask"
"383",6,5,138,23,8392144,8397242,5098,"20","orth"
"394",6,3,118,24,8401293,8404912,3619,"0","mask"
"404",6,1,134,25,8408477,8411070,2593,"0","valid"
"414",6,4,29,26,8414022,8418001,3979,"20","valid"
"433",6,4,89,27,8424625,8429969,5344,"20","valid"
"444",6,2,15,28,8433322,8441692,8370,"0","orth"
"463",6,5,30,29,8447483,8452069,4586,"20","orth"
"484",6,2,57,30,8457893,8459925,2032,"0","orth"
"493",6,1,68,31,8464097,8466896,2799,"0","valid"
"503",6,2,51,32,8469815,8472414,2599,"0","orth"
"524",6,1,122,33,8478318,8481124,2806,"0","valid"
"533",6,2,69,34,8483930,8486329,2399,"0","orth"
"543",6,2,129,35,8489274,8491780,2506,"0","orth"
"554",6,1,62,36,8494813,8497858,3045,"0","valid"
"563",6,3,82,37,8501477,8504649,3172,"0","mask"
"572",6,4,47,38,8507694,8510240,2546,"20","valid"
"595",6,2,21,39,8516698,8519750,3052,"0","orth"
"613",6,4,131,40,8526174,8529613,3439,"20","valid"
"625",6,2,9,41,8532879,8535018,2139,"0","orth"
"644",6,5,24,42,8541609,8545501,3892,"20","orth"
"664",6,2,105,43,8552238,8554544,2306,"0","orth"
"674",6,5,12,44,8557903,8561735,3832,"20","orth"
"694",6,3,4,45,8568165,8570658,2493,"0","mask"
"713",6,3,106,46,8576976,8579041,2065,"0","mask"
"725",6,6,97,47,8582120,8586225,4105,"20","mask"
"732",6,4,41,48,8589045,8592757,3712,"20","valid"
"754",6,1,38,49,8598875,8600980,2105,"0","valid"
"774",6,4,11,50,8607171,8610777,3606,"20","valid"
"794",6,5,90,51,8618987,8623738,4751,"20","orth"
"803",6,1,8,52,8631236,8633681,2445,"0","valid"
"824",6,6,55,53,8640133,8643391,3258,"20","mask"
"832",6,2,63,54,8646776,8650395,3619,"0","orth"
"845",6,6,43,55,8653447,8656420,2973,"20","mask"
"865",6,1,2,56,8663870,8666463,2593,"0","valid"
"884",6,2,33,57,8672614,8675333,2719,"0","orth"
"904",6,3,40,58,8682917,8685129,2212,"0","mask"
"923",6,6,127,59,8692360,8695512,3152,"20","mask"
"933",6,3,10,60,8699011,8701436,2425,"0","mask"
"953",6,2,135,61,8707574,8711206,3632,"0","orth"
"962",6,5,54,62,8714458,8717477,3019,"20","orth"
"983",6,6,13,63,8724402,8727707,3305,"20","mask"
"1005",6,4,53,64,8733971,8738103,4132,"20","valid"
"1025",6,3,70,65,8744048,8746480,2432,"0","mask"
"1035",6,1,26,66,9004259,9007171,2912,"0","valid"
"1054",6,6,133,67,9015494,9018780,3286,"20","mask"
"1065",6,2,27,68,9021979,9024284,2305,"0","orth"
"1083",6,4,101,69,9029589,9032688,3099,"20","valid"
"1093",6,6,91,70,9035401,9038059,2658,"20","mask"
"1102",6,2,117,71,9041058,9043658,2600,"0","orth"
"1116",6,6,103,72,9046943,9050915,3972,"20","mask"
"1123",6,4,107,73,9054587,9057626,3039,"20","valid"
"1133",6,3,52,74,9060491,9063670,3179,"0","mask"
"1155",6,4,119,75,9070355,9073773,3418,"20","valid"
"1164",6,1,74,76,9077372,9080510,3138,"0","valid"
"1173",6,5,60,77,9083956,9088548,4592,"20","orth"
"1185",6,4,59,78,9091686,9097604,5918,"20","valid"
"1193",6,3,64,79,9100663,9103482,2819,"0","mask"
"1204",6,3,58,80,9106508,9109866,3358,"0","mask"
"1214",6,4,35,81,9112979,9116304,3325,"20","valid"
"1233",6,1,80,82,9122462,9125234,2772,"0","valid"
"1244",6,1,116,83,9128160,9130272,2112,"0","valid"
"1253",6,5,72,84,9133131,9135890,2759,"20","orth"
"1263",6,3,28,85,9139102,9141828,2726,"0","mask"
"1283",6,3,130,86,9148779,9152031,3252,"0","mask"
"1295",6,3,16,87,9155643,9157362,1719,"0","mask"
"1317",6,5,42,88,9162927,9166399,3472,"20","orth"
"1334",6,2,87,89,9172743,9175536,2793,"0","orth"
"1342",6,4,113,90,9179008,9182780,3772,"20","valid"
"1355",6,6,121,91,9186065,9188984,2919,"20","mask"
"1362",6,5,108,92,9191716,9195542,3826,"20","orth"
"1374",6,5,18,93,9198887,9201686,2799,"20","orth"
"1393",6,5,96,94,9207344,9210290,2946,"20","orth"
"1405",6,5,66,95,9213095,9216714,3619,"20","orth"
"1418",6,6,85,96,9220259,9225091,4832,"20","mask"
"1424",6,1,98,97,9228283,9231495,3212,"0","valid"
"1434",6,4,23,98,9234707,9237539,2832,"20","valid"
"1453",6,1,50,99,9244830,9246956,2126,"0","valid"
"1474",6,1,86,100,9252641,9257819,5178,"0","valid"
"1484",6,2,81,101,9261071,9263730,2659,"0","orth"
"1494",6,6,7,102,9266535,9269388,2853,"20","mask"
"1514",6,1,44,103,9278618,9281383,2765,"0","valid"
"1533",6,2,99,104,9288001,9291200,3199,"0","orth"
"1543",6,1,20,105,9295592,9298057,2465,"0","valid"
"1564",6,4,95,106,9307320,9310533,3213,"20","valid"
"1574",6,3,88,107,9314471,9317170,2699,"0","mask"
"1583",6,1,110,108,9320416,9322328,1912,"0","valid"
"1592",6,5,126,109,9325040,9327466,2426,"20","orth"
"1605",6,5,102,110,9330052,9332225,2173,"20","orth"
"1614",6,5,6,111,9335230,9337209,1979,"20","orth"
"1635",6,6,79,112,9344413,9347925,3512,"20","mask"
"1643",6,2,3,113,9351544,9357728,6184,"0","orth"
"1662",6,6,67,114,9365019,9368072,3053,"20","mask"
"1673",6,2,111,115,9371117,9373909,2792,"0","orth"
"1685",6,6,115,116,9376995,9379801,2806,"20","mask"
"1695",6,3,100,117,9383479,9385605,2126,"0","mask"
"1703",6,5,36,118,9389024,9391656,2632,"20","orth"
"1725",6,5,114,119,9397427,9401966,4539,"20","orth"
"1733",6,1,32,120,9405044,9408570,3526,"0","valid"
"1754",6,6,1,121,9415014,9417800,2786,"20","mask"
"1773",6,3,136,122,9424184,9427136,2952,"0","mask"
"1784",6,1,128,123,9430515,9433334,2819,"0","valid"
"1794",6,4,83,124,9436560,9440058,3498,"20","valid"
"1803",6,3,112,125,9443577,9445623,2046,"0","mask"
"1816",6,3,22,126,9448642,9450821,2179,"0","mask"
"1834",6,5,48,127,9457059,9459751,2692,"20","orth"
"1854",6,2,39,128,9465989,9468781,2792,"0","orth"
"1873",6,2,93,129,9474519,9477058,2539,"0","orth"
"1883",6,1,14,130,9480210,9482709,2499,"0","valid"
"1903",6,6,19,131,9489494,9492912,3418,"20","mask"
"1924",6,4,125,132,9500416,9503655,3239,"20","valid"
"1933",6,3,76,133,9506567,9510299,3732,"0","mask"
"1943",6,6,25,134,9513312,9517170,3858,"20","mask"
"1964",6,6,109,135,9524394,9527959,3565,"20","mask"
"1974",6,4,5,136,9531251,9534843,3592,"20","valid"
"1992",6,6,37,137,9540968,9544427,3459,"20","mask"
"2015",6,4,71,138,9551404,9553830,2426,"20","valid"
"1013",7,2,56,1,10052920,10056645,3725,"0","orth"
"1117",7,1,73,2,10060017,10063822,3805,"0","valid"
"1215",7,4,70,3,10067134,10070586,3452,"20","valid"
"1318",7,4,10,4,10074125,10077743,3618,"20","valid"
"1515",7,2,134,5,10087720,10092025,4305,"0","orth"
"1615",7,3,27,6,10095184,10099109,3925,"0","mask"
"1817",7,4,106,7,10105474,10109512,4038,"20","valid"
"1917",7,6,30,8,10112451,10115643,3192,"20","mask"
"214",7,2,116,9,10121561,10124340,2779,"0","orth"
"225",7,1,7,10,10127492,10130631,3139,"0","valid"
"246",7,3,117,11,10140900,10144392,3492,"0","mask"
"252",7,6,66,12,10147245,10150723,3478,"20","mask"
"266",7,3,135,13,10154162,10157647,3485,"0","mask"
"275",7,4,118,14,10162799,10166431,3632,"20","valid"
"283",7,3,81,15,10170150,10174828,4678,"0","mask"
"295",7,5,137,16,10178053,10182012,3959,"20","orth"
"305",7,1,49,17,10185077,10188696,3619,"0","valid"
"324",7,4,88,18,10196014,10199312,3298,"20","valid"
"335",7,2,104,19,10204211,10207476,3265,"0","orth"
"344",7,1,91,20,10210921,10214067,3146,"0","valid"
"355",7,3,69,21,10218125,10221457,3332,"0","mask"
"364",7,5,125,22,10224876,10227642,2766,"20","orth"
"374",7,4,82,23,10232553,10235839,3286,"20","valid"
"384",7,1,97,24,10239817,10242450,2633,"0","valid"
"395",7,5,77,25,10245942,10249234,3292,"20","orth"
"405",7,3,105,26,10254259,10256584,2325,"0","mask"
"415",7,4,46,27,10260070,10263722,3652,"20","valid"
"434",7,6,42,28,10270833,10273591,2758,"20","mask"
"452",7,4,76,29,10285007,10289872,4865,"20","valid"
"464",7,1,37,30,10293298,10296477,3179,"0","valid"
"485",7,4,22,31,10306493,10311298,4805,"20","valid"
"504",7,4,28,32,10317769,10321674,3905,"20","valid"
"525",7,3,129,33,10329484,10331930,2446,"0","mask"
"534",7,2,98,34,10336962,10340260,3298,"0","orth"
"544",7,3,57,35,10344005,10346918,2913,"0","mask"
"555",7,6,108,36,10349757,10352029,2272,"20","mask"
"564",7,4,94,37,10356328,10359133,2805,"20","valid"
"573",7,5,5,38,10363319,10367637,4318,"20","orth"
"596",7,5,17,39,10375248,10378493,3245,"20","orth"
"614",7,6,78,40,10384131,10387296,3165,"20","mask"
"626",7,2,92,41,10390862,10393134,2272,"0","orth"
"634",7,1,133,42,10396006,10398305,2299,"0","valid"
"645",7,1,43,43,10401105,10402831,1726,"0","valid"
"665",7,3,39,44,10409475,10413267,3792,"0","mask"
"683",7,5,29,45,10420378,10424509,4131,"20","orth"
"704",7,3,75,46,10433519,10437431,3912,"0","mask"
"714",7,3,87,47,10442936,10445535,2599,"0","mask"
"726",7,1,61,48,10448787,10453645,4858,"0","valid"
"733",7,5,101,49,10456971,10460743,3772,"20","orth"
"743",7,4,124,50,10463735,10467594,3859,"20","valid"
"755",7,5,119,51,10473565,10476084,2519,"20","orth"
"764",7,6,48,52,10481062,10483001,1939,"20","mask"
"783",7,6,36,53,10492191,10495643,3452,"20","mask"
"804",7,4,112,54,10548277,10551936,3659,"20","valid"
"814",7,5,71,55,10555015,10557534,2519,"20","orth"
"825",7,5,65,56,10561026,10563578,2552,"20","orth"
"833",7,4,58,57,10566437,10568863,2426,"20","valid"
"846",7,5,107,58,10575914,10578886,2972,"20","orth"
"852",7,3,21,59,10582858,10585330,2472,"0","mask"
"873",7,6,12,60,10596093,10599198,3105,"20","mask"
"893",7,2,50,61,10606503,10609068,2565,"0","orth"
"914",7,1,85,62,10616019,10619271,3252,"0","valid"
"924",7,2,80,63,10623356,10625249,1893,"0","orth"
"934",7,4,34,64,10628574,10631773,3199,"20","valid"
"954",7,3,45,65,10639770,10642809,3039,"0","mask"
"974",7,2,2,66,10684294,10686560,2266,"0","orth"
"994",7,4,130,67,10695483,10698816,3333,"20","valid"
"1006",7,1,109,68,10702188,10704493,2305,"0","valid"
"1014",7,2,128,69,10707445,10709738,2293,"0","orth"
"1026",7,5,53,70,10713756,10716535,2779,"20","orth"
"1042",7,2,74,71,10723326,10725845,2519,"0","orth"
"1055",7,6,18,72,10728777,10730916,2139,"20","mask"
"1074",7,6,120,73,10737261,10739167,1906,"20","mask"
"1084",7,6,138,74,10743572,10746991,3419,"20","mask"
"1094",7,6,72,75,10751276,10754101,2825,"20","mask"
"1103",7,2,20,76,10757760,10760159,2399,"0","orth"
"1124",7,2,44,77,10768016,10771482,3466,"0","orth"
"1142",7,6,6,78,10782578,10785817,3239,"20","mask"
"1165",7,4,136,79,10794713,10797412,2699,"20","valid"
"1174",7,1,103,80,10800691,10802930,2239,"0","valid"
"1186",7,4,64,81,10805803,10808968,3165,"20","valid"
"1194",7,3,51,82,10812053,10815019,2966,"0","mask"
"1216",7,1,25,83,10821230,10825082,3852,"0","valid"
"1234",7,1,31,84,10830833,10833972,3139,"0","valid"
"1254",7,1,79,85,10840343,10843475,3132,"0","valid"
"1264",7,2,26,86,10847201,10850633,3432,"0","orth"
"1284",7,5,35,87,10861369,10865634,4265,"20","orth"
"1303",7,4,40,88,10873451,10876223,2772,"20","valid"
"1325",7,4,100,89,10883974,10886773,2799,"20","valid"
"1335",7,3,93,90,10889932,10892337,2405,"0","mask"
"1343",7,6,24,91,10895996,10898635,2639,"20","mask"
"1363",7,1,13,92,10906812,10909964,3152,"0","valid"
"1383",7,2,62,93,10951476,10953675,2199,"0","orth"
"1394",7,1,115,94,10956987,10960106,3119,"0","valid"
"1406",7,6,132,95,10963671,10966217,2546,"20","mask"
"1419",7,4,16,96,10969609,10971608,1999,"20","valid"
"1435",7,6,84,97,10978166,10981191,3025,"20","mask"
"1444",7,5,59,98,10984964,10988455,3491,"20","orth"
"1454",7,3,63,99,10991881,10994313,2432,"0","mask"
"1464",7,3,9,100,10997845,11001078,3233,"0","mask"
"1485",7,2,86,101,11007508,11009467,1959,"0","orth"
"1495",7,4,4,102,11012347,11014259,1912,"20","valid"
"1516",7,2,8,103,11022203,11025581,3378,"0","orth"
"1534",7,5,11,104,11031553,11033412,1859,"20","orth"
"1554",7,6,54,105,11039837,11042942,3105,"20","mask"
"1575",7,5,41,106,11051039,11053804,2765,"20","orth"
"1593",7,6,60,107,11060342,11064041,3699,"20","mask"
"1606",7,6,96,108,11067086,11070385,3299,"20","mask"
"1616",7,3,33,109,11085473,11087439,1966,"0","mask"
"1636",7,1,1,110,11094776,11097455,2679,"0","valid"
"1654",7,1,19,111,11103706,11105699,1993,"0","valid"
"1674",7,2,32,112,11113249,11116189,2940,"0","orth"
"1696",7,5,83,113,11122772,11125472,2700,"20","orth"
"1704",7,6,126,114,11128330,11132149,3819,"20","mask"
"1716",7,3,15,115,11134948,11137694,2746,"0","mask"
"1734",7,5,89,116,11144631,11147810,3179,"20","orth"
"1744",7,4,52,117,11152921,11155960,3039,"20","valid"
"1765",7,6,102,118,11163998,11168063,4065,"20","mask"
"1774",7,5,23,119,11171208,11173314,2106,"20","orth"
"1795",7,3,111,120,11184463,11186482,2019,"0","mask"
"1804",7,2,68,121,11190594,11192741,2147,"0","orth"
"1818",7,3,3,122,11196139,11198412,2273,"0","mask"
"1835",7,2,14,123,11205782,11207914,2132,"0","orth"
"1855",7,5,47,124,11214445,11217198,2753,"20","orth"
"1874",7,1,55,125,11224282,11226614,2332,"0","valid"
"1884",7,2,122,126,11229240,11231639,2399,"0","orth"
"1894",7,5,95,127,11234838,11237870,3032,"20","orth"
"1904",7,5,131,128,11241096,11244148,3052,"20","orth"
"1918",7,6,90,129,11246927,11249746,2819,"20","mask"
"1925",7,1,67,130,11252352,11254197,1845,"0","valid"
"1934",7,2,38,131,11257956,11260249,2293,"0","orth"
"1953",7,2,110,132,11266420,11269359,2939,"0","orth"
"1965",7,1,121,133,11272611,11274570,1959,"0","valid"
"1975",7,1,127,134,11277356,11279721,2365,"0","valid"
"1983",7,5,113,135,11282674,11285413,2739,"20","orth"
"1993",7,3,123,136,11289638,11292317,2679,"0","mask"
"2005",7,6,114,137,11296162,11301000,4838,"20","mask"
"2016",7,3,99,138,11304026,11306218,2192,"0","mask"
"1015",8,3,104,1,2968777,2971549,2772,"0","mask"
"1118",8,2,67,2,2974655,2977260,2605,"0","orth"
"1217",8,6,59,3,2980706,2984631,3925,"20","mask"
"1319",8,4,39,4,2987737,2990576,2839,"20","valid"
"1517",8,6,23,5,2996001,2998619,2618,"20","mask"
"1717",8,5,64,6,3004897,3008289,3392,"20","orth"
"1819",8,6,83,7,3011834,3015267,3433,"20","mask"
"1919",8,4,9,8,3018612,3021804,3192,"20","valid"
"215",8,2,19,9,3028055,3031207,3152,"0","orth"
"233",8,4,129,10,3038371,3041763,3392,"20","valid"
"247",8,6,113,11,3044656,3047495,2839,"20","mask"
"253",8,3,98,12,3050400,3054279,3879,"0","mask"
"267",8,5,124,13,3057098,3060070,2972,"20","orth"
"276",8,4,45,14,3062889,3065368,2479,"20","valid"
"296",8,5,4,15,3070833,3073652,2819,"20","orth"
"313",8,2,7,16,3078936,3081522,2586,"0","orth"
"336",8,4,27,17,3088273,3091079,2806,"20","valid"
"356",8,4,3,18,3096923,3100502,3579,"20","valid"
"375",8,2,13,19,3106420,3109745,3325,"0","orth"
"396",8,5,34,20,3115343,3118589,3246,"20","orth"
"416",8,1,114,21,3126819,3129458,2639,"0","valid"
"425",8,6,35,22,3132304,3135322,3018,"20","mask"
"445",8,3,44,23,3141840,3143999,2159,"0","mask"
"465",8,3,38,24,3150057,3152482,2425,"0","mask"
"486",8,1,48,25,3158347,3161272,2925,"0","valid"
"505",8,1,96,26,3167857,3170022,2165,"0","valid"
"513",8,3,62,27,3173128,3176220,3092,"0","mask"
"526",8,4,81,28,3179159,3182245,3086,"20","valid"
"535",8,3,122,29,3185284,3187136,1852,"0","mask"
"545",8,6,89,30,3189929,3192554,2625,"20","mask"
"556",8,1,12,31,3195960,3198139,2179,"0","valid"
"574",8,5,94,32,3204390,3207049,2659,"20","orth"
"585",8,3,32,33,3210168,3212807,2639,"0","mask"
"604",8,4,75,34,3219158,3222117,2959,"20","valid"
"615",8,4,93,35,3224936,3227528,2592,"20","valid"
"627",8,2,127,36,3230694,3233059,2365,"0","orth"
"635",8,1,66,37,3235652,3238231,2579,"0","valid"
"646",8,2,109,38,3241416,3244735,3319,"0","orth"
"655",8,3,8,39,3248254,3250153,1899,"0","mask"
"675",8,5,46,40,3256857,3260223,3366,"20","orth"
"695",8,5,82,41,3267147,3269606,2459,"20","orth"
"705",8,5,70,42,3272585,3275657,3072,"20","orth"
"715",8,1,84,43,3278549,3281775,3226,"0","valid"
"727",8,6,53,44,3285333,3288312,2979,"20","mask"
"744",8,4,63,45,3293997,3296269,2272,"20","valid"
"756",8,1,138,46,3299115,3302387,3272,"0","valid"
"765",8,5,40,47,3305513,3308638,3125,"20","orth"
"784",8,5,76,48,3315575,3318495,2920,"20","orth"
"795",8,1,72,49,3321453,3323126,1673,"0","valid"
"805",8,4,135,50,3326345,3329144,2799,"20","valid"
"815",8,2,61,51,3332063,3334462,2399,"0","orth"
"826",8,4,105,52,3337194,3340466,3272,"20","valid"
"834",8,1,36,53,3343498,3345464,1966,"0","valid"
"853",8,3,80,54,3353275,3356301,3026,"0","mask"
"866",8,5,100,55,3359366,3364404,5038,"20","orth"
"874",8,6,101,56,3367196,3370389,3193,"20","mask"
"885",8,1,60,57,3373814,3376726,2912,"0","valid"
"894",8,2,133,58,3379766,3382738,2972,"0","orth"
"905",8,2,73,59,3386156,3388382,2226,"0","orth"
"915",8,6,65,60,3391681,3394406,2725,"20","mask"
"925",8,3,116,61,3397472,3399784,2312,"0","mask"
"935",8,5,88,62,3403663,3406375,2712,"20","orth"
"944",8,2,31,63,3409294,3411453,2159,"0","orth"
"963",8,2,49,64,3417205,3419430,2225,"0","orth"
"984",8,2,121,65,3424795,3426688,1893,"0","orth"
"995",8,3,56,66,3486359,3488971,2612,"0","mask"
"1007",8,3,2,67,3492177,3496502,4325,"0","mask"
"1027",8,4,123,68,3504319,3506985,2666,"20","valid"
"1036",8,6,77,69,3509937,3513509,3572,"20","mask"
"1043",8,4,57,70,3516528,3518780,2252,"20","valid"
"1056",8,2,115,71,3521766,3524572,2806,"0","orth"
"1066",8,4,15,72,3527464,3531103,3639,"20","valid"
"1085",8,5,130,73,3537114,3541332,4218,"20","orth"
"1095",8,4,21,74,3544285,3546410,2125,"20","valid"
"1119",8,5,112,75,3553701,3555933,2232,"20","orth"
"1125",8,1,24,76,3558826,3561405,2579,"0","valid"
"1143",8,4,111,77,3569515,3572347,2832,"20","valid"
"1156",8,2,25,78,3575726,3577698,1972,"0","orth"
"1175",8,1,90,79,3583217,3585156,1939,"0","valid"
"1187",8,6,131,80,3588635,3591100,2465,"20","mask"
"1195",8,3,92,81,3594026,3597152,3126,"0","mask"
"1205",8,2,43,82,3599944,3602996,3052,"0","orth"
"1225",8,1,30,83,3608887,3611599,2712,"0","valid"
"1245",8,5,16,84,3617357,3619923,2566,"20","orth"
"1265",8,6,47,85,3626154,3628493,2339,"20","mask"
"1285",8,5,28,86,3634691,3637250,2559,"20","orth"
"1304",8,1,132,87,3643354,3646161,2807,"0","valid"
"13110",8,3,110,88,3648926,3651691,2765,"0","mask"
"1326",8,2,1,89,3654597,3656849,2252,"0","orth"
"1344",8,2,55,90,3663327,3665753,2426,"0","orth"
"1356",8,5,58,91,3668598,3670917,2319,"20","orth"
"1364",8,4,51,92,3673723,3676089,2366,"20","valid"
"1384",8,3,26,93,3681760,3683899,2139,"0","mask"
"1407",8,6,71,94,3690537,3693016,2479,"20","mask"
"14110",8,6,29,95,3695848,3698541,2693,"20","mask"
"1436",8,3,50,96,3704665,3706844,2179,"0","mask"
"1455",8,1,78,97,3713055,3715061,2006,"0","valid"
"1465",8,1,18,98,3717667,3720353,2686,"0","valid"
"1486",8,6,125,99,3725831,3728363,2532,"20","mask"
"1496",8,1,102,100,3731155,3733514,2359,"0","valid"
"1504",8,6,41,101,3736333,3739199,2866,"20","mask"
"1524",8,5,10,102,3745064,3748036,2972,"20","orth"
"1544",8,5,52,103,3753680,3756219,2539,"20","orth"
"1565",8,6,119,104,3762377,3765796,3419,"20","mask"
"1576",8,2,91,105,3769161,3771647,2486,"0","orth"
"1584",8,1,126,106,3774586,3776592,2006,"0","valid"
"1594",8,2,37,107,3779378,3781423,2045,"0","orth"
"1617",8,6,95,108,3788254,3790560,2306,"20","mask"
"1624",8,4,69,109,3793705,3795991,2286,"20","valid"
"1637",8,4,117,110,3798930,3801202,2272,"20","valid"
"1644",8,6,137,111,3804022,3806361,2339,"20","mask"
"1655",8,6,17,112,3809386,3813285,3899,"20","mask"
"1675",8,1,42,113,3819609,3822288,2679,"0","valid"
"1697",8,2,85,114,3828353,3830865,2512,"0","orth"
"1705",8,3,68,115,3833911,3835810,1899,"0","mask"
"1718",8,6,11,116,3838842,3840748,1906,"20","mask"
"1735",8,1,54,117,3847525,3849391,1866,"0","valid"
"1755",8,6,5,118,3855349,3857488,2139,"20","mask"
"1775",8,4,87,119,3863227,3866392,3165,"20","valid"
"1785",8,3,14,120,3869524,3871736,2212,"0","mask"
"1805",8,3,20,121,3877854,3880067,2213,"0","mask"
"1823",8,4,33,122,3887038,3889023,1985,"20","valid"
"1843",8,1,120,123,3894775,3897187,2412,"0","valid"
"1856",8,1,108,124,3900353,3902052,1699,"0","valid"
"1864",8,4,99,125,3906044,3908397,2353,"20","valid"
"1875",8,2,103,126,3911395,3912961,1566,"0","orth"
"1885",8,5,118,127,3915940,3917793,1853,"20","orth"
"1895",8,5,22,128,3920592,3922651,2059,"20","orth"
"19110",8,3,86,129,3930368,3932121,1753,"0","mask"
"1926",8,6,107,130,3935160,3936866,1706,"20","mask"
"1935",8,5,106,131,3939651,3941797,2146,"20","orth"
"1944",8,1,6,132,3944676,3947175,2499,"0","valid"
"1966",8,2,97,133,3954019,3955672,1653,"0","orth"
"1976",8,3,134,134,3958745,3961297,2552,"0","mask"
"1984",8,2,79,135,3964809,3966908,2099,"0","orth"
"1994",8,5,136,136,3970093,3972273,2180,"20","orth"
"2006",8,3,128,137,3975205,3978077,2872,"0","mask"
"2017",8,3,74,138,3980816,3983129,2313,"0","mask"
"1016",9,4,128,1,5686566,5692097,5531,"20","valid"
"1120",9,3,109,2,5695649,5700028,4379,"0","mask"
"1218",9,3,7,3,5705519,5710144,4625,"0","mask"
"1420",9,3,121,4,5716681,5720867,4186,"0","mask"
"1518",9,3,115,5,5724239,5731023,6784,"0","mask"
"1618",9,6,94,6,5734235,5738240,4005,"20","mask"
"1719",9,1,53,7,5743625,5748103,4478,"0","valid"
"1920",9,2,18,8,5754501,5757233,2732,"0","orth"
"216",9,3,61,9,5763311,5766577,3266,"0","mask"
"226",9,6,124,10,5770775,5773940,3165,"20","mask"
"234",9,6,70,11,5777426,5782784,5358,"20","mask"
"248",9,6,106,12,5785709,5790881,5172,"20","mask"
"254",9,6,46,13,5794406,5798378,3972,"20","mask"
"277",9,4,32,14,5807008,5811053,4045,"20","valid"
"297",9,1,107,15,5817364,5819937,2573,"0","valid"
"306",9,3,55,16,5822709,5826548,3839,"0","mask"
"314",9,4,116,17,5830086,5833272,3186,"20","valid"
"325",9,3,133,18,5837044,5840076,3032,"0","mask"
"337",9,5,99,19,5843442,5846640,3198,"20","orth"
"345",9,1,137,20,5849606,5852811,3205,"0","valid"
"357",9,5,81,21,5856003,5860068,4065,"20","orth"
"365",9,2,66,22,5863641,5866253,2612,"0","orth"
"376",9,1,11,23,5869885,5872351,2466,"0","valid"
"397",9,3,37,24,5878475,5883073,4598,"0","mask"
"417",9,5,111,25,5889238,5893010,3772,"20","orth"
"426",9,1,35,26,5896369,5899940,3571,"0","valid"
"446",9,6,136,27,5906944,5910117,3173,"20","mask"
"453",9,4,92,28,5913316,5917194,3878,"20","valid"
"466",9,2,6,29,5920193,5922679,2486,"0","orth"
"487",9,5,129,30,5929056,5931715,2659,"20","orth"
"494",9,2,120,31,5934721,5939859,5138,"0","orth"
"506",9,4,110,32,5942878,5945090,2212,"20","valid"
"514",9,4,134,33,5948189,5950775,2586,"20","valid"
"527",9,4,44,34,5953774,5957146,3372,"20","valid"
"546",9,6,118,35,5964063,5967702,3639,"20","mask"
"557",9,2,54,36,5971134,5974733,3599,"0","orth"
"575",9,6,34,37,5982657,5986862,4205,"20","mask"
"597",9,4,86,38,5994872,5998591,3719,"20","valid"
"605",9,3,79,39,6003276,6005821,2545,"0","mask"
"616",9,5,135,40,6009380,6013418,4038,"20","orth"
"628",9,5,87,41,6017224,6021875,4651,"20","orth"
"636",9,1,77,42,6025048,6029253,4205,"0","valid"
"647",9,2,90,43,6032845,6035170,2325,"0","orth"
"656",9,4,56,44,6038409,6043041,4632,"20","valid"
"666",9,4,80,45,6046726,6052691,5965,"20","valid"
"676",9,5,69,46,6055750,6060688,4938,"20","orth"
"684",9,2,114,47,6064799,6067445,2646,"0","orth"
"696",9,2,84,48,6071457,6074196,2739,"0","orth"
"706",9,2,132,49,6077642,6080674,3032,"0","orth"
"716",9,5,21,50,6083907,6086405,2498,"20","orth"
"734",9,6,40,51,6093023,6096021,2998,"20","mask"
"757",9,2,78,52,6103665,6107677,4012,"0","orth"
"766",9,1,17,53,6110716,6112742,2026,"0","valid"
"785",9,2,138,54,6118886,6120925,2039,"0","orth"
"796",9,3,25,55,6124557,6128096,3539,"0","mask"
"816",9,4,74,56,6134181,6136873,2692,"20","valid"
"827",9,4,98,57,6139619,6144903,5284,"20","valid"
"835",9,6,16,58,6148036,6151474,3438,"20","mask"
"854",9,1,5,59,6158192,6161644,3452,"0","valid"
"875",9,2,102,60,6168301,6175025,6724,"0","orth"
"886",9,3,43,61,6178304,6181670,3366,"0","mask"
"906",9,3,19,62,6188934,6191173,2239,"0","mask"
"926",9,1,71,63,6198257,6199983,1726,"0","valid"
"936",9,6,76,64,6202922,6207194,4272,"20","mask"
"945",9,6,10,65,6210326,6214537,4211,"20","mask"
"964",9,2,30,66,6260701,6263313,2612,"0","orth"
"985",9,3,49,67,6269684,6272456,2772,"0","mask"
"1008",9,4,26,68,6278221,6281306,3085,"20","valid"
"1028",9,2,60,69,6287157,6289456,2299,"0","orth"
"1037",9,3,13,70,6292442,6295868,3426,"0","mask"
"1057",9,4,2,71,6302398,6306017,3619,"20","valid"
"1075",9,1,29,72,6312941,6315127,2186,"0","valid"
"1096",9,5,123,73,6320791,6324903,4112,"20","orth"
"1104",9,5,3,74,6328015,6331474,3459,"20","orth"
"1126",9,3,103,75,6337072,6340718,3646,"0","mask"
"1134",9,5,117,76,6343890,6347222,3332,"20","orth"
"1144",9,3,73,77,6351027,6353200,2173,"0","mask"
"1157",9,2,108,78,6356278,6358344,2066,"0","orth"
"1166",9,6,64,79,6361190,6363616,2426,"20","mask"
"1176",9,5,93,80,6366455,6368434,1979,"20","orth"
"1188",9,2,36,81,6371193,6372712,1519,"0","orth"
"1206",9,1,23,82,6378324,6380276,1952,"0","valid"
"1226",9,5,105,83,6385767,6387893,2126,"20","orth"
"1235",9,5,75,84,6390652,6394518,3866,"20","orth"
"1246",9,1,83,85,6397783,6401662,3879,"0","valid"
"1255",9,3,1,86,6404474,6409132,4658,"0","mask"
"1273",9,6,82,87,6415523,6418509,2986,"20","mask"
"1286",9,6,112,88,6421241,6423733,2492,"20","mask"
"1296",9,2,48,89,6426346,6430071,3725,"0","orth"
"13111",9,2,12,90,6437122,6445579,8457,"0","orth"
"1336",9,1,89,91,6452064,6463632,11568,"0","valid"
"1345",9,2,96,92,6466884,6471229,4345,"0","orth"
"1357",9,1,95,93,6474281,6479133,4852,"0","valid"
"1365",9,4,38,94,6481812,6485611,3799,"20","valid"
"1385",9,6,58,95,6491522,6494347,2825,"20","mask"
"1395",9,6,22,96,6497540,6500925,3385,"20","mask"
"14111",9,1,41,97,6506983,6510028,3045,"0","valid"
"1437",9,4,50,98,6515693,6521191,5498,"20","valid"
"1456",9,6,100,99,6531147,6534133,2986,"20","mask"
"1466",9,1,125,100,6537858,6540011,2153,"0","valid"
"1475",9,6,28,101,6543016,6545808,2792,"20","mask"
"1497",9,3,85,102,6554365,6557051,2686,"0","mask"
"1505",9,3,31,103,6560310,6563849,3539,"0","mask"
"1525",9,1,131,104,6572445,6575064,2619,"0","valid"
"1535",9,3,97,105,6578056,6582448,4392,"0","mask"
"1545",9,4,14,106,6585687,6591231,5544,"20","valid"
"1566",9,2,126,107,6598749,6601661,2912,"0","orth"
"1577",9,4,20,108,6604500,6607219,2719,"20","valid"
"1595",9,4,62,109,6614303,6616695,2392,"20","valid"
"1607",9,3,91,110,6619648,6622627,2979,"0","mask"
"1619",9,4,8,111,6625786,6628078,2292,"20","valid"
"1638",9,2,72,112,6633656,6635715,2059,"0","orth"
"1645",9,5,51,113,6639427,6642339,2912,"20","orth"
"1663",9,1,101,114,6647765,6650003,2238,"0","valid"
"1676",9,4,68,115,6653069,6657207,4138,"20","valid"
"1686",9,1,59,116,6660519,6664851,4332,"0","valid"
"1698",9,3,67,117,6668243,6671935,3692,"0","mask"
"1706",9,6,52,118,6674587,6678413,3826,"20","mask"
"1726",9,6,4,119,6685344,6689615,4271,"20","mask"
"1745",9,5,45,120,6694580,6698072,3492,"20","orth"
"1766",9,3,127,121,6704243,6706895,2652,"0","mask"
"1776",9,5,39,122,6709728,6715532,5804,"20","orth"
"1796",9,1,65,123,6722270,6725709,3439,"0","valid"
"1806",9,6,88,124,6728661,6735218,6557,"20","mask"
"18110",9,4,104,125,6738657,6742196,3539,"20","valid"
"1824",9,2,24,126,6756117,6761668,5551,"0","orth"
"1844",9,4,122,127,6770119,6774137,4018,"20","valid"
"1857",9,5,9,128,6777256,6780075,2819,"20","orth"
"1876",9,1,119,129,6786759,6792124,5365,"0","valid"
"1886",9,5,33,130,6795136,6800421,5285,"20","orth"
"1905",9,6,130,131,6807865,6810890,3025,"20","mask"
"19111",9,1,113,132,6813663,6817361,3698,"0","valid"
"1927",9,5,57,133,6820520,6823972,3452,"20","orth"
"1936",9,5,15,134,6826851,6829610,2759,"20","orth"
"1954",9,2,42,135,6837227,6841306,4079,"0","orth"
"1977",9,5,27,136,6847750,6852455,4705,"20","orth"
"1995",9,1,47,137,6858233,6860219,1986,"0","valid"
"2018",9,5,63,138,6866617,6870715,4098,"20","orth"
"1017",10,2,11,1,8031732,8034085,2353,"0","orth"
"1219",10,3,120,2,8040982,8047473,6491,"0","mask"
"1320",10,2,53,3,8050718,8054044,3326,"0","orth"
"1519",10,1,58,4,8059802,8062147,2345,"0","valid"
"1620",10,5,74,5,8065200,8069038,3838,"20","orth"
"1720",10,2,83,6,8072264,8077129,4865,"0","orth"
"1820",10,2,5,7,8080821,8086818,5997,"0","orth"
"205",10,5,14,8,8094169,8098307,4138,"20","orth"
"227",10,5,20,9,8105618,8110690,5072,"20","orth"
"249",10,6,63,10,8118487,8121979,3492,"20","mask"
"255",10,1,76,11,8124964,8129836,4872,"0","valid"
"268",10,4,91,12,8132728,8136633,3905,"20","valid"
"278",10,4,97,13,8139806,8142271,2465,"20","valid"
"284",10,3,72,14,8145283,8147923,2640,"0","mask"
"298",10,6,69,15,8151628,8154240,2612,"20","mask"
"307",10,1,16,16,8157379,8164003,6624,"0","valid"
"326",10,2,113,17,8169468,8175466,5998,"0","orth"
"338",10,3,132,18,8178478,8182683,4205,"0","mask"
"346",10,4,49,19,8186002,8191846,5844,"20","valid"
"366",10,2,17,20,8198104,8204162,6058,"0","orth"
"385",10,3,66,21,8210753,8213405,2652,"0","mask"
"398",10,1,64,22,8218870,8218983,113,"0","valid"
"406",10,1,106,23,8222435,8225574,3139,"0","valid"
"418",10,2,89,24,8228793,8234497,5704,"0","orth"
"427",10,6,99,25,8237909,8241062,3153,"20","mask"
"435",10,3,84,26,8244267,8248578,4311,"0","mask"
"447",10,2,125,27,8251771,8256602,4831,"0","orth"
"454",10,4,1,28,8260994,8263826,2832,"20","valid"
"473",10,5,8,29,8269264,8271917,2653,"20","orth"
"495",10,4,7,30,8278001,8280660,2659,"20","valid"
"515",10,1,82,31,8287085,8290530,3445,"0","valid"
"528",10,4,55,32,8298560,8302179,3619,"20","valid"
"536",10,2,41,33,8305231,8307090,1859,"0","orth"
"558",10,2,29,34,8312628,8318553,5925,"0","orth"
"576",10,6,33,35,8327470,8331201,3731,"20","mask"
"598",10,4,103,36,8336979,8340538,3559,"20","valid"
"606",10,3,108,37,8343770,8346496,2726,"0","mask"
"617",10,6,135,38,8349788,8352953,3165,"20","mask"
"629",10,6,117,39,8356212,8357951,1739,"20","mask"
"637",10,6,15,40,8361310,8362969,1659,"20","mask"
"657",10,1,136,41,8368474,8371120,2646,"0","valid"
"667",10,2,35,42,8374852,8378370,3518,"0","orth"
"685",10,2,71,43,8384588,8386967,2379,"0","orth"
"697",10,4,25,44,8389920,8392965,3045,"20","valid"
"717",10,1,94,45,8398550,8404861,6311,"0","valid"
"728",10,5,44,46,8408399,8411192,2793,"20","orth"
"745",10,1,112,47,8416517,8425560,9043,"0","valid"
"758",10,2,137,48,8429145,8431698,2553,"0","orth"
"767",10,6,3,49,8434690,8439048,4358,"20","mask"
"786",10,5,68,50,8446053,8448558,2505,"20","orth"
"797",10,6,57,51,8451737,8454429,2692,"20","mask"
"806",10,1,70,52,8457615,8460394,2779,"0","valid"
"817",10,4,31,53,8463479,8467784,4305,"20","valid"
"836",10,1,28,54,8473562,8476461,2899,"0","valid"
"855",10,3,12,55,8482672,8485325,2653,"0","mask"
"876",10,6,75,56,8492109,8495487,3378,"20","mask"
"887",10,6,39,57,8498373,8502611,4238,"20","mask"
"907",10,2,47,58,8509016,8511315,2299,"0","orth"
"927",10,6,105,59,8519066,8523390,4324,"20","mask"
"937",10,1,46,60,8526876,8535546,8670,"0","valid"
"955",10,4,115,61,8542150,8544982,2832,"20","valid"
"965",10,5,26,62,8547875,8549874,1999,"20","orth"
"986",10,3,36,63,8556685,8563042,6357,"0","mask"
"1009",10,6,111,64,8570007,8574118,4111,"20","mask"
"1018",10,5,92,65,8577304,8581862,4558,"20","orth"
"1029",10,5,80,66,8708775,8711714,2939,"20","orth"
"1038",10,2,131,67,8714853,8717538,2685,"0","orth"
"1044",10,2,23,68,8720251,8722550,2299,"0","orth"
"1067",10,4,85,69,8727928,8731627,3699,"20","valid"
"1076",10,5,104,70,8734739,8738118,3379,"20","orth"
"1086",10,6,21,71,8741277,8745581,4304,"20","mask"
"1105",10,1,22,72,8752532,8755631,3099,"0","valid"
"1127",10,5,122,73,8764382,8766220,1838,"20","orth"
"1135",10,5,98,74,8769473,8772532,3059,"20","orth"
"1145",10,5,86,75,8775731,8778223,2492,"20","orth"
"1158",10,3,30,76,8781175,8783347,2172,"0","mask"
"1177",10,2,101,77,8788792,8791625,2833,"0","orth"
"1189",10,4,19,78,8794870,8797662,2792,"20","valid"
"1207",10,4,109,79,8805386,8809191,3805,"20","valid"
"12110",10,2,119,80,8813110,8818228,5118,"0","orth"
"1227",10,3,48,81,8821300,8822800,1500,"0","mask"
"1247",10,3,54,82,8830744,8833402,2658,"0","mask"
"1266",10,2,107,83,8839481,8843092,3611,"0","orth"
"1274",10,3,78,84,8846024,8849703,3679,"0","mask"
"1287",10,3,102,85,8852755,8855981,3226,"0","mask"
"1297",10,3,18,86,8859160,8862125,2965,"0","mask"
"13112",10,5,38,87,8869176,8872308,3132,"20","orth"
"1337",10,4,61,88,8877633,8879932,2299,"20","valid"
"1346",10,1,4,89,8882964,8885263,2299,"0","valid"
"1366",10,3,6,90,8891361,8895639,4278,"0","mask"
"1386",10,2,95,91,8903017,8907455,4438,"0","orth"
"1396",10,3,114,92,8911167,8915979,4812,"0","mask"
"1408",10,6,27,93,8919144,8921450,2306,"20","mask"
"1425",10,2,59,94,8927414,8929420,2006,"0","orth"
"1438",10,4,13,95,8932559,8934898,2339,"20","valid"
"1457",10,1,118,96,8939796,8942789,2993,"0","valid"
"1467",10,4,67,97,8945994,8947867,1873,"20","valid"
"1476",10,4,37,98,8950772,8953818,3046,"20","valid"
"1498",10,6,123,99,8960336,8964800,4464,"20","mask"
"1506",10,1,124,100,8968472,8970058,1586,"0","valid"
"15110",10,5,116,101,8972671,8975716,3045,"20","orth"
"1526",10,1,100,102,8978822,8982947,4125,"0","valid"
"1536",10,4,121,103,8986212,8988818,2606,"20","valid"
"1546",10,4,133,104,8991984,8994576,2592,"20","valid"
"1555",10,1,10,105,8997808,8999974,2166,"0","valid"
"1578",10,5,56,106,9006058,9008651,2593,"20","orth"
"1585",10,3,138,107,9011223,9012996,1773,"0","mask"
"1596",10,1,130,108,9016321,9018927,2606,"0","valid"
"1608",10,5,62,109,9022372,9025145,2773,"20","orth"
"16110",10,3,24,110,9028670,9032202,3532,"0","mask"
"1639",10,4,43,111,9038873,9041505,2632,"20","valid"
"1656",10,6,45,112,9047597,9052774,5177,"20","mask"
"1677",10,3,90,113,9058559,9061598,3039,"0","mask"
"1687",10,2,65,114,9064764,9067836,3072,"0","orth"
"1699",10,4,127,115,9070642,9073120,2478,"20","valid"
"1707",10,6,87,116,9080971,9083896,2925,"20","mask"
"17110",10,5,134,117,9087009,9093813,6804,"20","orth"
"1727",10,1,52,118,9097018,9100690,3672,"0","valid"
"1746",10,5,2,119,9108014,9111073,3059,"20","orth"
"1767",10,1,88,120,9118990,9121783,2793,"0","valid"
"1777",10,6,9,121,9124915,9128320,3405,"20","mask"
"1797",10,5,32,122,9135977,9139796,3819,"20","orth"
"18111",10,4,73,123,9145940,9148039,2099,"20","valid"
"1825",10,4,79,124,9151185,9154890,3705,"20","valid"
"1836",10,2,77,125,9158222,9160748,2526,"0","orth"
"1845",10,1,40,126,9163927,9167432,3505,"0","valid"
"1865",10,3,60,127,9173323,9177808,4485,"0","mask"
"1877",10,3,96,128,9181127,9186119,4992,"0","mask"
"1887",10,5,128,129,9189684,9194195,4511,"20","orth"
"1896",10,6,129,130,9197448,9200467,3019,"20","mask"
"1906",10,3,42,131,9203565,9205611,2046,"0","mask"
"1928",10,5,50,132,9213242,9218300,5058,"20","orth"
"1945",10,5,110,133,9223911,9226597,2686,"20","orth"
"1955",10,3,126,134,9229582,9233674,4092,"0","mask"
"1967",10,1,34,135,9236906,9239012,2106,"0","valid"
"1985",10,6,93,136,9245223,9247489,2266,"20","mask"
"1996",10,6,81,137,9250642,9256859,6217,"20","mask"
"2007",10,6,51,138,9260298,9263636,3338,"20","mask"
"1019",11,1,75,1,17499641,17505479,5838,"0","valid"
"1128",11,4,120,2,17508818,17515255,6437,"20","valid"
"1220",11,1,93,3,17518914,17524625,5711,"0","valid"
"1327",11,2,136,4,17527671,17533335,5664,"0","orth"
"1426",11,6,134,5,17538167,17545224,7057,"20","mask"
"1520",11,4,54,6,17550676,17554667,3991,"20","valid"
"1728",11,1,81,7,17566877,17572981,6104,"0","valid"
"1826",11,4,84,8,17576746,17582177,5431,"20","valid"
"1929",11,4,48,9,17585170,17589568,4398,"20","valid"
"217",11,6,98,10,17597965,17602710,4745,"20","mask"
"228",11,1,45,11,17606382,17611047,4665,"0","valid"
"2410",11,4,72,12,17617445,17621483,4038,"20","valid"
"256",11,5,85,13,17624802,17629833,5031,"20","orth"
"269",11,1,27,14,17635678,17640736,5058,"0","valid"
"285",11,1,21,15,17647600,17652751,5151,"0","valid"
"308",11,2,34,16,17659116,17663840,4724,"0","orth"
"327",11,1,87,17,17672824,17678622,5798,"0","valid"
"339",11,5,1,18,17682141,17686152,4011,"20","orth"
"358",11,1,105,19,17691890,17695849,3959,"0","valid"
"367",11,6,14,20,17699541,17705285,5744,"20","mask"
"386",11,2,130,21,17711689,17717714,6025,"0","orth"
"399",11,1,111,22,17720920,17726011,5091,"0","valid"
"407",11,6,56,23,17731396,17736573,5177,"20","mask"
"419",11,4,126,24,17739673,17744377,4704,"20","valid"
"428",11,3,119,25,17747709,17753534,5825,"0","mask"
"436",11,3,83,26,17756886,17761604,4718,"0","mask"
"448",11,5,49,27,17764910,17771434,6524,"20","orth"
"467",11,1,129,28,17778518,17782190,3672,"0","valid"
"474",11,1,63,29,17785662,17789374,3712,"0","valid"
"488",11,1,69,30,17792680,17796118,3438,"0","valid"
"496",11,2,40,31,17799544,17804255,4711,"0","orth"
"516",11,4,36,32,17810393,17813872,3479,"20","valid"
"537",11,2,46,33,17820462,17824528,4066,"0","orth"
"559",11,6,86,34,17830632,17834218,3586,"20","mask"
"565",11,4,132,35,17837356,17842121,4765,"20","valid"
"577",11,6,128,36,17845726,17851904,6178,"20","mask"
"586",11,2,100,37,17855030,17859481,4451,"0","orth"
"599",11,6,122,38,17862434,17866472,4038,"20","mask"
"607",11,5,103,39,17869398,17874263,4865,"20","orth"
"618",11,4,78,40,17877428,17880514,3086,"20","valid"
"6210",11,3,71,41,17884432,17888644,4212,"0","mask"
"638",11,3,131,42,17892369,17896694,4325,"0","mask"
"648",11,5,73,43,17901160,17906757,5597,"20","orth"
"658",11,3,113,44,17909836,17913668,3832,"0","mask"
"668",11,5,25,45,17917087,17921465,4378,"20","orth"
"686",11,5,121,46,17927890,17931882,3992,"20","orth"
"698",11,2,70,47,17935400,17939938,4538,"0","orth"
"707",11,5,31,48,17944050,17947789,3739,"20","orth"
"729",11,6,26,49,17954233,17959105,4872,"20","mask"
"746",11,6,50,50,17965356,17969168,3812,"20","mask"
"768",11,3,65,51,17975239,17978704,3465,"0","mask"
"775",11,4,30,52,17981650,17985035,3385,"20","valid"
"798",11,5,13,53,17990986,17994765,3779,"20","orth"
"818",11,4,90,54,18000576,18005774,5198,"20","valid"
"828",11,3,77,55,18009219,18013258,4039,"0","mask"
"837",11,6,110,56,18016417,18020102,3685,"20","mask"
"847",11,3,47,57,18022961,18027779,4818,"0","mask"
"867",11,3,11,58,18033697,18037796,4099,"0","mask"
"888",11,3,53,59,18044613,18049698,5085,"0","mask"
"908",11,5,37,60,18056469,18060687,4218,"20","orth"
"928",11,2,10,61,18067118,18071377,4259,"0","orth"
"946",11,4,66,62,18077174,18081126,3952,"20","valid"
"956",11,1,15,63,18084758,18088963,4205,"0","valid"
"975",11,3,107,64,18094888,18099433,4545,"0","mask"
"987",11,2,106,65,18102425,18106883,4458,"0","orth"
"996",11,4,60,66,18166601,18171259,4658,"20","valid"
"10010",11,5,109,67,18174245,18179163,4918,"20","orth"
"10110",11,3,17,68,18182502,18187000,4498,"0","mask"
"1039",11,5,55,69,18192305,18196230,3925,"20","orth"
"1045",11,2,4,70,18199169,18203135,3966,"0","orth"
"1068",11,1,39,71,18208559,18212651,4092,"0","valid"
"1087",11,5,7,72,18218522,18223127,4605,"20","orth"
"1106",11,4,138,73,18229412,18233583,4171,"20","valid"
"11110",11,2,118,74,18236736,18240947,4211,"0","orth"
"1129",11,5,61,75,18243980,18248624,4644,"20","orth"
"1136",11,1,57,76,18251583,18255322,3739,"0","valid"
"1146",11,6,38,77,18257981,18261540,3559,"20","mask"
"1167",11,6,104,78,18266924,18271389,4465,"20","mask"
"1178",11,1,3,79,18274535,18278293,3758,"0","valid"
"1196",11,3,125,80,18285017,18289076,4059,"0","mask"
"1208",11,1,9,81,18292208,18298412,6204,"0","valid"
"1228",11,4,108,82,18304990,18309802,4812,"20","valid"
"1236",11,5,67,83,18312607,18316966,4359,"20","orth"
"1248",11,5,127,84,18319865,18324357,4492,"20","orth"
"1256",11,2,22,85,18327428,18332713,5285,"0","orth"
"1275",11,2,94,86,18339104,18343709,4605,"0","orth"
"1288",11,6,80,87,18347794,18353732,5938,"20","mask"
"1298",11,6,8,88,18356951,18360677,3726,"20","mask"
"13113",11,4,96,89,18366574,18371132,4558,"20","valid"
"1328",11,6,116,90,18374158,18381435,7277,"20","mask"
"1338",11,3,5,91,18384547,18389332,4785,"0","mask"
"1358",11,2,16,92,18396223,18400335,4112,"0","orth"
"1375",11,6,2,93,18406459,18410385,3926,"20","mask"
"1397",11,6,62,94,18417575,18423566,5991,"20","mask"
"1409",11,6,32,95,18426878,18433556,6678,"20","mask"
"1427",11,2,112,96,18439254,18445292,6038,"0","orth"
"1439",11,3,101,97,18448484,18455661,7177,"0","mask"
"1445",11,4,6,98,18458613,18464045,5432,"20","valid"
"1468",11,5,43,99,18470369,18474668,4299,"20","orth"
"1487",11,5,115,100,18481085,18485630,4545,"20","orth"
"1499",11,5,19,101,18489422,18493747,4325,"20","orth"
"15111",11,2,76,102,18501518,18505723,4205,"0","orth"
"1527",11,3,59,103,18509075,18515805,6730,"0","mask"
"1537",11,3,95,104,18519031,18523329,4298,"0","mask"
"1547",11,2,64,105,18526268,18532606,6338,"0","orth"
"1556",11,6,68,106,18536804,18541036,4232,"20","mask"
"1567",11,2,82,107,18544535,18549806,5271,"0","orth"
"1579",11,2,58,108,18552825,18556517,3692,"0","orth"
"1586",11,4,42,109,18559590,18563821,4231,"20","valid"
"1609",11,3,137,110,18571298,18575437,4139,"0","mask"
"16111",11,6,44,111,18578489,18582188,3699,"20","mask"
"16310",11,6,20,112,18588159,18593184,5025,"20","mask"
"1657",11,2,52,113,18598981,18602260,3279,"0","orth"
"1678",11,2,124,114,18608251,18612183,3932,"0","orth"
"1688",11,3,41,115,18615136,18622513,7377,"0","mask"
"1708",11,5,79,116,18630397,18635794,5397,"20","orth"
"17111",11,3,23,117,18638707,18644091,5384,"0","mask"
"1736",11,2,28,118,18650529,18655860,5331,"0","orth"
"1756",11,4,12,119,18662098,18665284,3186,"20","valid"
"1778",11,1,117,120,18670895,18674121,3226,"0","valid"
"1786",11,4,114,121,18676986,18680871,3885,"20","valid"
"1798",11,5,133,122,18684390,18687216,2826,"20","orth"
"1807",11,3,89,123,18690748,18695293,4545,"0","mask"
"18112",11,3,29,124,18698251,18702377,4126,"0","mask"
"1837",11,1,135,125,18708721,18713972,5251,"0","valid"
"1846",11,4,24,126,18716971,18720883,3912,"20","valid"
"1866",11,6,74,127,18727148,18731532,4384,"20","mask"
"1878",11,1,99,128,18734671,18738271,3600,"0","valid"
"1888",11,4,18,129,18741122,18744801,3679,"20","valid"
"1907",11,5,97,130,18753484,18757510,4026,"20","orth"
"19112",11,3,35,131,18760615,18765587,4972,"0","mask"
"1937",11,1,33,132,18772317,18775703,3386,"0","valid"
"1956",11,1,51,133,18782694,18786499,3805,"0","valid"
"1978",11,5,91,134,18792723,18796142,3419,"20","orth"
"1986",11,2,88,135,18799141,18802879,3738,"0","orth"
"1997",11,1,123,136,18806032,18809464,3432,"0","valid"
"2008",11,4,102,137,18813522,18817201,3679,"20","valid"
"2019",11,6,92,138,18820193,18823905,3712,"20","mask"
"1020",12,5,114,1,19828514,19831999,3485,"20","orth"
"1130",12,5,78,2,19835351,19837623,2272,"20","orth"
"1229",12,4,125,3,19840709,19843915,3206,"20","valid"
"1329",12,6,7,4,19846820,19849779,2959,"20","mask"
"1528",12,1,86,5,19857037,19859349,2312,"0","valid"
"1625",12,3,82,6,19862121,19865327,3206,"0","mask"
"1729",12,4,35,7,19868466,19872971,4505,"20","valid"
"1930",12,4,5,8,19879448,19882727,3279,"20","valid"
"218",12,1,50,9,19889304,19892543,3239,"0","valid"
"235",12,5,102,10,19897821,19901167,3346,"20","orth"
"2411",12,2,69,11,19903946,19906738,2792,"0","orth"
"257",12,3,112,12,19910017,19912536,2519,"0","mask"
"2610",12,4,101,13,19915275,19919047,3772,"20","valid"
"279",12,5,60,14,19922592,19926097,3505,"20","orth"
"286",12,4,137,15,19929190,19931615,2425,"20","valid"
"299",12,6,25,16,19934501,19938060,3559,"20","mask"
"315",12,6,103,17,19944131,19948196,4065,"20","mask"
"328",12,3,58,18,19951422,19954827,3405,"0","mask"
"3310",12,2,117,19,19958912,19961758,2846,"0","orth"
"347",12,6,97,20,19964557,19967036,2479,"20","mask"
"359",12,4,47,21,19969881,19972867,2986,"20","valid"
"377",12,6,115,22,19978398,19981157,2759,"20","mask"
"387",12,1,26,23,19984003,19987042,3039,"0","valid"
"408",12,5,66,24,19993193,19996991,3798,"20","orth"
"4110",12,5,30,25,19999757,20002589,2832,"20","orth"
"437",12,3,16,26,20008507,20011486,2979,"0","mask"
"455",12,1,98,27,20019456,20022915,3459,"0","valid"
"468",12,1,128,28,20026054,20029519,3465,"0","valid"
"475",12,5,126,29,20032545,20035130,2585,"20","orth"
"489",12,2,33,30,20038083,20040475,2392,"0","orth"
"507",12,5,18,31,20046460,20048405,1945,"20","orth"
"529",12,6,127,32,20053624,20055849,2225,"20","mask"
"538",12,2,123,33,20058782,20062607,3825,"0","orth"
"547",12,3,94,34,20065852,20068659,2807,"0","mask"
"5510",12,2,39,35,20071883,20075176,3293,"0","orth"
"578",12,5,36,36,20081467,20083966,2499,"20","orth"
"5910",12,2,57,37,20091496,20094922,3426,"0","orth"
"608",12,2,63,38,20097921,20099893,1972,"0","orth"
"619",12,4,77,39,20103066,20105658,2592,"20","valid"
"6211",12,2,21,40,20108444,20110689,2245,"0","orth"
"649",12,5,132,41,20116607,20120272,3665,"20","orth"
"659",12,5,6,42,20123471,20126217,2746,"20","orth"
"677",12,3,88,43,20132894,20136007,3113,"0","mask"
"687",12,2,75,44,20138719,20141918,3199,"0","orth"
"699",12,4,71,45,20144657,20146456,1799,"20","valid"
"708",12,1,32,46,20149528,20151800,2272,"0","valid"
"7210",12,1,74,47,20158212,20161037,2825,"0","valid"
"735",12,3,124,48,20164496,20166822,2326,"0","mask"
"747",12,3,22,49,20170267,20172820,2553,"0","mask"
"769",12,6,61,50,20179670,20183409,3739,"20","mask"
"776",12,5,120,51,20186628,20188953,2325,"20","orth"
"787",12,4,83,52,20193279,20197017,3738,"20","valid"
"799",12,1,56,53,20200669,20204002,3333,"0","valid"
"807",12,1,62,54,20207307,20209806,2499,"0","valid"
"819",12,2,9,55,20213038,20215557,2519,"0","orth"
"838",12,6,55,56,20223114,20225333,2219,"20","mask"
"848",12,2,135,57,20228432,20232437,4005,"0","orth"
"856",12,2,87,58,20235936,20239588,3652,"0","orth"
"868",12,2,129,59,20243334,20245459,2125,"0","orth"
"877",12,4,65,60,20248425,20250891,2466,"20","valid"
"889",12,1,122,61,20253536,20255322,1786,"0","valid"
"895",12,1,8,62,20258381,20260747,2366,"0","valid"
"916",12,6,133,63,20268024,20270984,2960,"20","mask"
"929",12,3,64,64,20273862,20276554,2692,"0","mask"
"938",12,5,24,65,20280047,20282786,2739,"20","orth"
"957",12,3,76,66,20336759,20339991,3232,"0","mask"
"966",12,1,14,67,20343163,20346449,3286,"0","valid"
"988",12,4,119,68,20353393,20356505,3112,"20","valid"
"997",12,1,38,69,20359484,20362510,3026,"0","valid"
"10111",12,4,41,70,20367674,20370773,3099,"20","valid"
"10310",12,6,85,71,20376245,20378803,2558,"20","mask"
"1046",12,5,48,72,20381476,20382995,1519,"20","orth"
"1069",12,1,80,73,20389213,20391572,2359,"0","valid"
"1077",12,3,130,74,20394464,20397336,2872,"0","mask"
"1088",12,2,15,75,20400375,20401941,1566,"0","orth"
"1107",12,2,51,76,20407073,20409639,2566,"0","orth"
"11210",12,1,92,77,20415157,20417849,2692,"0","valid"
"1137",12,2,45,78,20420482,20422854,2372,"0","orth"
"1159",12,4,95,79,20428592,20431391,2799,"20","valid"
"1168",12,3,4,80,20434383,20436769,2386,"0","mask"
"11810",12,6,37,81,20442040,20445232,3192,"20","mask"
"1209",12,4,53,82,20451531,20454322,2791,"20","valid"
"12210",12,4,11,83,20459500,20462139,2639,"20","valid"
"1249",12,6,43,84,20467204,20469083,1879,"20","mask"
"1267",12,6,79,85,20475388,20478040,2652,"20","mask"
"1276",12,4,23,86,20480679,20482705,2026,"20","valid"
"1299",12,4,59,87,20488096,20490855,2759,"20","valid"
"1305",12,2,3,88,20493781,20497893,4112,"0","orth"
"13210",12,1,68,89,20504210,20507396,3186,"0","valid"
"1339",12,3,118,90,20510442,20514953,4511,"0","mask"
"1347",12,6,13,91,20518119,20521891,3772,"20","mask"
"1367",12,3,52,92,20527449,20531021,3572,"0","mask"
"1387",12,6,49,93,20536425,20539671,3246,"20","mask"
"14010",12,5,72,94,20544376,20547201,2825,"20","orth"
"14112",12,3,70,95,20550287,20553412,3125,"0","mask"
"1428",12,1,134,96,20556844,20559037,2193,"0","valid"
"14310",12,5,96,97,20562063,20565448,3385,"20","orth"
"1446",12,1,44,98,20568194,20570146,1952,"0","valid"
"1469",12,6,73,99,20575557,20578630,3073,"20","mask"
"1477",12,6,19,100,20581695,20583934,2239,"20","mask"
"14910",12,5,108,101,20589719,20592751,3032,"20","orth"
"1507",12,3,106,102,20595463,20597129,1666,"0","mask"
"15112",12,6,67,103,20599842,20601628,1786,"20","mask"
"1529",12,5,42,104,20604600,20607252,2652,"20","orth"
"1548",12,4,131,105,20614243,20616382,2139,"20","valid"
"1557",12,6,31,106,20619661,20622433,2772,"20","mask"
"15710",12,5,12,107,20629857,20633110,3253,"20","orth"
"1597",12,2,99,108,20638934,20641493,2559,"0","orth"
"16010",12,3,34,109,20644519,20646764,2245,"0","mask"
"1626",12,2,105,110,20652689,20655335,2646,"0","orth"
"16311",12,4,17,111,20658480,20661899,3419,"20","valid"
"1658",12,5,54,112,20666924,20669169,2245,"20","orth"
"1679",12,3,100,113,20675860,20678979,3119,"0","mask"
"1689",12,3,28,114,20681865,20684630,2765,"0","mask"
"1709",12,3,136,115,20690055,20692341,2286,"0","mask"
"17112",12,3,40,116,20695333,20698626,3293,"0","mask"
"1737",12,2,93,117,20704557,20707489,2932,"0","orth"
"1747",12,5,84,118,20710401,20713993,3592,"20","orth"
"1757",12,6,91,119,20717698,20720091,2393,"20","mask"
"1768",12,1,2,120,20723016,20725589,2573,"0","valid"
"1787",12,1,116,121,20732326,20734752,2426,"0","valid"
"1799",12,4,89,122,20737871,20741230,3359,"20","valid"
"1808",12,3,46,123,20744228,20747321,3093,"0","mask"
"1827",12,4,29,124,20754218,20757010,2792,"20","valid"
"1847",12,6,1,125,20762442,20764781,2339,"20","mask"
"1867",12,5,138,126,20771512,20773831,2319,"20","orth"
"1879",12,1,20,127,20776743,20778616,1873,"0","valid"
"1897",12,5,90,128,20785533,20788172,2639,"20","orth"
"1908",12,2,81,129,20791558,20793990,2432,"0","orth"
"19113",12,6,109,130,20796842,20799621,2779,"20","mask"
"19210",12,3,10,131,20802554,20806106,3552,"0","mask"
"1946",12,1,110,132,20812083,20814169,2086,"0","valid"
"1957",12,2,111,133,20817215,20819934,2719,"0","orth"
"1968",12,4,113,134,20823466,20825512,2046,"20","valid"
"1979",12,2,27,135,20828378,20831876,3498,"0","orth"
"1998",12,1,104,136,20838307,20840946,2639,"0","valid"
"2009",12,6,121,137,20843832,20846490,2658,"20","mask"
"20110",12,4,107,138,20850549,20853735,3186,"20","valid"
"1030",13,6,24,1,22318127,22321399,3272,"20","mask"
"1230",13,5,125,2,22330282,22334401,4119,"20","orth"
"1330",13,6,78,3,22337386,22340825,3439,"20","mask"
"1429",13,5,5,4,22344091,22347190,3099,"20","orth"
"1627",13,6,108,5,22353620,22356859,3239,"20","mask"
"1730",13,3,123,6,22359759,22363044,3285,"0","mask"
"1828",13,4,40,7,22366269,22369981,3712,"20","valid"
"206",13,5,89,8,22376905,22379931,3026,"20","orth"
"219",13,4,46,9,22383296,22386255,2959,"20","valid"
"236",13,3,21,10,22393639,22396851,3212,"0","mask"
"258",13,6,138,11,22403455,22407061,3606,"20","mask"
"2611",13,6,6,12,22410000,22412832,2832,"20","mask"
"287",13,5,11,13,22418816,22421482,2666,"20","orth"
"309",13,5,107,14,22429179,22432658,3479,"20","orth"
"316",13,1,55,15,22435777,22438556,2779,"0","valid"
"329",13,4,16,16,22441521,22444913,3392,"20","valid"
"348",13,6,36,17,22451331,22454057,2726,"20","mask"
"368",13,3,45,18,22461081,22464033,2952,"0","mask"
"388",13,3,99,19,22470671,22474123,3452,"0","mask"
"3910",13,6,42,20,22476968,22479954,2986,"20","mask"
"4111",13,2,8,21,22490897,22493942,3045,"0","orth"
"438",13,5,65,22,22500326,22502938,2612,"20","orth"
"449",13,4,4,23,22506224,22509749,3525,"20","valid"
"469",13,2,32,24,22516001,22519213,3212,"0","orth"
"4810",13,1,91,25,22525943,22528849,2906,"0","valid"
"497",13,1,127,26,22531961,22534920,2959,"0","valid"
"508",13,6,126,27,22537706,22540805,3099,"20","mask"
"517",13,2,56,28,22544210,22547329,3119,"0","orth"
"5210",13,4,106,29,22549975,22552667,2692,"20","valid"
"539",13,6,132,30,22555473,22558458,2985,"20","mask"
"548",13,2,98,31,22561217,22564150,2933,"0","orth"
"5511",13,3,105,32,22566922,22569754,2832,"0","mask"
"566",13,5,53,33,22572499,22575538,3039,"20","orth"
"587",13,2,104,34,22582223,22585661,3438,"0","orth"
"5911",13,4,118,35,22588787,22592066,3279,"20","valid"
"609",13,1,13,36,22594998,22598184,3186,"0","valid"
"6212",13,1,73,37,22604754,22607993,3239,"0","valid"
"639",13,3,69,38,22611025,22614084,3059,"0","mask"
"6410",13,2,20,39,22617103,22619822,2719,"0","orth"
"669",13,2,92,40,22627879,22631405,3526,"0","orth"
"678",13,2,116,41,22634357,22637389,3032,"0","orth"
"688",13,2,68,42,22640415,22643927,3512,"0","orth"
"6910",13,4,136,43,22646512,22649798,3286,"20","valid"
"709",13,5,41,44,22653030,22655775,2745,"20","orth"
"7211",13,6,18,45,22662380,22665299,2919,"20","mask"
"748",13,3,81,46,22671643,22674549,2906,"0","mask"
"759",13,5,23,47,22677174,22679580,2406,"20","orth"
"777",13,4,76,48,22685445,22688137,2692,"20","valid"
"788",13,4,100,49,22691209,22694048,2839,"20","valid"
"7910",13,6,120,50,22697000,22700079,3079,"20","mask"
"808",13,3,51,51,22703371,22705990,2619,"0","mask"
"829",13,1,19,52,22712248,22715414,3166,"0","valid"
"849",13,2,86,53,22723517,22726416,2899,"0","orth"
"857",13,5,83,54,22729195,22732107,2912,"20","orth"
"869",13,3,15,55,22734746,22737225,2479,"0","mask"
"8810",13,2,128,56,22744403,22747775,3372,"0","orth"
"896",13,1,121,57,22751001,22754313,3312,"0","valid"
"909",13,4,70,58,22757545,22757591,46,"20","valid"
"917",13,3,75,59,22760197,22765601,5404,"0","mask"
"9210",13,6,66,60,22768720,22772326,3606,"20","mask"
"939",13,3,111,61,22775625,22779736,4111,"0","mask"
"947",13,5,113,62,22782982,22785967,2985,"20","orth"
"958",13,4,64,63,22789386,22792552,3166,"20","valid"
"967",13,3,63,64,22795764,22798749,2985,"0","mask"
"976",13,3,117,65,22801662,22803881,2219,"0","mask"
"989",13,1,79,66,22895927,22899839,3912,"0","valid"
"998",13,1,31,67,22902971,22906483,3512,"0","valid"
"10112",13,3,27,68,22918665,22923370,4705,"0","mask"
"10311",13,5,137,69,22929541,22932373,2832,"20","orth"
"1047",13,5,101,70,22935172,22937985,2813,"20","orth"
"1058",13,4,52,71,22940704,22943289,2585,"20","valid"
"1078",13,3,39,72,22950587,22953286,2699,"0","mask"
"1097",13,2,26,73,22960756,22964095,3339,"0","orth"
"11111",13,4,94,74,22971859,22975178,3319,"20","valid"
"11211",13,4,34,75,22978085,22980902,2817,"20","valid"
"1147",13,1,109,76,22988633,22991411,2778,"0","valid"
"11510",13,2,134,77,22994451,22997229,2778,"0","orth"
"1169",13,3,33,78,22999842,23002581,2739,"0","mask"
"11811",13,2,2,79,23009045,23012097,3052,"0","orth"
"12010",13,6,90,80,23018702,23021207,2505,"20","mask"
"12111",13,1,61,81,23024140,23027732,3592,"0","valid"
"12211",13,3,87,82,23030764,23033716,2952,"0","mask"
"1237",13,1,7,83,23036668,23040067,3399,"0","valid"
"1257",13,1,67,84,23047077,23049457,2380,"0","valid"
"1268",13,1,43,85,23052276,23054755,2479,"0","valid"
"1289",13,6,96,86,23060772,23063918,3146,"20","mask"
"12910",13,5,131,87,23067257,23070163,2906,"20","orth"
"1306",13,4,10,88,23072955,23075841,2886,"20","valid"
"13211",13,6,114,89,23082971,23085837,2866,"20","mask"
"13310",13,5,77,90,23088737,23091008,2271,"20","orth"
"1348",13,4,28,91,23094200,23096666,2466,"20","valid"
"1368",13,1,25,92,23104450,23107355,2905,"0","valid"
"1388",13,1,49,93,23114313,23117558,3245,"0","valid"
"14011",13,5,35,94,23123710,23126348,2638,"20","orth"
"14210",13,6,54,95,23133792,23136638,2846,"20","mask"
"1447",13,6,30,96,23143202,23145854,2652,"20","mask"
"14610",13,2,62,97,23152186,23154924,2738,"0","orth"
"1478",13,5,29,98,23158030,23160602,2572,"20","orth"
"14911",13,4,82,99,23167513,23170179,2666,"20","valid"
"1508",13,3,9,100,23173184,23176483,3299,"0","mask"
"15210",13,2,14,101,23183947,23188025,4078,"0","orth"
"1549",13,4,124,102,23197529,23199961,2432,"20","valid"
"1558",13,4,58,103,23202734,23205766,3032,"20","valid"
"1568",13,1,103,104,23208612,23211344,2732,"0","valid"
"15711",13,2,80,105,23214016,23216901,2885,"0","orth"
"1587",13,1,85,106,23219781,23222813,3032,"0","valid"
"1598",13,2,50,107,23225672,23228284,2612,"0","orth"
"16112",13,1,97,108,23234602,23237474,2872,"0","valid"
"1628",13,1,133,109,23240400,23243312,2912,"0","valid"
"16312",13,6,84,110,23246131,23248770,2639,"20","mask"
"1646",13,2,110,111,23251629,23254148,2519,"0","orth"
"1659",13,4,22,112,23257260,23260232,2972,"20","valid"
"16710",13,6,72,113,23266290,23268642,2352,"20","mask"
"16810",13,5,119,114,23271675,23274680,3005,"20","orth"
"16910",13,3,57,115,23277753,23280672,2919,"0","mask"
"17010",13,4,112,116,23284130,23286796,2666,"20","valid"
"17113",13,5,47,117,23289588,23292074,2486,"20","orth"
"1738",13,1,37,118,23298098,23301150,3052,"0","valid"
"1758",13,5,59,119,23309134,23312180,3046,"20","orth"
"1769",13,6,48,120,23315625,23317917,2292,"20","mask"
"1788",13,2,44,121,23324888,23327361,2473,"0","orth"
"1809",13,2,74,122,23333525,23336211,2686,"0","orth"
"18113",13,1,1,123,23338950,23341529,2579,"0","valid"
"1838",13,6,12,124,23348033,23350752,2719,"20","mask"
"1858",13,5,71,125,23357996,23360508,2512,"20","orth"
"1868",13,3,3,126,23363907,23367113,3206,"0","mask"
"1889",13,6,60,127,23375083,23378255,3172,"20","mask"
"1898",13,4,88,128,23381261,23384053,2792,"20","valid"
"1909",13,4,130,129,23386845,23389698,2853,"20","valid"
"19114",13,3,135,130,23392530,23395556,3026,"0","mask"
"19211",13,3,129,131,23398548,23400793,2245,"0","mask"
"1938",13,1,115,132,23403519,23406371,2852,"0","valid"
"1947",13,5,95,133,23409464,23412409,2945,"20","orth"
"1958",13,2,38,134,23415402,23418067,2665,"0","orth"
"19710",13,3,93,135,23424791,23427450,2659,"0","mask"
"1987",13,5,17,136,23431063,23434275,3212,"20","orth"
"20010",13,2,122,137,23441625,23443971,2346,"0","orth"
"20111",13,6,102,138,23447077,23449776,2699,"20","mask"
"1040",14,3,26,1,24758438,24761364,2926,"0","mask"
"1238",14,3,128,2,24767062,24770873,3811,"0","mask"
"1340",14,3,110,3,24774539,24776571,2032,"0","mask"
"1430",14,4,39,4,24779917,24782856,2939,"20","valid"
"1629",14,5,34,5,24788381,24791379,2998,"20","orth"
"1829",14,3,50,6,24797784,24800236,2452,"0","mask"
"207",14,2,109,7,24805901,24808520,2619,"0","orth"
"2110",14,4,111,8,24811266,24814964,3698,"20","valid"
"229",14,6,107,9,24818429,24821908,3479,"20","mask"
"237",14,2,1,10,24825274,24827706,2432,"0","orth"
"259",14,1,72,11,24833124,24835690,2566,"0","valid"
"2612",14,3,92,12,24838822,24842440,3618,"0","mask"
"2710",14,2,121,13,24845733,24848532,2799,"0","orth"
"288",14,4,123,14,24851644,24855929,4285,"20","valid"
"2910",14,4,87,15,24858941,24862127,3186,"20","valid"
"3010",14,2,97,16,24864965,24867405,2440,"0","orth"
"317",14,6,131,17,24870224,24872569,2345,"20","mask"
"3210",14,6,71,18,24875842,24877841,1999,"20","mask"
"3311",14,1,108,19,24880973,24882892,1919,"0","valid"
"349",14,3,44,20,24886311,24888337,2026,"0","mask"
"369",14,3,14,21,24894601,24898160,3559,"0","mask"
"389",14,5,136,22,24903918,24906584,2666,"20","orth"
"3911",14,6,35,23,24909622,24912108,2486,"20","mask"
"4112",14,2,25,24,24918259,24920605,2346,"0","orth"
"439",14,2,13,25,24927909,24931114,3205,"0","orth"
"456",14,4,129,26,24937172,24941684,4512,"20","valid"
"4610",14,6,53,27,24944703,24947388,2685,"20","mask"
"4811",14,3,2,28,24952600,24954906,2306,"0","mask"
"509",14,1,96,29,24960790,24963156,2366,"0","valid"
"518",14,2,49,30,24966908,24968954,2046,"0","orth"
"5310",14,1,84,31,24974059,24976658,2599,"0","valid"
"549",14,4,81,32,24979550,24982042,2492,"20","valid"
"5512",14,5,82,33,24984888,24987047,2159,"20","orth"
"567",14,1,12,34,24989966,24991945,1979,"0","valid"
"588",14,3,74,35,24997817,25000155,2338,"0","mask"
"5912",14,1,90,36,25003681,25005814,2133,"0","valid"
"6010",14,6,83,37,25009372,25012691,3319,"20","mask"
"6110",14,5,52,38,25016629,25019668,3039,"20","orth"
"6310",14,6,113,39,25024887,25027905,3018,"20","mask"
"6411",14,3,104,40,25031117,25033923,2806,"0","mask"
"6510",14,4,45,41,25036882,25039568,2686,"20","valid"
"679",14,1,36,42,25044919,25046712,1793,"0","valid"
"6911",14,6,65,43,25052216,25054982,2766,"20","mask"
"7010",14,4,99,44,25058168,25061380,3212,"20","valid"
"718",14,4,21,45,25064405,25067124,2719,"20","valid"
"736",14,3,62,46,25072849,25075361,2512,"0","mask"
"749",14,1,114,47,25078027,25080799,2772,"0","valid"
"7510",14,1,30,48,25083625,25085571,1946,"0","valid"
"778",14,5,100,49,25091089,25093594,2505,"20","orth"
"789",14,3,32,50,25097580,25100159,2579,"0","mask"
"809",14,6,119,51,25106950,25110395,3445,"20","mask"
"8110",14,5,28,52,25113140,25115733,2593,"20","orth"
"839",14,6,29,53,25122024,25125063,3039,"20","mask"
"858",14,2,103,54,25130814,25133506,2692,"0","orth"
"8610",14,3,56,55,25136152,25138678,2526,"0","mask"
"878",14,1,24,56,25141357,25144082,2725,"0","valid"
"897",14,5,16,57,25149927,25152706,2779,"20","orth"
"918",14,2,79,58,25158644,25161089,2445,"0","orth"
"9211",14,6,11,59,25164222,25166594,2372,"20","mask"
"948",14,4,69,60,25173585,25175737,2152,"20","valid"
"959",14,5,10,61,25179263,25182761,3498,"20","orth"
"977",14,5,40,62,25189506,25192718,3212,"20","orth"
"999",14,2,127,63,25199542,25202574,3032,"0","orth"
"10011",14,4,27,64,25205433,25208199,2766,"20","valid"
"10210",14,6,23,65,25213883,25216169,2286,"20","mask"
"1048",14,6,5,66,25299178,25301671,2493,"20","mask"
"10610",14,2,133,67,25307682,25309821,2139,"0","orth"
"1079",14,3,86,68,25312567,25314393,1826,"0","mask"
"1089",14,2,43,69,25317339,25318918,1579,"0","orth"
"1108",14,4,105,70,25324102,25327135,3033,"20","valid"
"11112",14,5,58,71,25330087,25332913,2826,"20","orth"
"11212",14,5,4,72,25335785,25338204,2419,"20","orth"
"1148",14,1,42,73,25343356,25345075,1719,"0","valid"
"11610",14,4,117,74,25352239,25354711,2472,"20","valid"
"1179",14,4,15,75,25357644,25359463,1819,"20","valid"
"1197",14,1,6,76,25365274,25367500,2226,"0","valid"
"12112",14,4,57,77,25373364,25375943,2579,"20","valid"
"12212",14,3,38,78,25378876,25381275,2399,"0","mask"
"12410",14,3,8,79,25387626,25390085,2459,"0","mask"
"1269",14,5,64,80,25395443,25398522,3079,"20","orth"
"1277",14,4,9,81,25401561,25404673,3112,"20","valid"
"12911",14,5,118,82,25417015,25419407,2392,"20","orth"
"1307",14,5,70,83,25422793,25425918,3125,"20","orth"
"13114",14,6,137,84,25429217,25431103,1886,"20","mask"
"13212",14,2,85,85,25434189,25436921,2732,"0","orth"
"13311",14,6,17,86,25440086,25442039,1953,"20","mask"
"1359",14,3,116,87,25449096,25452562,3466,"0","mask"
"1369",14,5,88,88,25457240,25459292,2052,"20","orth"
"1376",14,1,48,89,25462338,25463884,1546,"0","valid"
"1398",14,3,20,90,25470369,25472767,2398,"0","mask"
"14113",14,1,132,91,25481145,25483597,2452,"0","valid"
"14211",14,2,91,92,25486642,25488535,1893,"0","orth"
"14311",14,2,7,93,25491547,25493613,2066,"0","orth"
"1458",14,6,77,94,25500244,25502617,2373,"20","mask"
"14611",14,4,33,95,25506182,25509854,3672,"20","valid"
"1488",14,6,125,96,25516265,25518524,2259,"20","mask"
"14912",14,6,89,97,25521603,25525834,4231,"20","mask"
"1509",14,6,101,98,25528787,25531432,2645,"20","mask"
"15113",14,2,73,99,25534338,25536484,2146,"0","orth"
"15211",14,1,60,100,25539343,25542122,2779,"0","valid"
"1538",14,6,59,101,25545194,25548180,2986,"20","mask"
"15410",14,5,124,102,25551705,25554377,2672,"20","orth"
"1559",14,1,120,103,25558263,25560089,1826,"0","valid"
"1569",14,2,115,104,25563381,25566393,3012,"0","orth"
"15712",14,4,135,105,25569618,25573470,3852,"20","valid"
"1588",14,2,61,106,25576483,25578995,2512,"0","orth"
"1599",14,1,126,107,25581881,25583940,2059,"0","valid"
"16011",14,3,122,108,25586685,25588838,2153,"0","mask"
"16113",14,4,3,109,25591890,25596049,4159,"20","valid"
"16313",14,3,134,110,25603699,25605892,2193,"0","mask"
"1647",14,1,138,111,25609004,25611070,2066,"0","valid"
"16510",14,5,94,112,25613929,25616688,2759,"20","orth"
"1664",14,3,68,113,25619593,25621906,2313,"0","mask"
"16711",14,6,95,114,25624518,25627650,3132,"20","mask"
"16811",14,2,55,115,25630702,25632428,1726,"0","orth"
"16911",14,5,106,116,25635354,25637653,2299,"20","orth"
"17011",14,1,78,117,25641772,25644044,2272,"0","valid"
"17114",14,5,46,118,25647423,25649915,2492,"20","orth"
"1739",14,5,112,119,25657999,25660305,2306,"20","orth"
"1748",14,3,98,120,25663531,25665723,2192,"0","mask"
"1759",14,1,54,121,25668582,25670628,2046,"0","valid"
"1779",14,2,37,122,25676919,25679224,2305,"0","orth"
"17910",14,3,80,123,25686342,25689088,2746,"0","mask"
"18010",14,5,130,124,25692266,25694652,2386,"20","orth"
"18114",14,6,47,125,25697418,25700530,3112,"20","mask"
"1839",14,4,93,126,25706501,25708800,2299,"20","valid"
"1848",14,4,75,127,25711773,25714512,2739,"20","valid"
"1859",14,5,22,128,25717484,25720356,2872,"20","orth"
"18710",14,4,51,129,25728946,25731312,2366,"20","valid"
"1899",14,2,19,130,25736803,25738662,1859,"0","orth"
"19115",14,2,67,131,25748172,25750012,1840,"0","orth"
"19212",14,2,31,132,25752904,25755123,2219,"0","orth"
"1948",14,4,63,133,25761887,25763940,2053,"20","valid"
"1959",14,1,66,134,25766805,25769138,2333,"0","valid"
"1969",14,6,41,135,25772637,25775049,2412,"20","mask"
"1988",14,5,76,136,25782213,25785372,3159,"20","orth"
"1999",14,1,102,137,25788491,25790643,2152,"0","valid"
"20011",14,1,18,138,25793629,25796108,2479,"0","valid"
"1049",15,5,57,1,10151763,10153835,2072,"20","orth"
"1138",15,4,116,2,10156607,10161045,4438,"20","valid"
"1239",15,2,54,3,10164215,10166418,2203,"0","orth"
"1440",15,4,98,4,10172072,10175079,3007,"20","valid"
"1530",15,1,77,5,10178164,10180830,2666,"0","valid"
"1630",15,3,133,6,10184144,10186844,2700,"0","mask"
"1740",15,1,107,7,10189655,10192099,2444,"0","valid"
"1830",15,2,138,8,10195158,10197446,2288,"0","orth"
"1939",15,3,55,9,10200172,10202420,2248,"0","mask"
"208",15,5,111,10,10205401,10208126,2725,"20","orth"
"2111",15,1,89,11,10210917,10214160,3243,"0","valid"
"2210",15,3,103,12,10217382,10220441,3059,"0","mask"
"238",15,3,121,13,10223670,10226598,2928,"0","mask"
"2412",15,5,3,14,10229487,10232533,3046,"20","orth"
"2613",15,1,119,15,10238403,10241240,2837,"0","valid"
"2711",15,5,129,16,10244521,10247136,2615,"20","orth"
"289",15,4,92,17,10250070,10254312,4242,"20","valid"
"2911",15,3,67,18,10257483,10260241,2758,"0","mask"
"3011",15,5,93,19,10263091,10266039,2948,"20","orth"
"318",15,2,12,20,10268817,10271176,2359,"0","orth"
"3312",15,3,1,21,10276968,10279647,2679,"0","mask"
"3510",15,1,113,22,10285066,10287746,2680,"0","valid"
"3610",15,1,29,23,10290491,10293243,2752,"0","valid"
"3810",15,6,22,24,10298688,10301806,3118,"20","mask"
"409",15,2,90,25,10307355,10310944,3589,"0","orth"
"4113",15,4,8,26,10314134,10317977,3843,"20","valid"
"4310",15,4,104,27,10323971,10327481,3510,"20","valid"
"4410",15,6,34,28,10330487,10334298,3811,"20","mask"
"4611",15,3,73,29,10339822,10343279,3457,"0","mask"
"476",15,5,21,30,10346175,10349554,3379,"20","orth"
"498",15,1,125,31,10355528,10357927,2399,"0","valid"
"5010",15,5,45,32,10360725,10363496,2771,"20","orth"
"5211",15,4,68,33,10369104,10372680,3576,"20","valid"
"5311",15,6,112,34,10375784,10378628,2844,"20","mask"
"5410",15,6,88,35,10381707,10385190,3483,"20","mask"
"5513",15,1,53,36,10388295,10391832,3537,"0","valid"
"579",15,2,72,37,10397498,10400322,2824,"0","orth"
"589",15,3,91,38,10403198,10407479,4281,"0","mask"
"5913",15,4,32,39,10410820,10414767,3947,"20","valid"
"6111",15,5,105,40,10420474,10424494,4020,"20","orth"
"6213",15,1,5,41,10427546,10431278,3732,"0","valid"
"6412",15,2,96,42,10437645,10440671,3026,"0","orth"
"6511",15,1,17,43,10444057,10447293,3236,"0","valid"
"6710",15,4,56,44,10453058,10456953,3895,"20","valid"
"689",15,6,46,45,10460110,10464150,4040,"20","mask"
"7011",15,6,58,46,10469948,10472987,3039,"20","mask"
"719",15,5,9,47,10476131,10478779,2648,"20","orth"
"737",15,1,65,48,10484380,10486766,2386,"0","valid"
"7410",15,5,75,49,10489511,10493295,3784,"20","orth"
"7511",15,1,95,50,10496440,10499440,3000,"0","valid"
"7610",15,3,25,51,10502473,10505133,2660,"0","mask"
"7810",15,4,62,52,10510676,10513303,2627,"20","valid"
"7911",15,6,76,53,10516127,10519546,3419,"20","mask"
"8010",15,5,51,54,10522513,10525317,2804,"20","orth"
"8210",15,2,114,55,10530566,10533743,3177,"0","orth"
"8310",15,3,13,56,10537155,10539887,2732,"0","mask"
"859",15,6,64,57,10545417,10547979,2562,"20","mask"
"8611",15,4,26,58,10551103,10553764,2661,"20","valid"
"8811",15,4,134,59,10560856,10564568,3712,"20","valid"
"898",15,4,2,60,10567837,10570974,3137,"20","valid"
"919",15,6,94,61,10576602,10580863,4261,"20","mask"
"9212",15,4,14,62,10583942,10587008,3066,"20","valid"
"949",15,3,79,63,10592368,10595231,2863,"0","mask"
"9510",15,6,118,64,10598080,10600878,2798,"20","mask"
"968",15,5,87,65,10603793,10607715,3922,"20","orth"
"978",15,4,128,66,10668667,10672510,3843,"20","valid"
"9810",15,2,60,67,10675903,10678628,2725,"0","orth"
"9910",15,5,63,68,10681530,10684132,2602,"20","orth"
"10012",15,6,82,69,10686962,10691197,4235,"20","mask"
"10113",15,1,41,70,10694361,10697551,3190,"0","valid"
"10312",15,1,35,71,10703028,10706107,3079,"0","valid"
"1059",15,4,20,72,10712205,10715578,3373,"20","valid"
"10710",15,4,110,73,10721154,10724050,2896,"20","valid"
"10810",15,5,15,74,10726743,10730677,3934,"20","orth"
"1109",15,6,28,75,10735920,10738946,3026,"20","mask"
"11213",15,6,124,76,10744829,10747541,2712,"20","mask"
"1139",15,1,71,77,10750214,10753012,2798,"0","valid"
"1149",15,6,40,78,10756196,10759549,3353,"20","mask"
"11611",15,4,86,79,10767922,10770686,2764,"20","valid"
"11710",15,5,99,80,10773700,10776753,3053,"20","orth"
"11812",15,5,27,81,10779726,10782465,2739,"20","orth"
"12011",15,2,102,82,10787322,10790335,3013,"0","orth"
"12113",15,6,4,83,10793290,10797028,3738,"20","mask"
"12310",15,3,7,84,10802074,10805663,3589,"0","mask"
"1258",15,3,31,85,10812716,10815461,2745,"0","mask"
"1278",15,2,48,86,10820644,10822494,1850,"0","orth"
"12912",15,3,85,87,10827619,10830632,3013,"0","mask"
"1308",15,4,50,88,10833410,10836384,2974,"20","valid"
"13213",15,5,81,89,10841855,10845097,3242,"20","orth"
"13312",15,1,137,90,10847862,10850770,2908,"0","valid"
"1349",15,2,126,91,10853829,10856712,2883,"0","orth"
"13510",15,5,33,92,10859470,10863856,4386,"20","orth"
"1377",15,5,39,93,10869634,10872661,3027,"20","orth"
"1399",15,6,10,94,10878288,10881883,3595,"20","mask"
"14114",15,2,132,95,10887465,10890387,2922,"0","orth"
"14212",15,6,70,96,10893361,10897231,3870,"20","mask"
"14312",15,2,78,97,10900146,10902414,2268,"0","orth"
"1448",15,6,130,98,10905519,10909774,4255,"20","mask"
"1459",15,4,122,99,10912774,10918193,5419,"20","valid"
"14612",15,2,84,100,10922213,10926017,3804,"0","orth"
"1479",15,4,38,101,10928952,10932789,3837,"20","valid"
"14913",15,6,16,102,10938247,10941757,3510,"20","mask"
"15114",15,3,97,103,10947496,10950601,3105,"0","mask"
"15212",15,2,108,104,10953575,10957071,3496,"0","orth"
"1539",15,3,43,105,10959980,10964386,4406,"0","mask"
"15510",15,4,80,106,10970609,10973641,3032,"20","valid"
"15610",15,4,74,107,10976602,10979583,2981,"20","valid"
"15713",15,2,36,108,10982302,10985681,3379,"0","orth"
"15910",15,2,18,109,10991825,10994518,2693,"0","orth"
"16114",15,3,49,110,11000303,11003820,3517,"0","mask"
"16314",15,5,117,111,11012735,11015140,2405,"20","orth"
"1648",15,6,100,112,11017951,11021056,3105,"20","mask"
"16511",15,4,44,113,11023788,11026174,2386,"20","valid"
"16712",15,1,131,114,11032044,11033933,1889,"0","valid"
"16812",15,1,11,115,11036691,11038737,2046,"0","valid"
"17012",15,3,19,116,11044384,11047208,2824,"0","mask"
"17210",15,1,23,117,11052535,11055601,3066,"0","valid"
"1749",15,2,42,118,11061300,11064850,3550,"0","orth"
"17610",15,3,37,119,11070072,11073243,3171,"0","mask"
"1789",15,2,6,120,11079008,11082407,3399,"0","orth"
"18011",15,2,120,121,11087799,11090289,2490,"0","orth"
"18115",15,3,61,122,11093218,11096323,3105,"0","mask"
"18210",15,6,52,123,11099493,11102369,2876,"20","mask"
"1849",15,2,24,124,11107997,11110899,2902,"0","orth"
"1869",15,5,123,125,11116618,11119494,2876,"20","orth"
"18711",15,5,69,126,11122331,11124723,2392,"20","orth"
"18810",15,1,59,127,11127887,11131462,3575,"0","valid"
"18910",15,3,115,128,11134894,11137789,2895,"0","mask"
"19010",15,6,136,129,11141077,11143652,2575,"20","mask"
"19116",15,1,101,130,11146476,11149117,2641,"0","valid"
"19213",15,3,109,131,11152143,11155274,3131,"0","mask"
"19310",15,1,47,132,11158438,11160392,1954,"0","valid"
"19510",15,2,30,133,11165903,11168458,2555,"0","orth"
"19711",15,1,83,134,11173471,11176164,2693,"0","valid"
"1989",15,2,66,135,11179106,11181740,2634,"0","orth"
"19910",15,6,106,136,11184544,11186943,2399,"20","mask"
"20012",15,5,135,137,11190231,11194048,3817,"20","orth"
"20112",15,3,127,138,11197231,11200179,2948,"0","mask"
"1050",16,4,73,1,29253245,29258743,5498,"20","valid"
"1140",16,3,54,2,29262121,29266993,4872,"0","mask"
"1350",16,5,98,3,29275144,29282620,7476,"20","orth"
"1449",16,4,61,4,29285879,29290724,4845,"20","valid"
"1540",16,1,10,5,29294116,29298668,4552,"0","valid"
"1750",16,3,84,6,29304879,29309830,4951,"0","mask"
"1840",16,5,74,7,29313363,29318880,5517,"20","orth"
"1940",16,4,67,8,29322106,29325618,3512,"20","valid"
"209",16,6,123,9,29328690,29333488,4798,"20","mask"
"2112",16,4,121,10,29336374,29340512,4138,"20","valid"
"2211",16,4,13,11,29343705,29348116,4411,"20","valid"
"2413",16,1,112,12,29353981,29357640,3659,"0","valid"
"2510",16,2,83,13,29360792,29365563,4771,"0","orth"
"2614",16,1,106,14,29368555,29372094,3539,"0","valid"
"2712",16,1,76,15,29374980,29380044,5064,"0","valid"
"2810",16,5,68,16,29383290,29388488,5198,"20","orth"
"2912",16,5,38,17,29391640,29395912,4272,"20","orth"
"319",16,3,96,18,29401956,29406674,4718,"0","mask"
"3211",16,2,77,19,29410140,29414871,4731,"0","orth"
"3313",16,5,86,20,29418130,29421862,3732,"20","orth"
"3410",16,6,3,21,29425075,29429333,4258,"20","mask"
"3611",16,3,42,22,29434864,29440016,5152,"0","mask"
"3811",16,5,20,23,29445940,29449705,3765,"20","orth"
"4010",16,3,114,24,29456430,29462347,5917,"0","mask"
"4114",16,2,113,25,29465606,29470438,4832,"0","orth"
"429",16,2,95,26,29473557,29478615,5058,"0","orth"
"4311",16,6,15,27,29481640,29484699,3059,"20","mask"
"457",16,6,27,28,29490237,29494636,4399,"20","mask"
"477",16,2,47,29,29500167,29504239,4072,"0","orth"
"499",16,3,90,30,29510216,29514995,4779,"0","mask"
"5011",16,2,101,31,29518073,29522885,4812,"0","orth"
"519",16,3,108,32,29525884,29531095,5211,"0","mask"
"5212",16,1,46,33,29534427,29538573,4146,"0","valid"
"5411",16,5,110,34,29544511,29548289,3778,"20","orth"
"5514",16,3,138,35,29551741,29556626,4885,"0","mask"
"568",16,2,23,36,29559851,29564097,4246,"0","orth"
"5810",16,1,64,37,29570008,29575199,5191,"0","valid"
"5914",16,2,89,38,29578238,29583629,5391,"0","orth"
"6011",16,5,92,39,29587261,29592639,5378,"20","orth"
"6112",16,5,116,40,29595778,29600510,4732,"20","orth"
"6214",16,6,117,41,29603468,29606528,3060,"20","mask"
"6311",16,5,56,42,29609426,29614098,4672,"20","orth"
"6413",16,4,103,43,29617603,29621369,3766,"20","valid"
"6512",16,2,137,44,29624548,29629692,5144,"0","orth"
"6610",16,5,14,45,29633078,29637922,4844,"20","orth"
"6810",16,4,109,46,29644680,29649005,4325,"20","valid"
"6912",16,2,107,47,29652357,29656815,4458,"0","orth"
"7012",16,1,40,48,29660308,29665492,5184,"0","valid"
"7212",16,2,11,49,29671743,29676009,4266,"0","orth"
"7411",16,4,55,50,29682393,29687511,5118,"20","valid"
"7512",16,2,131,51,29690577,29694962,4385,"0","orth"
"7611",16,3,120,52,29698027,29702479,4452,"0","mask"
"779",16,6,93,53,29706097,29710409,4312,"20","mask"
"7811",16,3,48,54,29713315,29716234,2919,"0","mask"
"8011",16,6,135,55,29722611,29727823,5212,"20","mask"
"8111",16,1,124,56,29730742,29735160,4418,"0","valid"
"8211",16,2,53,57,29738665,29743497,4832,"0","orth"
"8410",16,4,43,58,29749108,29752960,3852,"20","valid"
"8612",16,5,32,59,29758645,29762403,3758,"20","orth"
"8812",16,4,49,60,29768394,29772326,3932,"20","valid"
"9010",16,5,134,61,29777911,29781523,3612,"20","orth"
"9110",16,2,17,62,29784715,29789580,4865,"0","orth"
"9310",16,3,60,63,29795184,29800449,5265,"0","mask"
"9410",16,3,66,64,29803561,29806727,3166,"0","mask"
"9511",16,6,105,65,29809826,29816903,7077,"20","mask"
"969",16,6,45,66,29867544,29871296,3752,"20","mask"
"9811",16,2,5,67,29877354,29881619,4265,"0","orth"
"10013",16,1,58,68,29887557,29891702,4145,"0","valid"
"10114",16,2,59,69,29894794,29899146,4352,"0","orth"
"10211",16,2,65,70,29902085,29905444,3359,"0","orth"
"10313",16,3,6,71,29908389,29913067,4678,"0","mask"
"10510",16,3,30,72,29918705,29922591,3886,"0","mask"
"10711",16,2,125,73,29928262,29931881,3619,"0","orth"
"10811",16,3,72,74,29934613,29938351,3738,"0","mask"
"1098",16,2,35,75,29941350,29944589,3239,"0","orth"
"11113",16,4,1,76,29950581,29954665,4084,"20","valid"
"11310",16,4,133,77,29960863,29963689,2826,"20","valid"
"11410",16,2,41,78,29966754,29970806,4052,"0","orth"
"11612",16,6,81,79,29976184,29980310,4126,"20","mask"
"11711",16,2,119,80,29983315,29987207,3892,"0","orth"
"11813",16,4,19,81,29990219,29994318,4099,"20","valid"
"12012",16,1,94,82,30002255,30007906,5651,"0","valid"
"12114",16,5,104,83,30011152,30014943,3791,"20","orth"
"12213",16,1,118,84,30018422,30022181,3759,"0","valid"
"12311",16,4,91,85,30025073,30029565,4492,"20","valid"
"12411",16,1,4,86,30032724,30036475,3751,"0","valid"
"12610",16,6,87,87,30042333,30046745,4412,"20","mask"
"1279",16,6,63,88,30049564,30052629,3065,"20","mask"
"12810",16,5,122,89,30055441,30057534,2093,"20","orth"
"12913",16,4,127,90,30060480,30063199,2719,"20","valid"
"1309",16,4,79,91,30066051,30070203,4152,"20","valid"
"13115",16,5,128,92,30073102,30077680,4578,"20","orth"
"13214",16,5,50,93,30080679,30084251,3572,"20","orth"
"13410",16,6,9,94,30090049,30094774,4725,"20","mask"
"13610",16,4,25,95,30100472,30103831,3359,"20","valid"
"1389",16,4,97,96,30109315,30112514,3199,"20","valid"
"13910",16,6,39,97,30115433,30119238,3805,"20","mask"
"14115",16,1,82,98,30125063,30129388,4325,"0","valid"
"14213",16,4,7,99,30132353,30137331,4978,"20","valid"
"14410",16,6,51,100,30143809,30148094,4285,"20","mask"
"14613",16,5,8,101,30153799,30158217,4418,"20","orth"
"1489",16,4,85,102,30164614,30168540,3926,"20","valid"
"14914",16,2,29,103,30171445,30175697,4252,"0","orth"
"15115",16,6,57,104,30181582,30185967,4385,"20","mask"
"15213",16,6,21,105,30189052,30191898,2846,"20","mask"
"15411",16,6,69,106,30197629,30201541,3912,"20","mask"
"15511",16,5,62,107,30204626,30209238,4612,"20","orth"
"15611",16,3,24,108,30212344,30216989,4645,"0","mask"
"1589",16,6,129,109,30224099,30229144,5045,"20","mask"
"15911",16,6,99,110,30232436,30236948,4512,"20","mask"
"16012",16,3,132,111,30240020,30244299,4279,"0","mask"
"16115",16,5,2,112,30247231,30250929,3698,"20","orth"
"16315",16,3,102,113,30257420,30260566,3146,"0","mask"
"1649",16,1,100,114,30263598,30266957,3359,"0","valid"
"16512",16,5,80,115,30270142,30274174,4032,"20","orth"
"1665",16,3,126,116,30277459,30282691,5232,"0","mask"
"16713",16,1,34,117,30285770,30289815,4045,"0","valid"
"16912",16,4,37,118,30295580,30300764,5184,"20","valid"
"17115",16,4,31,119,30306262,30310734,4472,"20","valid"
"17310",16,5,44,120,30317592,30320770,3178,"20","orth"
"17510",16,6,111,121,30326661,30330013,3352,"20","mask"
"17611",16,1,52,122,30333366,30337484,4118,"0","valid"
"17810",16,1,130,123,30343489,30348347,4858,"0","valid"
"17911",16,1,28,124,30351386,30355544,4158,"0","valid"
"18116",16,1,88,125,30361555,30364674,3119,"0","valid"
"18211",16,3,36,126,30367493,30372045,4552,"0","mask"
"18410",16,3,18,127,30378449,30382907,4458,"0","mask"
"18610",16,3,12,128,30388865,30392570,3705,"0","mask"
"18811",16,4,115,129,30398135,30401427,3292,"20","valid"
"18911",16,1,16,130,30404506,30407785,3279,"0","valid"
"19117",16,3,78,131,30413096,30416041,2945,"0","mask"
"19214",16,1,70,132,30419194,30424225,5031,"0","valid"
"19311",16,2,71,133,30427064,30429970,2906,"0","orth"
"1949",16,1,22,134,30432835,30436601,3766,"0","valid"
"19610",16,5,26,135,30442818,30448610,5792,"20","orth"
"19810",16,1,136,136,30455460,30459232,3772,"0","valid"
"19911",16,6,33,137,30462418,30466183,3765,"20","mask"
"20113",16,6,75,138,30472488,30477272,4784,"20","mask"
"1060",17,3,65,1,31411507,31413979,2472,"0","mask"
"1150",17,3,23,2,31417325,31421210,3885,"0","mask"
"1360",17,3,17,3,31426928,31430493,3565,"0","mask"
"1550",17,3,119,4,31437111,31443801,6690,"0","mask"
"1640",17,2,4,5,31447094,31450233,3139,"0","orth"
"1850",17,5,7,6,31455977,31459296,3319,"20","orth"
"2010",17,2,82,7,31466200,31469352,3152,"0","orth"
"2113",17,4,138,8,31472984,31476190,3206,"20","valid"
"2212",17,5,61,9,31479782,31482647,2865,"20","orth"
"239",17,1,75,10,31486086,31489785,3699,"0","valid"
"2414",17,2,40,11,31493443,31497608,4165,"0","orth"
"2615",17,1,45,12,31503466,31506845,3379,"0","valid"
"2811",17,5,91,13,31512277,31515668,3391,"20","orth"
"2913",17,1,87,14,31519174,31522586,3412,"0","valid"
"3012",17,5,103,15,31525478,31528970,3492,"20","orth"
"3110",17,5,85,16,31531776,31535434,3658,"20","orth"
"3212",17,6,8,17,31538767,31541425,2658,"20","mask"
"3411",17,3,5,18,31548283,31551169,2886,"0","mask"
"3612",17,4,54,19,31557366,31560085,2719,"20","valid"
"3812",17,4,12,20,31566617,31568862,2245,"20","valid"
"4011",17,4,36,21,31574707,31577646,2939,"20","valid"
"4210",17,4,84,22,31584156,31588135,3979,"20","valid"
"4312",17,4,126,23,31591121,31595386,4265,"20","valid"
"4411",17,6,116,24,31598498,31602430,3932,"20","mask"
"458",17,2,106,25,31605349,31608761,3412,"0","orth"
"4612",17,1,105,26,31611760,31616591,4831,"0","valid"
"478",17,1,93,27,31619650,31622395,2745,"0","valid"
"4812",17,1,111,28,31625688,31628860,3172,"0","valid"
"4910",17,6,122,29,31631632,31634351,2719,"20","mask"
"5012",17,1,33,30,31637497,31640929,3432,"0","valid"
"5213",17,6,104,31,31647060,31651398,4338,"20","mask"
"5312",17,5,73,32,31654657,31658909,4252,"20","orth"
"5412",17,4,60,33,31662127,31665640,3513,"20","valid"
"5515",17,5,31,34,31669385,31672910,3525,"20","orth"
"5710",17,3,53,35,31678475,31681134,2659,"0","mask"
"5915",17,1,9,36,31686905,31690284,3379,"0","valid"
"6113",17,1,39,37,31696848,31700660,3812,"0","valid"
"6312",17,2,46,38,31706585,31710223,3638,"0","orth"
"6513",17,3,35,39,31716241,31719373,3132,"0","mask"
"6711",17,5,67,40,31726111,31728396,2285,"20","orth"
"6811",17,6,68,41,31731509,31735474,3965,"20","mask"
"6913",17,1,135,42,31738533,31741845,3312,"0","valid"
"7013",17,1,81,43,31745224,31748609,3385,"0","valid"
"7110",17,5,37,44,31751488,31755033,3545,"20","orth"
"738",17,1,117,45,31760791,31764730,3939,"0","valid"
"7412",17,1,129,46,31768122,31772507,4385,"0","valid"
"7513",17,5,109,47,31775986,31780071,4085,"20","orth"
"7612",17,1,63,48,31783176,31786202,3026,"0","valid"
"7710",17,2,112,49,31789354,31793046,3692,"0","orth"
"7812",17,3,131,50,31796525,31801109,4584,"0","mask"
"7912",17,6,38,51,31804115,31807381,3266,"20","mask"
"8112",17,3,113,52,31813318,31816197,2879,"0","mask"
"8212",17,3,83,53,31819123,31822788,3665,"0","mask"
"8311",17,5,97,54,31825714,31827833,2119,"20","orth"
"8411",17,2,28,55,31830779,31834964,4185,"0","orth"
"8613",17,4,108,56,31841475,31844400,2925,"20","valid"
"879",17,3,29,57,31847539,31851864,4325,"0","mask"
"899",17,4,18,58,31859255,31861774,2519,"20","valid"
"9111",17,5,43,59,31867738,31870457,2719,"20","orth"
"9311",17,6,134,60,31876095,31879274,3179,"20","mask"
"9411",17,6,26,61,31882526,31887171,4645,"20","mask"
"9610",17,4,78,62,31893835,31896234,2399,"20","valid"
"979",17,6,92,63,31899340,31902659,3319,"20","mask"
"9812",17,4,24,64,31905344,31908303,2959,"20","valid"
"10014",17,4,30,65,31915561,31918339,2778,"20","valid"
"10212",17,6,20,66,31948675,31950621,1946,"20","mask"
"10410",17,6,128,67,31956159,31961617,5458,"20","mask"
"10511",17,2,22,68,31965036,31969234,4198,"0","orth"
"10712",17,5,25,69,31975592,31978464,2872,"20","orth"
"1099",17,6,14,70,31984242,31988180,3938,"20","mask"
"11114",17,1,123,71,31995278,31998943,3665,"0","valid"
"11214",17,2,52,72,32001755,32004368,2613,"0","orth"
"11411",17,2,94,73,32010066,32012965,2899,"0","orth"
"11511",17,5,55,74,32015617,32018216,2599,"20","orth"
"11613",17,3,95,75,32021168,32025486,4318,"0","mask"
"11712",17,1,3,76,32028572,32033150,4578,"0","valid"
"1198",17,3,71,77,32039521,32043113,3592,"0","mask"
"12013",17,5,13,78,32046392,32050444,4052,"20","orth"
"12214",17,3,107,79,32056722,32059674,2952,"0","mask"
"12312",17,3,137,80,32062753,32066132,3379,"0","mask"
"12412",17,5,127,81,32069017,32071323,2306,"20","orth"
"1259",17,5,1,82,32074235,32076721,2486,"20","orth"
"12710",17,1,15,83,32083112,32085491,2379,"0","valid"
"12914",17,3,41,84,32092468,32096827,4359,"0","mask"
"13116",17,6,32,85,32102638,32105670,3032,"20","mask"
"13313",17,4,72,86,32112088,32113967,1879,"20","valid"
"13411",17,6,50,87,32116740,32119238,2498,"20","mask"
"13611",17,2,118,88,32124990,32127929,2939,"0","orth"
"1378",17,4,102,89,32130748,32133307,2559,"20","valid"
"13810",17,3,59,90,32136272,32140870,4598,"0","mask"
"13911",17,4,42,91,32143929,32147448,3519,"20","valid"
"14116",17,2,88,92,32154113,32156838,2725,"0","orth"
"14214",17,1,69,93,32159544,32161776,2232,"0","valid"
"14313",17,3,89,94,32164775,32168800,4025,"0","mask"
"14411",17,4,6,95,32171799,32175937,4138,"20","valid"
"14614",17,4,114,96,32182928,32187153,4225,"20","valid"
"14710",17,3,47,97,32189913,32192325,2412,"0","mask"
"14915",17,2,64,98,32197749,32201481,3732,"0","orth"
"15010",17,2,130,99,32204827,32209386,4559,"0","orth"
"15116",17,4,48,100,32212104,32214257,2153,"20","valid"
"15310",17,1,51,101,32220421,32223153,2732,"0","valid"
"15512",17,1,57,102,32228771,32231598,2827,"0","valid"
"15612",17,6,80,103,32234856,32237755,2899,"20","mask"
"15714",17,2,76,104,32240534,32244859,4325,"0","orth"
"15810",17,2,70,105,32248184,32251776,3592,"0","orth"
"15912",17,6,62,106,32255315,32258114,2799,"20","mask"
"16013",17,2,10,107,32261253,32265025,3772,"0","orth"
"16210",17,3,101,108,32271869,32276400,4531,"0","mask"
"16316",17,2,58,109,32279972,32283684,3712,"0","orth"
"16410",17,5,79,110,32286897,32290335,3438,"20","orth"
"16513",17,3,125,111,32293661,32297846,4185,"0","mask"
"1666",17,6,86,112,32301145,32303877,2732,"20","mask"
"16714",17,6,98,113,32306763,32310321,3558,"20","mask"
"16813",17,3,77,114,32313447,32316699,3252,"0","mask"
"16913",17,4,120,115,32319778,32322277,2499,"20","valid"
"17013",17,4,96,116,32325236,32329421,4185,"20","valid"
"17116",17,2,16,117,32332500,32336845,4345,"0","orth"
"17311",17,3,11,118,32343189,32346015,2826,"0","mask"
"17511",17,6,74,119,32352446,32357437,4991,"20","mask"
"17612",17,6,2,120,32361042,32364148,3106,"20","mask"
"17811",17,5,133,121,32372698,32375197,2499,"20","orth"
"17912",17,4,90,122,32377930,32380762,2832,"20","valid"
"18012",17,5,19,123,32383947,32387533,3586,"20","orth"
"18212",17,4,66,124,32394057,32396603,2546,"20","valid"
"18310",17,6,56,125,32399695,32402754,3059,"20","mask"
"18411",17,1,21,126,32405633,32407978,2345,"0","valid"
"18611",17,2,124,127,32414050,32417628,3578,"0","orth"
"18712",17,2,136,128,32421180,32424406,3226,"0","orth"
"18812",17,5,115,129,32427331,32430343,3012,"20","orth"
"18912",17,6,110,130,32433263,32435455,2192,"20","mask"
"19011",17,2,100,131,32438134,32442006,3872,"0","orth"
"19118",17,6,44,132,32444765,32447197,2432,"20","mask"
"19312",17,5,121,133,32453515,32456034,2519,"20","orth"
"19410",17,5,49,134,32460179,32462658,2479,"20","orth"
"19611",17,2,34,135,32467830,32472681,4851,"0","orth"
"19811",17,4,132,136,32480052,32483037,2985,"20","valid"
"19912",17,1,99,137,32486069,32489582,3513,"0","valid"
"20013",17,1,27,138,32492574,32496033,3459,"0","valid"
"1070",18,6,37,1,793816,796281,2465,"20","mask"
"1240",18,6,61,2,802899,805911,3012,"20","mask"
"1370",18,5,72,3,809356,811989,2633,"20","orth"
"1450",18,1,38,4,814721,817227,2506,"0","valid"
"1650",18,5,12,5,826397,828956,2559,"20","orth"
"1860",18,6,133,6,834680,837099,2419,"20","mask"
"1950",18,3,88,7,840432,842724,2292,"0","mask"
"2020",18,6,127,8,846043,849242,3199,"20","mask"
"2114",18,5,60,9,853760,856232,2472,"20","orth"
"2213",18,4,137,10,859578,862570,2992,"20","valid"
"2310",18,4,83,11,865822,869248,3426,"20","valid"
"2415",18,1,86,12,873553,875798,2245,"0","valid"
"2511",18,6,55,13,879351,881630,2279,"20","mask"
"2616",18,2,33,14,884895,887227,2332,"0","orth"
"2812",18,3,10,15,894285,898143,3858,"0","mask"
"3013",18,2,15,16,904315,906427,2112,"0","orth"
"3213",18,6,25,17,913005,915564,2559,"20","mask"
"3412",18,1,116,18,923568,927239,3671,"0","valid"
"3511",18,5,6,19,931925,935550,3625,"20","orth"
"378",18,6,43,20,942254,945966,3712,"20","mask"
"3912",18,5,84,21,951724,954349,2625,"20","orth"
"4012",18,4,5,22,958161,961807,3646,"20","valid"
"4211",18,5,66,23,967511,970344,2833,"20","orth"
"4313",18,6,79,24,976381,978720,2339,"20","mask"
"4412",18,2,69,25,982093,984505,2412,"0","orth"
"459",18,2,3,26,987650,990136,2486,"0","orth"
"479",18,4,65,27,996767,999006,2239,"20","valid"
"4813",18,4,17,28,1002291,1005177,2886,"20","valid"
"5013",18,2,45,29,1010895,1013114,2219,"0","orth"
"5214",18,2,99,30,1018572,1021118,2546,"0","orth"
"5313",18,1,110,31,1024543,1026269,1726,"0","valid"
"5413",18,2,27,32,1029102,1031954,2852,"0","orth"
"569",18,4,77,33,1038491,1041584,3093,"20","valid"
"5711",18,1,56,34,1044783,1048368,3585,"0","valid"
"5811",18,2,39,35,1051880,1054992,3112,"0","orth"
"6012",18,1,32,36,1060770,1063789,3019,"0","valid"
"6215",18,6,91,37,1069780,1072312,2532,"20","mask"
"6313",18,6,103,38,1077330,1079823,2493,"20","mask"
"6414",18,6,1,39,1083642,1087400,3758,"20","mask"
"6611",18,1,104,40,1093005,1095217,2212,"0","valid"
"6712",18,4,131,41,1098403,1100548,2145,"20","valid"
"6812",18,5,96,42,1106100,1108925,2825,"20","orth"
"6914",18,1,74,43,1112084,1114723,2639,"0","valid"
"7014",18,2,105,44,1117755,1119981,2226,"0","orth"
"7111",18,6,67,45,1123120,1126699,3579,"20","mask"
"7213",18,6,19,46,1129591,1132417,2826,"20","mask"
"7413",18,4,47,47,1138408,1140327,1919,"20","valid"
"7613",18,5,24,48,1145805,1149317,3512,"20","orth"
"7813",18,3,112,49,1155241,1157407,2166,"0","mask"
"7913",18,5,30,50,1160380,1163066,2686,"20","orth"
"8113",18,3,70,51,1168517,1172155,3638,"0","mask"
"8213",18,5,102,52,1175641,1178913,3272,"20","orth"
"8312",18,3,34,53,1182078,1184610,2532,"0","mask"
"8510",18,5,126,54,1191122,1193961,2839,"20","orth"
"8614",18,1,128,55,1197266,1199745,2479,"0","valid"
"8710",18,5,78,56,1202597,1205196,2599,"20","orth"
"8813",18,6,85,57,1208488,1212327,3839,"20","mask"
"8910",18,1,8,58,1216599,1218978,2379,"0","valid"
"9112",18,3,64,59,1227521,1230274,2753,"0","mask"
"9213",18,4,113,60,1234679,1237851,3172,"20","valid"
"9312",18,4,59,61,1241583,1244282,2699,"20","valid"
"9412",18,3,100,62,1247467,1250139,2672,"0","mask"
"9512",18,1,80,63,1253518,1255364,1846,"0","valid"
"9611",18,6,31,64,1258637,1261336,2699,"20","mask"
"9813",18,6,49,65,1267067,1271292,4225,"20","mask"
"10015",18,2,57,66,1304053,1306332,2279,"0","orth"
"10115",18,3,76,67,1309564,1312543,2979,"0","mask"
"10213",18,3,118,68,1315835,1319414,3579,"0","mask"
"10314",18,3,124,69,1322880,1324679,1799,"0","mask"
"10411",18,5,36,70,1329877,1332156,2279,"20","orth"
"10611",18,3,16,71,1339800,1341812,2012,"0","mask"
"10812",18,1,50,72,1347817,1350189,2372,"0","valid"
"11010",18,5,90,73,1355741,1358746,3005,"20","orth"
"11115",18,4,125,74,1361785,1364464,2679,"20","valid"
"11215",18,3,28,75,1367676,1370175,2499,"0","mask"
"11412",18,2,21,76,1375540,1380525,4985,"0","orth"
"11614",18,1,92,77,1387575,1389781,2206,"0","valid"
"11713",18,5,138,78,1393173,1395699,2526,"20","orth"
"11814",18,2,123,79,1398931,1401177,2246,"0","orth"
"1199",18,2,93,80,1404223,1406222,1999,"0","orth"
"12014",18,3,106,81,1409641,1411913,2272,"0","mask"
"12115",18,6,73,82,1415285,1418544,3259,"20","mask"
"12215",18,1,26,83,1421976,1424182,2206,"0","valid"
"12413",18,3,130,84,1431253,1433745,2492,"0","mask"
"12510",18,1,98,85,1436944,1439470,2526,"0","valid"
"12611",18,5,18,86,1442295,1444707,2412,"20","orth"
"12811",18,3,136,87,1453504,1455823,2319,"0","mask"
"12915",18,4,23,88,1459382,1462688,3306,"20","valid"
"13117",18,4,107,89,1469825,1472337,2512,"20","valid"
"13215",18,1,44,90,1476062,1480734,4672,"0","valid"
"13412",18,5,48,91,1486739,1488185,1446,"20","orth"
"13612",18,2,111,92,1494369,1496555,2186,"0","orth"
"1379",18,1,14,93,1500067,1502806,2739,"0","valid"
"13912",18,5,108,94,1509130,1511783,2653,"20","orth"
"14012",18,5,120,95,1514682,1517067,2385,"20","orth"
"14117",18,6,121,96,1520166,1524538,4372,"20","mask"
"14215",18,1,122,97,1528150,1529856,1706,"0","valid"
"14314",18,2,117,98,1533395,1534954,1559,"0","orth"
"14412",18,2,9,99,1538733,1540785,2052,"0","orth"
"14615",18,1,134,100,1549535,1552214,2679,"0","valid"
"14711",18,1,68,101,1555747,1558079,2332,"0","valid"
"14810",18,4,89,102,1562484,1564696,2212,"20","valid"
"14916",18,4,95,103,1569195,1572507,3312,"20","valid"
"15011",18,6,13,104,1575999,1578478,2479,"20","mask"
"15214",18,5,132,105,1586515,1588927,2412,"20","orth"
"15311",18,6,97,106,1592333,1594685,2352,"20","mask"
"15412",18,2,75,107,1598018,1600650,2632,"0","orth"
"15513",18,4,53,108,1603735,1605781,2046,"20","valid"
"15715",18,5,42,109,1611992,1614438,2446,"20","orth"
"15913",18,6,115,110,1620276,1622701,2425,"20","mask"
"16014",18,2,81,111,1625954,1629173,3219,"0","orth"
"16116",18,6,109,112,1632251,1634831,2580,"20","mask"
"16211",18,4,71,113,1638069,1640315,2246,"20","valid"
"16317",18,4,29,114,1643707,1645933,2226,"20","valid"
"16514",18,3,40,115,1652544,1655083,2539,"0","mask"
"16715",18,4,35,116,1661107,1663326,2219,"20","valid"
"16914",18,2,129,117,1670857,1674229,3372,"0","orth"
"17014",18,1,2,118,1677668,1680001,2333,"0","valid"
"17211",18,1,62,119,1685485,1688071,2586,"0","valid"
"17312",18,3,46,120,1691750,1694342,2592,"0","mask"
"17512",18,3,82,121,1701353,1705711,4358,"0","mask"
"17613",18,6,7,122,1709443,1713202,3759,"20","mask"
"17812",18,4,11,123,1720152,1722365,2213,"20","valid"
"18013",18,2,135,124,1728729,1731568,2839,"0","orth"
"18117",18,1,20,125,1736593,1739645,3052,"0","valid"
"18311",18,4,101,126,1746276,1749708,3432,"20","valid"
"18412",18,3,52,127,1752993,1754972,1979,"0","mask"
"18612",18,4,119,128,1760804,1763343,2539,"20","valid"
"18713",18,3,22,129,1767675,1770887,3212,"0","mask"
"18913",18,5,114,130,1777051,1780124,3073,"20","orth"
"19012",18,2,51,131,1783256,1785415,2159,"0","orth"
"19215",18,3,4,132,1791386,1793878,2492,"0","mask"
"19411",18,5,54,133,1800123,1802155,2032,"20","orth"
"19612",18,3,94,134,1807840,1811292,3452,"0","mask"
"19712",18,2,87,135,1814791,1817023,2232,"0","orth"
"19812",18,3,58,136,1820242,1825833,5591,"0","mask"
"19913",18,4,41,137,1829972,1832184,2212,"20","valid"
"20114",18,2,63,138,1838069,1839888,1819,"0","orth"
"1080",19,2,26,1,3200718,3205456,4738,"0","orth"
"1250",19,2,134,2,3213240,3220857,7617,"0","orth"
"1380",19,4,58,3,3224283,3229894,5611,"20","valid"
"1460",19,3,129,4,3233266,3239144,5878,"0","mask"
"1560",19,5,101,5,3242442,3246035,3593,"20","orth"
"1660",19,4,136,6,3249287,3254191,4904,"20","valid"
"1760",19,5,71,7,3257117,3261676,4559,"20","orth"
"1870",19,1,7,8,3264934,3270825,5891,"0","valid"
"2021",19,6,6,9,3279469,3285193,5724,"20","mask"
"2214",19,4,4,10,3292418,3297762,5344,"20","valid"
"2416",19,2,116,11,3305659,3310757,5098,"0","orth"
"2512",19,2,86,12,3313749,3317128,3379,"0","orth"
"2617",19,1,1,13,3320767,3323906,3139,"0","valid"
"2813",19,2,50,14,3330737,3334189,3452,"0","orth"
"3014",19,6,126,15,3340066,3346304,6238,"20","mask"
"3111",19,3,57,16,3349443,3353488,4045,"0","mask"
"3214",19,3,33,17,3356714,3361692,4978,"0","mask"
"3413",19,3,99,18,3368389,3373261,4872,"0","mask"
"3512",19,5,131,19,3377260,3380805,3545,"20","orth"
"3613",19,1,109,20,3383750,3387669,3919,"0","valid"
"379",19,5,17,21,3391807,3396732,4925,"20","orth"
"3913",19,6,42,22,3403010,3411986,8976,"20","mask"
"4115",19,5,95,23,3423736,3437104,13368,"20","orth"
"4212",19,6,54,24,3440649,3443788,3139,"20","mask"
"4413",19,6,96,25,3450013,3455110,5097,"20","mask"
"4510",19,4,118,26,3458270,3461228,2958,"20","valid"
"4613",19,1,19,27,3464121,3467473,3352,"0","valid"
"4814",19,2,20,28,3476109,3486359,10250,"0","orth"
"5014",19,6,60,29,3493204,3498395,5191,"20","mask"
"5110",19,3,21,30,3502580,3506532,3952,"0","mask"
"5314",19,4,10,31,3513556,3518287,4731,"20","valid"
"5516",19,5,65,32,3525618,3530243,4625,"20","orth"
"5610",19,4,112,33,3533055,3536634,3579,"20","valid"
"5712",19,1,67,34,3539506,3542385,2879,"0","valid"
"5812",19,4,88,35,3545424,3549189,3765,"20","valid"
"5916",19,1,121,36,3552408,3555294,2886,"0","valid"
"6013",19,2,8,37,3558366,3561691,3325,"0","orth"
"6216",19,3,27,38,3569175,3573407,4232,"0","mask"
"6415",19,6,138,39,3579338,3584489,5151,"20","mask"
"6514",19,2,98,40,3587642,3591854,4212,"0","orth"
"6612",19,3,81,41,3595199,3598078,2879,"0","mask"
"6713",19,1,13,42,3604862,3610506,5644,"0","valid"
"6915",19,4,16,43,3617950,3622762,4812,"20","valid"
"7112",19,3,39,44,3631239,3639336,8097,"0","mask"
"739",19,6,72,45,3645754,3650605,4851,"20","mask"
"7414",19,2,14,46,3653984,3659848,5864,"0","orth"
"7614",19,6,84,47,3666799,3670664,3865,"20","mask"
"7711",19,4,22,48,3673963,3677902,3939,"20","valid"
"7914",19,4,64,49,3685859,3689564,3705,"20","valid"
"8012",19,3,15,50,3692650,3695835,3185,"0","mask"
"8214",19,2,92,51,3702299,3706438,4139,"0","orth"
"8313",19,2,122,52,3709397,3711529,2132,"0","orth"
"8412",19,5,5,53,3714721,3718986,4265,"20","orth"
"8615",19,3,111,54,3727277,3733961,6684,"0","mask"
"8711",19,2,56,55,3737466,3742444,4978,"0","orth"
"8814",19,5,113,56,3745457,3749682,4225,"20","orth"
"8911",19,5,11,57,3754354,3757226,2872,"20","orth"
"9113",19,5,77,58,3764503,3767582,3079,"20","orth"
"9214",19,1,31,59,3770821,3775112,4291,"0","valid"
"9413",19,1,25,60,3784149,3789187,5038,"0","valid"
"9612",19,1,85,61,3800097,3804082,3985,"0","valid"
"9710",19,1,73,62,3812286,3815864,3578,"0","valid"
"9814",19,6,108,63,3819123,3822395,3272,"20","mask"
"9911",19,3,105,64,3825374,3828693,3319,"0","mask"
"10016",19,4,52,65,3835050,3838975,3925,"20","valid"
"10214",19,1,115,66,3874376,3876808,2432,"0","valid"
"10315",19,5,89,67,3880213,3884085,3872,"20","orth"
"10412",19,2,32,68,3887504,3890743,3239,"0","orth"
"10612",19,3,69,69,3897427,3900839,3412,"0","mask"
"10713",19,1,127,70,3903911,3907630,3719,"0","valid"
"10813",19,6,78,71,3910482,3913981,3499,"20","mask"
"10910",19,5,83,72,3916993,3921438,4445,"20","orth"
"11011",19,1,49,73,3924777,3931255,6478,"0","valid"
"11216",19,5,53,74,3938199,3941311,3112,"20","orth"
"11413",19,6,12,75,3947662,3951747,4085,"20","mask"
"11615",19,3,93,76,3960637,3963743,3106,"0","mask"
"11714",19,5,35,77,3967435,3970914,3479,"20","orth"
"11910",19,4,70,78,3977777,3981363,3586,"20","valid"
"12015",19,3,9,79,3984468,3991246,6778,"0","mask"
"12216",19,5,41,80,3996864,4000542,3678,"20","orth"
"12414",19,4,28,81,4006541,4010432,3891,"20","valid"
"12612",19,6,90,82,4019102,4023967,4865,"20","mask"
"12711",19,3,117,83,4026973,4029899,2926,"0","mask"
"12812",19,5,137,84,4032717,4035956,3239,"20","orth"
"12916",19,6,132,85,4038668,4042647,3979,"20","mask"
"13010",19,6,24,86,4045812,4049678,3866,"20","mask"
"13216",19,3,45,87,4058741,4062013,3272,"0","mask"
"13413",19,6,120,88,4067531,4071723,4192,"20","mask"
"13511",19,6,36,89,4074735,4078534,3799,"20","mask"
"13710",19,1,79,90,4084598,4088183,3585,"0","valid"
"13811",19,2,2,91,4092542,4096873,4331,"0","orth"
"14013",19,3,135,92,4104544,4109282,4738,"0","mask"
"14118",19,4,46,93,4112381,4117859,5478,"20","valid"
"14315",19,1,37,94,4124164,4128469,4305,"0","valid"
"14510",19,6,102,95,4134313,4137925,3612,"20","mask"
"14616",19,5,107,96,4141137,4145376,4239,"20","orth"
"14712",19,1,91,97,4148261,4151414,3153,"0","valid"
"14811",19,1,55,98,4154306,4156591,2285,"0","valid"
"14917",19,6,66,99,4159424,4162436,3012,"20","mask"
"15012",19,2,44,100,4165635,4168760,3125,"0","orth"
"15215",19,5,125,101,4174818,4179936,5118,"20","orth"
"15312",19,6,114,102,4183215,4187966,4751,"20","mask"
"15413",19,2,38,103,4191005,4195070,4065,"0","orth"
"15613",19,4,76,104,4201115,4206320,5205,"20","valid"
"15716",19,1,97,105,4209745,4213424,3679,"0","valid"
"15811",19,5,59,106,4216357,4220794,4437,"20","orth"
"15914",19,2,104,107,4225286,4229444,4158,"0","orth"
"16015",19,2,62,108,4232830,4235676,2846,"0","orth"
"16117",19,3,51,109,4238574,4242326,3752,"0","mask"
"16318",19,3,87,110,4249777,4254122,4345,"0","mask"
"16411",19,4,100,111,4257481,4260313,2832,"20","valid"
"16515",19,2,128,112,4263445,4270922,7477,"0","orth"
"1667",19,1,103,113,4274315,4278999,4684,"0","valid"
"16716",19,4,130,114,4282392,4287076,4684,"20","valid"
"16814",19,4,94,115,4290309,4294807,4498,"20","valid"
"16915",19,5,23,116,4297899,4301425,3526,"20","orth"
"17117",19,5,29,117,4308209,4311754,3545,"20","orth"
"17313",19,4,124,118,4317899,4322350,4451,"20","valid"
"17410",19,4,82,119,4325463,4328628,3165,"20","valid"
"17513",19,3,75,120,4331827,4336178,4351,"0","mask"
"17614",19,5,47,121,4339571,4343276,3705,"20","orth"
"17813",19,3,123,122,4349993,4354605,4612,"0","mask"
"17913",19,2,110,123,4357690,4361462,3772,"0","orth"
"18014",19,2,74,124,4364628,4369139,4511,"0","orth"
"18118",19,2,68,125,4372665,4376257,3592,"0","orth"
"18213",19,1,43,126,4379162,4381761,2599,"0","valid"
"18413",19,1,133,127,4392784,4396889,4105,"0","valid"
"18510",19,4,106,128,4404053,4407499,3446,"20","valid"
"18613",19,4,34,129,4410784,4415116,4332,"20","valid"
"18813",19,4,40,130,4425452,4430037,4585,"20","valid"
"19013",19,1,61,131,4437681,4440873,3192,"0","valid"
"19119",19,5,119,132,4443892,4448830,4938,"20","orth"
"19216",19,6,18,133,4451903,4454461,2558,"20","mask"
"19412",19,6,30,134,4460719,4464431,3712,"20","mask"
"19613",19,3,3,135,4470462,4474601,4139,"0","mask"
"19813",19,3,63,136,4480198,4484044,3846,"0","mask"
"19914",19,6,48,137,4486883,4490015,3132,"20","mask"
"20115",19,2,80,138,4496693,4501544,4851,"0","orth"
"1090",20,2,103,1,13844400,13850178,5778,"0","orth"
"1160",20,1,42,2,13853832,13859368,5536,"0","valid"
"1390",20,1,120,3,13866545,13871689,5144,"0","valid"
"1470",20,4,93,4,13875938,13880101,4163,"20","valid"
"1570",20,3,8,5,13884278,13889311,5033,"0","mask"
"1770",20,4,39,6,13895070,13901057,5987,"20","valid"
"1960",20,2,31,7,13906835,13913391,6556,"0","orth"
"2115",20,1,6,8,13920366,13928529,8163,"0","valid"
"2311",20,6,71,9,13933438,13937720,4282,"20","mask"
"2417",20,4,87,10,13941511,13947348,5837,"20","valid"
"2513",20,4,129,11,13951714,13957839,6125,"20","valid"
"2618",20,1,54,12,13961466,13965251,3785,"0","valid"
"2814",20,4,9,13,13974545,13980069,5524,"20","valid"
"3015",20,4,63,14,13986559,13991436,4877,"20","valid"
"3112",20,4,21,15,13995639,13999299,3660,"20","valid"
"3314",20,2,109,16,14006639,14013653,7014,"0","orth"
"3414",20,5,124,17,14018320,14021980,3660,"20","orth"
"3513",20,1,90,18,14026680,14031229,4549,"0","valid"
"3614",20,4,99,19,14035530,14039752,4222,"20","valid"
"3710",20,2,55,20,14044648,14047610,2962,"0","orth"
"3813",20,4,69,21,14051917,14055584,3667,"20","valid"
"3914",20,1,126,22,14060015,14064702,4687,"0","valid"
"4013",20,3,62,23,14068075,14072585,4510,"0","mask"
"4116",20,6,41,24,14077298,14082076,4778,"20","mask"
"4314",20,3,104,25,14089521,14093200,3679,"0","mask"
"4414",20,6,23,26,14098835,14103051,4216,"20","mask"
"4614",20,6,101,27,14109156,14114241,5085,"20","mask"
"4710",20,2,133,28,14117523,14120791,3268,"0","orth"
"4815",20,5,130,29,14124974,14130040,5066,"20","orth"
"4911",20,4,105,30,14133903,14138073,4170,"20","valid"
"5015",20,2,19,31,14143145,14147230,4085,"0","orth"
"5215",20,2,1,32,14155473,14159702,4229,"0","orth"
"5414",20,4,27,33,14165356,14169663,4307,"20","valid"
"5611",20,6,95,34,14175311,14183808,8497,"20","mask"
"5713",20,2,97,35,14188135,14192762,4627,"0","orth"
"5813",20,1,114,36,14196828,14201946,5118,"0","valid"
"5917",20,1,18,37,14206358,14209803,3445,"0","valid"
"6114",20,6,65,38,14216790,14220627,3837,"20","mask"
"6217",20,6,5,39,14224719,14228314,3595,"20","mask"
"6416",20,1,72,40,14234399,14238419,4020,"0","valid"
"6515",20,3,98,41,14242472,14248374,5902,"0","mask"
"6613",20,6,29,42,14251368,14256323,4955,"20","mask"
"6813",20,5,10,43,14263094,14267010,3916,"20","orth"
"7015",20,2,73,44,14273788,14279075,5287,"0","orth"
"7113",20,1,48,45,14282657,14284769,2112,"0","valid"
"7310",20,5,22,46,14292305,14297391,5086,"20","orth"
"7514",20,4,135,47,14304607,14309038,4431,"20","valid"
"7615",20,6,35,48,14313182,14316621,3439,"20","mask"
"7814",20,5,82,49,14322477,14326242,3765,"20","orth"
"7915",20,1,60,50,14330255,14335792,5537,"0","valid"
"8013",20,4,45,51,14339132,14342505,3373,"20","valid"
"8215",20,4,57,52,14349152,14353146,3994,"20","valid"
"8314",20,4,33,53,14356800,14362538,5738,"20","valid"
"8511",20,2,79,54,14371382,14375873,4491,"0","orth"
"8616",20,1,24,55,14380442,14384135,3693,"0","valid"
"8815",20,5,46,56,14391436,14395599,4163,"20","orth"
"9011",20,6,137,57,14400868,14403495,2627,"20","mask"
"9114",20,3,68,58,14406705,14410326,3621,"0","mask"
"9215",20,4,117,59,14414954,14417823,2869,"20","valid"
"9313",20,2,115,60,14421052,14424719,3667,"0","orth"
"9414",20,1,66,61,14427595,14432543,4948,"0","valid"
"9513",20,6,53,62,14436831,14440289,3458,"20","mask"
"9711",20,5,28,63,14446766,14450093,3327,"20","orth"
"9912",20,3,128,64,14455924,14460061,4137,"0","mask"
"10017",20,4,51,65,14463447,14469147,5700,"20","valid"
"10215",20,5,16,66,14507581,14512123,4542,"20","orth"
"10413",20,6,11,67,14518013,14522726,4713,"20","mask"
"10613",20,6,59,68,14528380,14532066,3686,"20","mask"
"10714",20,5,58,69,14536439,14539537,3098,"20","orth"
"10814",20,5,106,70,14543119,14546165,3046,"20","orth"
"10911",20,2,25,71,14549309,14552021,2712,"0","orth"
"11116",20,5,52,72,14557512,14560944,3432,"20","orth"
"11311",20,6,113,73,14570605,14573814,3209,"20","mask"
"11414",20,3,14,74,14576625,14579899,3274,"0","mask"
"11616",20,6,107,75,14585710,14588724,3014,"20","mask"
"11715",20,6,77,76,14592796,14596672,3876,"20","mask"
"11815",20,1,132,77,14600156,14603574,3418,"0","valid"
"11911",20,3,50,78,14607051,14609830,2779,"0","mask"
"12116",20,3,122,79,14615183,14617686,2503,"0","mask"
"12217",20,6,119,80,14622026,14628268,6242,"20","mask"
"12313",20,2,121,81,14631393,14635334,3941,"0","orth"
"12415",20,6,125,82,14638472,14641341,2869,"20","mask"
"12511",20,2,43,83,14644263,14646858,2595,"0","orth"
"12712",20,5,112,84,14651969,14656682,4713,"20","orth"
"12813",20,5,136,85,14666186,14669336,3150,"20","orth"
"12917",20,1,138,86,14672638,14676441,3803,"0","valid"
"13011",20,4,15,87,14679174,14681193,2019,"20","valid"
"13217",20,1,36,88,14687599,14690174,2575,"0","valid"
"13414",20,2,13,89,14696607,14700450,3843,"0","orth"
"13613",20,3,92,90,14706980,14710032,3052,"0","mask"
"13711",20,4,123,91,14712895,14715895,3000,"20","valid"
"13812",20,3,26,92,14718883,14721824,2941,"0","mask"
"14014",20,5,70,93,14730471,14735269,4798,"20","orth"
"14119",20,5,40,94,14739720,14743341,3621,"20","orth"
"14316",20,3,20,95,14749767,14751943,2176,"0","mask"
"14511",20,5,4,96,14759440,14761715,2275,"20","orth"
"14713",20,2,37,97,14767016,14770226,3210,"0","orth"
"14918",20,4,81,98,14777814,14780194,2380,"20","valid"
"15013",20,3,56,99,14783991,14788181,4190,"0","mask"
"15117",20,6,89,100,14796214,14800940,4726,"20","mask"
"15216",20,2,91,101,14804208,14807156,2948,"0","orth"
"15313",20,3,134,102,14810215,14812823,2608,"0","mask"
"15414",20,1,102,103,14815680,14817333,1653,"0","valid"
"15514",20,4,111,104,14820895,14824517,3622,"20","valid"
"15614",20,3,44,105,14829582,14832243,2661,"0","mask"
"15812",20,2,127,106,14839282,14841230,1948,"0","orth"
"15915",20,2,67,107,14844328,14846799,2471,"0","orth"
"16016",20,3,116,108,14850590,14857610,7020,"0","mask"
"16118",20,6,17,109,14861938,14865898,3960,"20","mask"
"16319",20,3,80,110,14873637,14876670,3033,"0","mask"
"16412",20,6,131,111,14879801,14883024,3223,"20","mask"
"16516",20,1,12,112,14886469,14888710,2241,"0","valid"
"16717",20,2,85,113,14895685,14899358,3673,"0","orth"
"16815",20,3,74,114,14903123,14906319,3196,"0","mask"
"16916",20,6,47,115,14911091,14913621,2530,"20","mask"
"17118",20,1,84,116,14919085,14921974,2889,"0","valid"
"17212",20,1,108,117,14924844,14928249,3405,"0","valid"
"17314",20,3,32,118,14931027,14934570,3543,"0","mask"
"17514",20,3,86,119,14941583,14943394,1811,"0","mask"
"17615",20,1,78,120,14946381,14951198,4817,"0","valid"
"17710",20,1,96,121,14954565,14957715,3150,"0","valid"
"17814",20,4,75,122,14961833,14964996,3163,"20","valid"
"17914",20,2,49,123,14969546,14971350,1804,"0","orth"
"18119",20,3,110,124,14976971,14979206,2235,"0","mask"
"18214",20,5,88,125,14982259,14984619,2360,"20","orth"
"18312",20,2,7,126,14987390,14989978,2588,"0","orth"
"18511",20,3,2,127,14996979,14999508,2529,"0","mask"
"18714",20,3,38,128,15006555,15009176,2621,"0","mask"
"18914",20,5,100,129,15015850,15018333,2483,"20","orth"
"19014",20,4,3,130,15022778,15025922,3144,"20","valid"
"19217",20,1,30,131,15041740,15045126,3386,"0","valid"
"19413",20,6,83,132,15050852,15054172,3320,"20","mask"
"19511",20,2,61,133,15058297,15060689,2392,"0","orth"
"19614",20,5,64,134,15064219,15068245,4026,"20","orth"
"19713",20,5,94,135,15071363,15074854,3491,"20","orth"
"19814",20,5,76,136,15078697,15081494,2797,"20","orth"
"19915",20,5,118,137,15086018,15088998,2980,"20","orth"
"20014",20,5,34,138,15092299,15094508,2209,"20","orth"
"10100",21,4,20,1,8012207,8017918,5711,"20","valid"
"1260",21,1,59,2,8025916,8032260,6344,"0","valid"
"13100",21,4,92,3,8035405,8041336,5931,"20","valid"
"1480",21,1,23,4,8044942,8050593,5651,"0","valid"
"1668",21,6,10,5,8058557,8064954,6397,"20","mask"
"1880",21,2,120,6,8071826,8077270,5444,"0","orth"
"1970",21,1,5,7,8080622,8086600,5978,"0","valid"
"2116",21,5,93,8,8094357,8098495,4138,"20","orth"
"2215",21,5,75,9,8101801,8109025,7224,"20","orth"
"2312",21,6,70,10,8112624,8120667,8043,"20","mask"
"2418",21,2,138,11,8125639,8130310,4671,"0","orth"
"2514",21,6,34,12,8133309,8144405,11096,"20","mask"
"2713",21,6,130,13,8152109,8158260,6151,"20","mask"
"2815",21,3,79,14,8162099,8168689,6590,"0","mask"
"2914",21,2,90,15,8172628,8177893,5265,"0","orth"
"3016",21,3,37,16,8181385,8188735,7350,"0","mask"
"3215",21,3,103,17,8196013,8201164,5151,"0","mask"
"3315",21,4,38,18,8205556,8211187,5631,"20","valid"
"3514",21,2,114,19,8218178,8224149,5971,"0","orth"
"3615",21,2,36,20,8227228,8231760,4532,"0","orth"
"3814",21,4,98,21,8239170,8244875,5705,"20","valid"
"3915",21,1,95,22,8248134,8254598,6464,"0","valid"
"4014",21,2,18,23,8257610,8264154,6544,"0","orth"
"4213",21,3,91,24,8272125,8277682,5557,"0","mask"
"4315",21,2,12,25,8280802,8286653,5851,"0","orth"
"4511",21,6,106,26,8293097,8299201,6104,"20","mask"
"4615",21,6,46,27,8302394,8307985,5591,"20","mask"
"4816",21,2,132,28,8314476,8321786,7310,"0","orth"
"4912",21,6,40,29,8325652,8330670,5018,"20","mask"
"5111",21,4,8,30,8337687,8343358,5671,"20","valid"
"5315",21,6,58,31,8351303,8358153,6850,"20","mask"
"5415",21,4,14,32,8361385,8366623,5238,"20","valid"
"5612",21,2,102,33,8374120,8379505,5385,"0","orth"
"5714",21,6,64,34,8382757,8387888,5131,"20","mask"
"5814",21,3,7,35,8391534,8396059,4525,"0","mask"
"6014",21,2,24,36,8406009,8415971,9962,"0","orth"
"6218",21,2,78,37,8423149,8427187,4038,"0","orth"
"6314",21,3,43,38,8431879,8435664,3785,"0","mask"
"6516",21,5,123,39,8442522,8448333,5811,"20","orth"
"6614",21,6,28,40,8451532,8456916,5384,"20","mask"
"6814",21,6,4,41,8463654,8470451,6797,"20","mask"
"7016",21,3,97,42,8477629,8483546,5917,"0","mask"
"7114",21,2,96,43,8486666,8491184,4518,"0","orth"
"7214",21,6,88,44,8495709,8500647,4938,"20","mask"
"7311",21,6,16,45,8503999,8509837,5838,"20","mask"
"7515",21,5,21,46,8518214,8522119,3905,"20","orth"
"7712",21,1,137,47,8529656,8534514,4858,"0","valid"
"7815",21,5,45,48,8537394,8542098,4704,"20","orth"
"8014",21,1,119,49,8548510,8554700,6190,"0","valid"
"8114",21,3,13,50,8558153,8563124,4971,"0","mask"
"8315",21,1,35,51,8569522,8573907,4385,"0","valid"
"8512",21,5,63,52,8581657,8587848,6191,"20","orth"
"8617",21,4,122,53,8590854,8595079,4225,"20","valid"
"8712",21,2,72,54,8598031,8601990,3959,"0","orth"
"8816",21,1,41,55,8605522,8610433,4911,"0","valid"
"9012",21,3,67,56,8617711,8621909,4198,"0","mask"
"9115",21,1,125,57,8625081,8632305,7224,"0","valid"
"9216",21,6,76,58,8635404,8642474,7070,"20","mask"
"9314",21,4,26,59,8645527,8650791,5264,"20","valid"
"9514",21,6,82,60,8658529,8662534,4005,"20","mask"
"9613",21,5,87,61,8665613,8670771,5158,"20","orth"
"9712",21,5,129,62,8673697,8677149,3452,"20","orth"
"9815",21,2,84,63,8680640,8688964,8324,"0","orth"
"9913",21,6,112,64,8691883,8696541,4658,"20","mask"
"10018",21,2,108,65,8699514,8703279,3765,"0","orth"
"10116",21,1,77,66,8773686,8778777,5091,"0","valid"
"10216",21,2,30,67,8781557,8785575,4018,"0","orth"
"10414",21,4,32,68,8792766,8798344,5578,"20","valid"
"10614",21,1,53,69,8805861,8811239,5378,"0","valid"
"10815",21,3,55,70,8817557,8821622,4065,"0","mask"
"10912",21,5,111,71,8824467,8829232,4765,"20","orth"
"11012",21,5,3,72,8832378,8838129,5751,"20","orth"
"11217",21,6,100,73,8845113,8850525,5412,"20","mask"
"11312",21,6,118,74,8853637,8859881,6244,"20","mask"
"11415",21,5,9,75,8864113,8869324,5211,"20","orth"
"11617",21,1,83,76,8877748,8883645,5897,"0","valid"
"11716",21,2,126,77,8886791,8892775,5984,"0","orth"
"11816",21,4,56,78,8896188,8902672,6484,"20","valid"
"11912",21,4,74,79,8907144,8911788,4644,"20","valid"
"12016",21,4,50,80,8914921,8918706,3785,"20","valid"
"12218",21,4,2,81,8926283,8930808,4525,"20","valid"
"12416",21,4,68,82,8938665,8944223,5558,"20","valid"
"12512",21,1,11,83,8947362,8952940,5578,"0","valid"
"12713",21,5,57,84,8961037,8968368,7331,"20","orth"
"12814",21,1,47,85,8972753,8976684,3931,"0","valid"
"13012",21,3,85,86,8983548,8989566,6018,"0","mask"
"13118",21,5,51,87,8992872,8998303,5431,"20","orth"
"13314",21,1,29,88,9005121,9010119,4998,"0","valid"
"13512",21,1,107,89,9018029,9023294,5265,"0","valid"
"13614",21,6,22,90,9026553,9032550,5997,"20","mask"
"13813",21,2,60,91,9039815,9044679,4864,"0","orth"
"13913",21,6,52,92,9047958,9052403,4445,"20","mask"
"14120",21,5,69,93,9059267,9063766,4499,"20","orth"
"14216",21,3,73,94,9066771,9071163,4392,"0","mask"
"14317",21,3,121,95,9074555,9080633,6078,"0","mask"
"14413",21,4,110,96,9084978,9088523,3545,"20","valid"
"14512",21,4,62,97,9091849,9095527,3678,"20","valid"
"14617",21,2,48,98,9098360,9100812,2452,"0","orth"
"14812",21,4,80,99,9108023,9113540,5517,"20","valid"
"14919",21,6,94,100,9116866,9122797,5931,"20","mask"
"15014",21,4,44,101,9125850,9129448,3598,"20","valid"
"15217",21,5,27,102,9136146,9140004,3858,"20","orth"
"15415",21,3,133,103,9146389,9150527,4138,"0","mask"
"15515",21,1,17,104,9153613,9158351,4738,"0","valid"
"15717",21,4,128,105,9165835,9172245,6410,"20","valid"
"15813",21,6,124,106,9176071,9183728,7657,"20","mask"
"15916",21,5,105,107,9187360,9192398,5038,"20","orth"
"16017",21,1,89,108,9195810,9202921,7111,"0","valid"
"16119",21,5,33,109,9206193,9212704,6511,"20","orth"
"16320",21,2,42,110,9219548,9223087,3539,"0","orth"
"16517",21,5,99,111,9230478,9235196,4718,"20","orth"
"1669",21,1,113,112,9237968,9241633,3665,"0","valid"
"16718",21,5,15,113,9244719,9247991,3272,"20","orth"
"16917",21,1,101,114,9254835,9258947,4112,"0","valid"
"17015",21,5,135,115,9262026,9267757,5731,"20","orth"
"17119",21,4,134,116,9270743,9275554,4811,"20","valid"
"17213",21,5,81,117,9278727,9283564,4837,"20","orth"
"17315",21,5,39,118,9286610,9290988,4378,"20","orth"
"17515",21,3,1,119,9297646,9301105,3459,"0","mask"
"17711",21,1,131,120,9307656,9312354,4698,"0","valid"
"17815",21,4,116,121,9315419,9320184,4765,"20","valid"
"17915",21,3,109,122,9324070,9331187,7117,"0","mask"
"18015",21,3,127,123,9334239,9338531,4292,"0","mask"
"18120",21,6,136,124,9341537,9347714,6177,"20","mask"
"18215",21,2,54,125,9350733,9355018,4285,"0","orth"
"18414",21,3,31,126,9364421,9371225,6804,"0","mask"
"18614",21,3,25,127,9377737,9384634,6897,"0","mask"
"18814",21,3,49,128,9391365,9396336,4971,"0","mask"
"19015",21,3,19,129,9402314,9407112,4798,"0","mask"
"19218",21,1,71,130,9416475,9419648,3173,"0","valid"
"19313",21,2,6,131,9423493,9428824,5331,"0","orth"
"19512",21,5,117,132,9435808,9439660,3852,"20","orth"
"19615",21,1,65,133,9442839,9447657,4818,"0","valid"
"19714",21,4,104,134,9450849,9456994,6145,"20","valid"
"19815",21,4,86,135,9460306,9464471,4165,"20","valid"
"19916",21,3,115,136,9468190,9473334,5144,"0","mask"
"20015",21,2,66,137,9476667,9481631,4964,"0","orth"
"20116",21,3,61,138,9498019,9504110,6091,"0","mask"
"10101",22,5,92,1,10331611,10335676,4065,"20","orth"
"1170",22,3,78,2,10338542,10341981,3439,"0","mask"
"1270",22,2,89,3,10345079,10348985,3906,"0","orth"
"13101",22,1,58,4,10351770,10354363,2593,"0","valid"
"1490",22,1,28,5,10356882,10359774,2892,"0","valid"
"1670",22,2,47,6,10366491,10368690,2199,"0","orth"
"1890",22,6,9,7,10374895,10378647,3752,"20","mask"
"2022",22,6,63,8,10387683,10390929,3246,"20","mask"
"2117",22,2,125,9,10394248,10397920,3672,"0","orth"
"2216",22,4,133,10,10401119,10405604,4485,"20","valid"
"2313",22,4,49,11,10408769,10412728,3959,"20","valid"
"2515",22,4,103,12,10418852,10423117,4265,"20","valid"
"2619",22,4,31,13,10426703,10431134,4431,"20","valid"
"2816",22,2,107,14,10439665,10443250,3585,"0","orth"
"2915",22,4,109,15,10446602,10452480,5878,"20","valid"
"3017",22,6,57,16,10455992,10459784,3792,"20","mask"
"3113",22,5,98,17,10462916,10467121,4205,"20","orth"
"3216",22,6,39,18,10470267,10475031,4764,"20","mask"
"3415",22,4,19,19,10480656,10483975,3319,"20","valid"
"3616",22,1,106,20,10491685,10494311,2626,"0","valid"
"3711",22,3,24,21,10497090,10500042,2952,"0","mask"
"3916",22,3,138,22,10507093,10511031,3938,"0","mask"
"4015",22,5,80,23,10514217,10517809,3592,"20","orth"
"4117",22,3,12,24,10521001,10524500,3499,"0","mask"
"4316",22,3,54,25,10532463,10535222,2759,"0","mask"
"4512",22,2,17,26,10541433,10545199,3766,"0","orth"
"4711",22,5,74,27,10550930,10555455,4525,"20","orth"
"4817",22,6,51,28,10558667,10562253,3586,"20","mask"
"5016",22,2,65,29,10568377,10571289,2912,"0","orth"
"5112",22,2,119,30,10574695,10578087,3392,"0","orth"
"5216",22,5,122,31,10581026,10583718,2692,"20","orth"
"5316",22,6,69,32,10587443,10590556,3113,"20","mask"
"5416",22,5,62,33,10594920,10598752,3832,"20","orth"
"5517",22,1,124,34,10603258,10606776,3518,"0","valid"
"5613",22,4,67,35,10609895,10612867,2972,"20","valid"
"5715",22,5,68,36,10615700,10619278,3578,"20","orth"
"5815",22,2,41,37,10622130,10624923,2793,"0","orth"
"6015",22,1,64,38,10631574,10634746,3172,"0","valid"
"6115",22,3,108,39,10637938,10640364,2426,"0","mask"
"6219",22,3,18,40,10643303,10645862,2559,"0","mask"
"6417",22,5,14,41,10653199,10656917,3718,"20","orth"
"6615",22,4,91,42,10663442,10666961,3519,"20","valid"
"6714",22,5,26,43,10669779,10673731,3952,"20","orth"
"6916",22,6,105,44,10681768,10684881,3113,"20","mask"
"7017",22,1,76,45,10687793,10690538,2745,"0","valid"
"7115",22,3,66,46,10693464,10696883,3419,"0","mask"
"7215",22,3,126,47,10700148,10704367,4219,"0","mask"
"7312",22,2,59,48,10707379,10710784,3405,"0","orth"
"7415",22,3,72,49,10713950,10717202,3252,"0","mask"
"7516",22,5,128,50,10720941,10725326,4385,"20","orth"
"7616",22,2,71,51,10728211,10730330,2119,"0","orth"
"7713",22,6,27,52,10733456,10737688,4232,"20","mask"
"7916",22,5,116,53,10743592,10747910,4318,"20","orth"
"8015",22,5,104,54,10752183,10756814,4631,"20","orth"
"8115",22,6,75,55,10762012,10766237,4225,"20","mask"
"8216",22,1,94,56,10770023,10773661,3638,"0","valid"
"8316",22,1,52,57,10776960,10779092,2132,"0","valid"
"8513",22,2,95,58,10785483,10788529,3046,"0","orth"
"8618",22,5,44,59,10791415,10793827,2412,"20","orth"
"8817",22,2,137,60,10799391,10802577,3186,"0","orth"
"8912",22,4,121,61,10805343,10808195,2852,"20","valid"
"9013",22,3,36,62,10811187,10814087,2900,"0","mask"
"9217",22,1,70,63,10820277,10823590,3313,"0","valid"
"9315",22,6,81,64,10826808,10831040,4232,"20","mask"
"9415",22,3,42,65,10833859,10836644,2785,"0","mask"
"9614",22,6,45,66,11042722,11045601,2879,"20","mask"
"9816",22,4,115,67,11051339,11054531,3192,"20","valid"
"9914",22,5,134,68,11057750,11060849,3099,"20","orth"
"10019",22,4,61,69,11064001,11067699,3698,"20","valid"
"10117",22,5,8,70,11070978,11074077,3099,"20","orth"
"10316",22,6,117,71,11080182,11082534,2352,"20","mask"
"10415",22,1,82,72,11085739,11087898,2159,"0","valid"
"10512",22,4,85,73,11090778,11094416,3638,"20","valid"
"10615",22,4,73,74,11097415,11101700,4285,"20","valid"
"10715",22,2,35,75,11108451,11111230,2779,"0","orth"
"10913",22,5,2,76,11117661,11121120,3459,"20","orth"
"11117",22,4,79,77,11127857,11131576,3719,"20","valid"
"11218",22,4,25,78,11135268,11138700,3432,"20","valid"
"11416",22,2,23,79,11144511,11146950,2439,"0","orth"
"11618",22,1,88,80,11153341,11156080,2739,"0","valid"
"11717",22,5,32,81,11159125,11162431,3306,"20","orth"
"11913",22,6,93,82,11168635,11171754,3119,"20","mask"
"12017",22,2,53,83,11174487,11177299,2812,"0","orth"
"12219",22,1,112,84,11182817,11184916,2099,"0","valid"
"12314",22,2,11,85,11187962,11190087,2125,"0","orth"
"12513",22,1,118,86,11196045,11198398,2353,"0","valid"
"12613",22,3,120,87,11201270,11204495,3225,"0","mask"
"12714",22,1,34,88,11207221,11210513,3292,"0","valid"
"12918",22,5,56,89,11217530,11221109,3579,"20","orth"
"13013",22,1,10,90,11224002,11226520,2518,"0","valid"
"13218",22,2,83,91,11233492,11236223,2731,"0","orth"
"13315",22,1,130,92,11239336,11242874,3538,"0","valid"
"13415",22,3,90,93,11245794,11249386,3592,"0","mask"
"13513",22,1,16,94,11252445,11255003,2558,"0","valid"
"13712",22,5,110,95,11261068,11264193,3125,"20","orth"
"13814",22,2,131,96,11267712,11269798,2086,"0","orth"
"13914",22,4,97,97,11272663,11275602,2939,"20","valid"
"14015",22,3,84,98,11278488,11281913,3425,"0","mask"
"14121",22,1,22,99,11285192,11287971,2779,"0","valid"
"14318",22,1,100,100,11294422,11296948,2526,"0","valid"
"14414",22,4,43,101,11299793,11302412,2619,"20","valid"
"14618",22,6,21,102,11308643,11311282,2639,"20","mask"
"14813",22,3,30,103,11317487,11320413,2926,"0","mask"
"15015",22,5,86,104,11325851,11329083,3232,"20","orth"
"15118",22,2,5,105,11333688,11336353,2665,"0","orth"
"15314",22,6,3,106,11342984,11346476,3492,"20","mask"
"15516",22,5,20,107,11352281,11355146,2865,"20","orth"
"15718",22,6,123,108,11361198,11364536,3338,"20","mask"
"15814",22,3,96,109,11367669,11370407,2738,"0","mask"
"15917",22,1,40,110,11373406,11376279,2873,"0","valid"
"16120",22,3,114,111,11383602,11387814,4212,"0","mask"
"16212",22,5,50,112,11390746,11393932,3186,"20","orth"
"16413",22,5,38,113,11399490,11403182,3692,"20","orth"
"16610",22,4,13,114,11409266,11412459,3193,"20","valid"
"16816",22,4,37,115,11418083,11421515,3432,"20","valid"
"17016",22,4,1,116,11427646,11430552,2906,"20","valid"
"17214",22,3,6,117,11436843,11439602,2759,"0","mask"
"17411",22,6,111,118,11447066,11450025,2959,"20","mask"
"17516",22,6,129,119,11452710,11458188,5478,"20","mask"
"17616",22,2,77,120,11462207,11464493,2286,"0","orth"
"17712",22,1,136,121,11469164,11472649,3485,"0","valid"
"17816",22,3,48,122,11475315,11477101,1786,"0","mask"
"18016",22,1,4,123,11482972,11485378,2406,"0","valid"
"18216",22,2,29,124,11491249,11494308,3059,"0","orth"
"18415",22,6,33,125,11500039,11503412,3373,"20","mask"
"18615",22,2,101,126,11509243,11512315,3072,"0","orth"
"18715",22,4,127,127,11515007,11518380,3373,"20","valid"
"18815",22,4,7,128,11521392,11524171,2779,"20","valid"
"19016",22,6,15,129,11529915,11532501,2586,"20","mask"
"19219",22,4,55,130,11537872,11540251,2379,"20","valid"
"19314",22,6,99,131,11543177,11546209,3032,"20","mask"
"19414",22,6,87,132,11549861,11552967,3106,"20","mask"
"19513",22,2,113,133,11555626,11558085,2459,"0","orth"
"19616",22,3,60,134,11561004,11563809,2805,"0","mask"
"19715",22,3,102,135,11566708,11569380,2672,"0","mask"
"19816",22,6,135,136,11572553,11577684,5131,"20","mask"
"19917",22,3,132,137,11581436,11584755,3319,"0","mask"
"20016",22,1,46,138,11588380,11591193,2813,"0","valid"
"10102",23,4,24,1,12443165,12447723,4558,"20","valid"
"1280",23,5,19,2,12453188,12457033,3845,"20","orth"
"14100",23,3,101,3,12463504,12467116,3612,"0","mask"
"1580",23,1,3,4,12470315,12473407,3092,"0","valid"
"1780",23,2,4,5,12479738,12482597,2859,"0","orth"
"1980",23,3,125,6,12487828,12493626,5798,"0","mask"
"2023",23,4,138,7,12497045,12501230,4185,"20","valid"
"2118",23,6,86,8,12504462,12508168,3706,"20","mask"
"2217",23,2,118,9,12511327,12515045,3718,"0","orth"
"2314",23,5,91,10,12518110,12522149,4039,"20","orth"
"2419",23,4,120,11,12525281,12530493,5212,"20","valid"
"2516",23,6,80,12,12533418,12536584,3166,"20","mask"
"2620",23,2,136,13,12539436,12543028,3592,"0","orth"
"2714",23,6,26,14,12545787,12549172,3385,"20","mask"
"2916",23,2,106,15,12555397,12557916,2519,"0","orth"
"3018",23,3,59,16,12561161,12565060,3899,"0","mask"
"3114",23,2,16,17,12568145,12571231,3086,"0","orth"
"3316",23,3,71,18,12577109,12580141,3032,"0","mask"
"3416",23,5,73,19,12583033,12587845,4812,"20","orth"
"3515",23,4,90,20,12590970,12594183,3213,"20","valid"
"3617",23,1,9,21,12597295,12601746,4451,"0","valid"
"3815",23,4,42,22,12607531,12611230,3699,"20","valid"
"4016",23,1,111,23,12616921,12619980,3059,"0","valid"
"4118",23,2,88,24,12622905,12626651,3746,"0","orth"
"4214",23,2,112,25,12629563,12634294,4731,"0","orth"
"4317",23,4,132,26,12637300,12642998,5698,"20","valid"
"4415",23,4,48,27,12645703,12647902,2199,"20","valid"
"4616",23,6,92,28,12654727,12661591,6864,"20","mask"
"4712",23,5,79,29,12665036,12667882,2846,"20","orth"
"4818",23,4,30,30,12670727,12673806,3079,"20","valid"
"5017",23,6,44,31,12679671,12681897,2226,"20","mask"
"5217",23,2,94,32,12688168,12691826,3658,"0","orth"
"5317",23,4,102,33,12695218,12703415,8197,"20","valid"
"5417",23,6,110,34,12706168,12709647,3479,"20","mask"
"5518",23,4,12,35,12712632,12715058,2426,"20","valid"
"5716",23,3,83,36,12720903,12729186,8283,"0","mask"
"5816",23,1,21,37,12731865,12734710,2845,"0","valid"
"6016",23,1,27,38,12740549,12743814,3265,"0","valid"
"6220",23,5,109,39,12749492,12757902,8410,"20","orth"
"6315",23,6,14,40,12760921,12764533,3612,"20","mask"
"6517",23,2,130,41,12771217,12775329,4112,"0","orth"
"6616",23,2,34,42,12778435,12781640,3205,"0","orth"
"6815",23,5,85,43,12787778,12791583,3805,"20","orth"
"6917",23,3,35,44,12794935,12797407,2472,"0","mask"
"7116",23,6,32,45,12804112,12808497,4385,"20","mask"
"7313",23,6,38,46,12814261,12818793,4532,"20","mask"
"7517",23,6,68,47,12824758,12833201,8443,"20","mask"
"7617",23,6,98,48,12836493,12841125,4632,"20","mask"
"7714",23,3,113,49,12844177,12849335,5158,"0","mask"
"7816",23,2,28,50,12852361,12854926,2565,"0","orth"
"8016",23,1,87,51,12860977,12864343,3366,"0","valid"
"8116",23,1,99,52,12868141,12871853,3712,"0","valid"
"8217",23,3,47,53,12875192,12879710,4518,"0","mask"
"8413",23,3,131,54,12885508,12887887,2379,"0","mask"
"8514",23,4,72,55,12890680,12898263,7583,"20","valid"
"8619",23,2,40,56,12901416,12905161,3745,"0","orth"
"8818",23,3,77,57,12912165,12914691,2526,"0","mask"
"8913",23,1,75,58,12917776,12921155,3379,"0","valid"
"9014",23,3,29,59,12924107,12928632,4525,"0","mask"
"9218",23,2,58,60,12934890,12939242,4352,"0","orth"
"9316",23,2,70,61,12942600,12947519,4919,"0","orth"
"9416",23,3,119,62,12951011,12956828,5817,"0","mask"
"9515",23,1,15,63,12959641,12962020,2379,"0","valid"
"9713",23,2,10,64,12968324,12971257,2933,"0","orth"
"9915",23,1,39,65,12977155,12979087,1932,"0","valid"
"10118",23,3,11,66,13180473,13183418,2945,"0","mask"
"10317",23,1,69,67,13189076,13191875,2799,"0","valid"
"10416",23,4,84,68,13194501,13199919,5418,"20","valid"
"10513",23,6,104,69,13203118,13210908,7790,"20","mask"
"10616",23,3,95,70,13214367,13217932,3565,"0","mask"
"10716",23,6,50,71,13221245,13224443,3198,"20","mask"
"10914",23,1,93,72,13230881,13233133,2252,"0","valid"
"11013",23,4,126,73,13235992,13242510,6518,"20","valid"
"11118",23,6,128,74,13245742,13255425,9683,"20","mask"
"11219",23,1,63,75,13258537,13262769,4232,"0","valid"
"11313",23,5,67,76,13265808,13269906,4098,"20","orth"
"11417",23,3,53,77,13273112,13276477,3365,"0","mask"
"11619",23,3,137,78,13281902,13285521,3619,"0","mask"
"11718",23,4,54,79,13289092,13291658,2566,"20","valid"
"11914",23,2,76,80,13298223,13302801,4578,"0","orth"
"12018",23,5,43,81,13307033,13310278,3245,"20","orth"
"12220",23,6,62,82,13315529,13319515,3986,"20","mask"
"12315",23,2,46,83,13322660,13326625,3965,"0","orth"
"12514",23,5,37,84,13333956,13340380,6424,"20","orth"
"12715",23,6,2,85,13346731,13353742,7011,"20","mask"
"12919",23,3,65,86,13360113,13362192,2079,"0","mask"
"13014",23,3,107,87,13365118,13368010,2892,"0","mask"
"13119",23,5,49,88,13371316,13374508,3192,"20","orth"
"13316",23,1,51,89,13379486,13382805,3319,"0","valid"
"13514",23,5,25,90,13387823,13391362,3539,"20","orth"
"13713",23,6,74,91,13396640,13400358,3718,"20","mask"
"13815",23,5,97,92,13403631,13406969,3338,"20","orth"
"13915",23,5,55,93,13410008,13412034,2026,"20","orth"
"14016",23,4,6,94,13414766,13419384,4618,"20","valid"
"14217",23,3,89,95,13425835,13429507,3672,"0","mask"
"14319",23,6,134,96,13432626,13435692,3066,"20","mask"
"14415",23,6,20,97,13438851,13447341,8490,"20","mask"
"14619",23,1,117,98,13453705,13455791,2086,"0","valid"
"14714",23,2,52,99,13458630,13461489,2859,"0","orth"
"14920",23,6,122,100,13467054,13470092,3038,"20","mask"
"15016",23,4,66,101,13473805,13477063,3258,"20","valid"
"15119",23,5,103,102,13481169,13484200,3031,"20","orth"
"15218",23,6,116,103,13487153,13491458,4305,"20","mask"
"15315",23,5,133,104,13494623,13497982,3359,"20","orth"
"15416",23,3,41,105,13500861,13506279,5418,"0","mask"
"15615",23,1,81,106,13512050,13514289,2239,"0","valid"
"15719",23,1,105,107,13516115,13518201,2086,"0","valid"
"15815",23,4,114,108,13520907,13525985,5078,"20","valid"
"15918",23,5,61,109,13529284,13532310,3026,"20","orth"
"16018",23,4,18,110,13535042,13538520,3478,"20","valid"
"16213",23,4,78,111,13543619,13545724,2105,"20","valid"
"16321",23,2,64,112,13549890,13553581,3691,"0","orth"
"16414",23,5,1,113,13557654,13565077,7423,"20","orth"
"16611",23,1,123,114,13574041,13578252,4211,"0","valid"
"16719",23,5,127,115,13581578,13584250,2672,"20","orth"
"16817",23,4,108,116,13587149,13591294,4145,"20","valid"
"16918",23,4,60,117,13594760,13599858,5098,"20","valid"
"17017",23,1,135,118,13602990,13606262,3272,"0","valid"
"17120",23,6,56,119,13610241,13615252,5011,"20","mask"
"17215",23,2,124,120,13618351,13621203,2852,"0","orth"
"17316",23,1,57,121,13624075,13627601,3526,"0","valid"
"17412",23,1,129,122,13630926,13636764,5838,"0","valid"
"17517",23,5,31,123,13640223,13644728,4505,"20","orth"
"17713",23,3,5,124,13650299,13653118,2819,"0","mask"
"17916",23,3,17,125,13659116,13664054,4938,"0","mask"
"18121",23,3,23,126,13670479,13673637,3158,"0","mask"
"18313",23,2,22,127,13679042,13686326,7284,"0","orth"
"18512",23,5,13,128,13692797,13697095,4298,"20","orth"
"18716",23,2,100,129,13702127,13706678,4551,"0","orth"
"18816",23,5,121,130,13709544,13714342,4798,"20","orth"
"18915",23,6,8,131,13717668,13720747,3079,"20","mask"
"19120",23,4,96,132,13737734,13741399,3665,"20","valid"
"19220",23,4,36,133,13744505,13746857,2352,"20","valid"
"19415",23,2,82,134,13752775,13755947,3172,"0","orth"
"19514",23,1,33,135,13759339,13762771,3432,"0","valid"
"19716",23,1,45,136,13768589,13771508,2919,"0","valid"
"19918",23,5,115,137,13777379,13780218,2839,"20","orth"
"20017",23,5,7,138,13783137,13786729,3592,"20","orth"
"10103",24,4,47,1,15139663,15142556,2893,"20","valid"
"1290",24,5,90,2,15148114,15152605,4491,"20","orth"
"13102",24,3,100,3,15155444,15159323,3879,"0","mask"
"14101",24,4,53,4,15162275,15166054,3779,"20","valid"
"1680",24,6,97,5,15171825,15174537,2712,"20","mask"
"1790",24,6,55,6,15177376,15179382,2006,"20","mask"
"18100",24,1,44,7,15182567,15184880,2313,"0","valid"
"2024",24,6,73,8,15191524,15195749,4225,"20","mask"
"2119",24,1,68,9,15199321,15202473,3152,"0","valid"
"2218",24,6,37,10,15205386,15208251,2865,"20","mask"
"2420",24,2,105,11,15213716,15217135,3419,"0","orth"
"2517",24,5,78,12,15220793,15222792,1999,"20","orth"
"2621",24,6,31,13,15225925,15229877,3952,"20","mask"
"2817",24,4,11,14,15235615,15237694,2079,"20","valid"
"3019",24,6,61,15,15244585,15247257,2672,"20","mask"
"3115",24,2,93,16,15250469,15252895,2426,"0","orth"
"3217",24,1,2,17,15256007,15259999,3992,"0","valid"
"3417",24,1,122,18,15266177,15270655,4478,"0","valid"
"3516",24,4,131,19,15273927,15277266,3339,"20","valid"
"3618",24,4,113,20,15280118,15282004,1886,"20","valid"
"3712",24,1,8,21,15285183,15290528,5345,"0","valid"
"3917",24,2,75,22,15297158,15300491,3333,"0","orth"
"4017",24,6,7,23,15303843,15306175,2332,"20","mask"
"4215",24,3,106,24,15312386,15314632,2246,"0","mask"
"4318",24,4,89,25,15318171,15320450,2279,"20","valid"
"4416",24,1,92,26,15323682,15327301,3619,"0","valid"
"4513",24,2,45,27,15331213,15333478,2265,"0","orth"
"4713",24,3,94,28,15339816,15343215,3399,"0","mask"
"4819",24,3,124,29,15346154,15349672,3518,"0","mask"
"4913",24,1,104,30,15352572,15355857,3285,"0","valid"
"5018",24,6,91,31,15358836,15361295,2459,"20","mask"
"5113",24,5,96,32,15364121,15367892,3771,"20","orth"
"5218",24,1,98,33,15371164,15376836,5672,"0","valid"
"5318",24,1,134,34,15380275,15383307,3032,"0","valid"
"5418",24,6,115,35,15386872,15389598,2726,"20","mask"
"5519",24,3,112,36,15392483,15396848,4365,"0","mask"
"5614",24,4,95,37,15399954,15403479,3525,"20","valid"
"5717",24,4,17,38,15407465,15410817,3352,"20","valid"
"5918",24,3,16,39,15417701,15422219,4518,"0","mask"
"6116",24,3,58,40,15427710,15431855,4145,"0","mask"
"6221",24,2,15,41,15435001,15437926,2925,"0","orth"
"6418",24,1,128,42,15445324,15450422,5098,"0","valid"
"6518",24,4,83,43,15453387,15457512,4125,"20","valid"
"6617",24,3,88,44,15460598,15463130,2532,"0","mask"
"6715",24,2,51,45,15468335,15471474,3139,"0","orth"
"6918",24,2,99,46,15477365,15482017,4652,"0","orth"
"7018",24,6,103,47,15485662,15488474,2812,"20","mask"
"7117",24,5,30,48,15491327,15493666,2339,"20","orth"
"7314",24,5,108,49,15498877,15502203,3326,"20","orth"
"7416",24,5,54,50,15505295,15507794,2499,"20","orth"
"7618",24,6,85,51,15515731,15519436,3705,"20","mask"
"7715",24,5,36,52,15522942,15525447,2505,"20","orth"
"7917",24,1,56,53,15530952,15535111,4159,"0","valid"
"8017",24,3,136,54,15538516,15541215,2699,"0","mask"
"8117",24,1,80,55,15544474,15548566,4092,"0","valid"
"8218",24,2,135,56,15553144,15555636,2492,"0","orth"
"8317",24,6,13,57,15559801,15564873,5072,"20","mask"
"8515",24,5,138,58,15570611,15573403,2792,"20","orth"
"8620",24,3,40,59,15576362,15579615,3253,"0","mask"
"8819",24,5,72,60,15585425,15587798,2373,"20","orth"
"8914",24,4,137,61,15590464,15594609,4145,"20","valid"
"9015",24,5,102,62,15598108,15601266,3158,"20","orth"
"9116",24,2,123,63,15604372,15609803,5431,"0","orth"
"9219",24,2,129,64,15612609,15617687,5078,"0","orth"
"9317",24,2,21,65,15620519,15624671,4152,"0","orth"
"9516",24,2,3,66,15669041,15672706,3665,"0","orth"
"9714",24,3,28,67,15678531,15682976,4445,"0","mask"
"9916",24,5,114,68,15688568,15696897,8329,"20","orth"
"10020",24,4,125,69,15699903,15703209,3306,"20","valid"
"10119",24,3,130,70,15706387,15709226,2839,"0","mask"
"10217",24,5,84,71,15712292,15714478,2186,"20","orth"
"10318",24,2,39,72,15717850,15720169,2319,"0","orth"
"10514",24,5,6,73,15726846,15731825,4979,"20","orth"
"10717",24,4,59,74,15737276,15740315,3039,"20","valid"
"10816",24,1,110,75,15743707,15747032,3325,"0","valid"
"10915",24,5,12,76,15750038,15752117,2079,"20","orth"
"11119",24,5,132,77,15757928,15761041,3113,"20","orth"
"11220",24,1,14,78,15764373,15767365,2992,"0","valid"
"11418",24,2,111,79,15773629,15777088,3459,"0","orth"
"11512",24,3,10,80,15780120,15782612,2492,"0","mask"
"11719",24,2,63,81,15788331,15790216,1885,"0","orth"
"11817",24,4,29,82,15793775,15795941,2166,"20","valid"
"12019",24,1,116,83,15802306,15806444,4138,"0","valid"
"12117",24,4,35,84,15811309,15813361,2052,"20","valid"
"12316",24,6,1,85,15819706,15822065,2359,"20","mask"
"12515",24,4,41,86,15827130,15831554,4424,"20","valid"
"12716",24,4,77,87,15837059,15840618,3559,"20","valid"
"12815",24,4,107,88,15844223,15846622,2399,"20","valid"
"12920",24,5,42,89,15849448,15853026,3578,"20","orth"
"13120",24,4,23,90,15859198,15860784,1586,"20","valid"
"13317",24,4,101,91,15867155,15870240,3085,"20","valid"
"13416",24,2,33,92,15873153,15876805,3652,"0","orth"
"13615",24,1,74,93,15884222,15890832,6610,"0","valid"
"13714",24,2,117,94,15893825,15896171,2346,"0","orth"
"13816",24,6,19,95,15899070,15904441,5371,"20","mask"
"14017",24,5,18,96,15912338,15914950,2612,"20","orth"
"14218",24,6,109,97,15919955,15922747,2792,"20","mask"
"14320",24,5,24,98,15925506,15928685,3179,"20","orth"
"14513",24,5,120,99,15934503,15936422,1919,"20","orth"
"14620",24,2,57,100,15939301,15941907,2606,"0","orth"
"14715",24,3,64,101,15944866,15947158,2292,"0","mask"
"14814",24,6,43,102,15950671,15953903,3232,"20","mask"
"15017",24,1,62,103,15959041,15961766,2725,"0","valid"
"15120",24,3,52,104,15964972,15967711,2739,"0","mask"
"15316",24,4,65,105,15974668,15976481,1813,"20","valid"
"15417",24,5,126,106,15979346,15983991,4645,"20","orth"
"15517",24,1,20,107,15987437,15992408,4971,"0","valid"
"15720",24,4,5,108,16000132,16002624,2492,"20","valid"
"15919",24,5,60,109,16009709,16012661,2952,"20","orth"
"16019",24,3,34,110,16015733,16018879,3146,"0","mask"
"16214",24,6,49,111,16025477,16028502,3025,"20","mask"
"16415",24,6,67,112,16035440,16037379,1939,"20","mask"
"16518",24,1,50,113,16040731,16043190,2459,"0","valid"
"16720",24,4,71,114,16048522,16050527,2005,"20","valid"
"16818",24,3,4,115,16053539,16055598,2059,"0","mask"
"17018",24,6,133,116,16060723,16063689,2966,"20","mask"
"17121",24,3,82,117,16066914,16069247,2333,"0","mask"
"17216",24,6,79,118,16072226,16074525,2299,"20","mask"
"17317",24,6,25,119,16078457,16081522,3065,"20","mask"
"17518",24,1,26,120,16087580,16090172,2592,"0","valid"
"17714",24,2,87,121,16095837,16102215,6378,"0","orth"
"17817",24,2,81,122,16104994,16107439,2445,"0","orth"
"17917",24,4,119,123,16110498,16113437,2939,"20","valid"
"18017",24,3,46,124,16117129,16119641,2512,"0","mask"
"18217",24,1,32,125,16125126,16130137,5011,"0","valid"
"18416",24,3,118,126,16136475,16138421,1946,"0","mask"
"18513",24,2,9,127,16141980,16144592,2612,"0","orth"
"18717",24,3,22,128,16150797,16155455,4658,"0","mask"
"18916",24,1,38,129,16161239,16165551,4312,"0","valid"
"19121",24,6,121,130,16170936,16175254,4318,"20","mask"
"19221",24,3,76,131,16179366,16183538,4172,"0","mask"
"19315",24,5,48,132,16186224,16187623,1399,"20","orth"
"19515",24,3,70,133,16194127,16197226,3099,"0","mask"
"19617",24,2,27,134,16200379,16202864,2485,"0","orth"
"19817",24,1,86,135,16208369,16210628,2259,"0","valid"
"19919",24,6,127,136,16213867,16217125,3258,"20","mask"
"20018",24,5,66,137,16220224,16223790,3566,"20","orth"
"20117",24,2,69,138,16227828,16229934,2106,"0","orth"
"10104",25,5,23,1,17751073,17754305,3232,"20","orth"
"12100",25,4,34,2,17760603,17763801,3198,"20","valid"
"14102",25,2,62,3,17772731,17779955,7224,"0","orth"
"1590",25,2,32,4,17803693,17814462,10769,"0","orth"
"17100",25,5,113,5,17820494,17824372,3878,"20","orth"
"18101",25,3,63,6,17828538,17841140,12602,"0","mask"
"1990",25,4,4,7,17849004,17856374,7370,"20","valid"
"2120",25,2,98,8,17864131,17867177,3046,"0","orth"
"2219",25,2,20,9,17870608,17874594,3986,"0","orth"
"2421",25,5,35,10,17882738,17886463,3725,"20","orth"
"2622",25,3,129,11,17893013,17897132,4119,"0","mask"
"2715",25,1,37,12,17903730,17910920,7190,"0","valid"
"2917",25,1,97,13,17982208,17986579,4371,"0","valid"
"3020",25,4,106,14,17992330,17995982,3652,"20","valid"
"3116",25,4,136,15,18000307,18004452,4145,"20","valid"
"3218",25,5,95,16,18008044,18013429,5385,"20","orth"
"3317",25,2,74,17,18018368,18023665,5297,"0","orth"
"3418",25,1,91,18,18028164,18032442,4278,"0","valid"
"3517",25,3,21,19,18035408,18039220,3812,"0","mask"
"3713",25,4,88,20,18045238,18048130,2892,"20","valid"
"3816",25,2,116,21,18054534,18057213,2679,"0","orth"
"3918",25,5,131,22,18060758,18064251,3493,"20","orth"
"4018",25,2,2,23,18068482,18070515,2033,"0","orth"
"4216",25,6,18,24,18078912,18083437,4525,"20","mask"
"4417",25,1,7,25,18093313,18097211,3898,"0","valid"
"4617",25,6,120,26,18105549,18108408,2859,"20","mask"
"4714",25,4,130,27,18112593,18115865,3272,"20","valid"
"4820",25,6,48,28,18122562,18124661,2099,"20","mask"
"5019",25,5,137,29,18132432,18135084,2652,"20","orth"
"5114",25,6,138,30,18141502,18144634,3132,"20","mask"
"5219",25,1,85,31,18151785,18156963,5178,"0","valid"
"5319",25,2,104,32,18160442,18163594,3152,"0","orth"
"5419",25,5,5,33,18167046,18170138,3092,"20","orth"
"5615",25,6,72,34,18177242,18180081,2839,"20","mask"
"5718",25,1,49,35,18184799,18188251,3452,"0","valid"
"5919",25,5,41,36,18195402,18198581,3179,"20","orth"
"6117",25,4,28,37,18204312,18207058,2746,"20","valid"
"6316",25,2,26,38,18214828,18218280,3452,"0","orth"
"6519",25,1,79,39,18226437,18230729,4292,"0","valid"
"6618",25,5,89,40,18234934,18237713,2779,"20","orth"
"6716",25,3,75,41,18244551,18249209,4658,"0","mask"
"6816",25,1,25,42,18252961,18255067,2106,"0","valid"
"7019",25,5,53,43,18261605,18265356,3751,"20","orth"
"7216",25,3,117,44,18272920,18275699,2779,"0","mask"
"7315",25,5,125,45,18280297,18283996,3699,"20","orth"
"7417",25,4,112,46,18289414,18291520,2106,"20","valid"
"7518",25,6,60,47,18295852,18298784,2932,"20","mask"
"7619",25,5,83,48,18302650,18305568,2918,"20","orth"
"7716",25,3,135,49,18308860,18312625,3765,"0","mask"
"7817",25,2,128,50,18316031,18321982,5951,"0","orth"
"7918",25,6,42,51,18325108,18329139,4031,"20","mask"
"8118",25,4,52,52,18338856,18341808,2952,"20","valid"
"8318",25,3,3,53,18347846,18350591,2745,"0","mask"
"8516",25,5,11,54,18357342,18359935,2593,"20","orth"
"8713",25,5,29,55,18387551,18390263,2712,"20","orth"
"8915",25,6,132,56,18403385,18409103,5718,"20","mask"
"9016",25,5,71,57,18413122,18415481,2359,"20","orth"
"9117",25,4,100,58,18418886,18421565,2679,"20","valid"
"9220",25,3,57,59,18426397,18428696,2299,"0","mask"
"9318",25,3,33,60,18433161,18436026,2865,"0","mask"
"9517",25,4,22,61,18442791,18446982,4191,"20","valid"
"9715",25,3,93,62,18454773,18458358,3585,"0","mask"
"9817",25,4,10,63,18462390,18465756,3366,"20","valid"
"10021",25,4,70,64,18474526,18478997,4471,"20","valid"
"10120",25,2,86,65,18483989,18486401,2412,"0","orth"
"10218",25,3,87,66,18637019,18644123,7104,"0","mask"
"10319",25,2,38,67,18647296,18649921,2625,"0","orth"
"10515",25,1,61,68,18656319,18658511,2192,"0","valid"
"10617",25,1,67,69,18661250,18663682,2432,"0","valid"
"10718",25,3,45,70,18667908,18670860,2952,"0","mask"
"10916",25,1,13,71,18677271,18680916,3645,"0","valid"
"11120",25,3,111,72,18686947,18690260,3313,"0","mask"
"11221",25,6,90,73,18693152,18695751,2599,"20","mask"
"11314",25,6,114,74,18717922,18724733,6811,"20","mask"
"11419",25,1,103,75,18729358,18732030,2672,"0","valid"
"11513",25,3,99,76,18747631,18751497,3866,"0","mask"
"11620",25,4,118,77,18755989,18761440,5451,"20","valid"
"11720",25,4,94,78,18765152,18770083,4931,"20","valid"
"11818",25,4,40,79,18779620,18783578,3958,"20","valid"
"12020",25,2,134,80,18793894,18800012,6118,"0","orth"
"12118",25,3,27,81,18811308,18818692,7384,"0","mask"
"12317",25,3,69,82,18829315,18831860,2545,"0","mask"
"12417",25,5,119,83,18841410,18845362,3952,"20","orth"
"12516",25,5,65,84,18851587,18854865,3278,"20","orth"
"12614",25,6,66,85,18860916,18864642,3726,"20","mask"
"12717",25,4,76,86,18873712,18878150,4438,"20","valid"
"12816",25,6,78,87,18884848,18888526,3678,"20","mask"
"12921",25,2,44,88,18940180,18943299,3119,"0","orth"
"13121",25,1,115,89,18949950,18953249,3299,"0","valid"
"13219",25,2,14,90,18956728,18959607,2879,"0","orth"
"13417",25,6,12,91,18971582,18974461,2879,"20","mask"
"13616",25,4,82,92,18982412,18985157,2745,"20","valid"
"13715",25,6,30,93,18987903,18991155,3252,"20","mask"
"13916",25,4,124,94,18996900,19000038,3138,"20","valid"
"14018",25,4,46,95,19003124,19006636,3512,"20","valid"
"14219",25,3,81,96,19013940,19017645,3705,"0","mask"
"14321",25,5,17,97,19020837,19023743,2906,"20","orth"
"14514",25,6,84,98,19029674,19034779,5105,"20","mask"
"14621",25,6,108,99,19039224,19043096,3872,"20","mask"
"14716",25,1,55,100,19046128,19048334,2206,"0","valid"
"14815",25,3,15,101,19051080,19055818,4738,"0","mask"
"15018",25,3,51,102,19061736,19066227,4491,"0","mask"
"15219",25,6,36,103,19071545,19073658,2113,"20","mask"
"15418",25,1,43,104,19079989,19083655,3666,"0","valid"
"15616",25,5,59,105,19090152,19095970,5818,"20","orth"
"15721",25,4,58,106,19099395,19102454,3059,"20","valid"
"15816",25,1,73,107,19105246,19108585,3339,"0","valid"
"15920",25,2,56,108,19114083,19118448,4365,"0","orth"
"16020",25,4,16,109,19121867,19124506,2639,"20","valid"
"16215",25,6,24,110,19131197,19134522,3325,"20","mask"
"16416",25,2,8,111,19142386,19148004,5618,"0","orth"
"16612",25,6,126,112,19155415,19158946,3531,"20","mask"
"16721",25,6,102,113,19162239,19168183,5944,"20","mask"
"16819",25,2,80,114,19172568,19174661,2093,"0","orth"
"16919",25,1,1,115,19177906,19180785,2879,"0","valid"
"17122",25,5,77,116,19187103,19190421,3318,"20","orth"
"17217",25,1,133,117,19194453,19196813,2360,"0","valid"
"17318",25,5,101,118,19200405,19202797,2392,"20","orth"
"17413",25,2,50,119,19206882,19209947,3065,"0","orth"
"17617",25,3,105,120,19215712,19218791,3079,"0","mask"
"17715",25,1,31,121,19222136,19225455,3319,"0","valid"
"17918",25,1,19,122,19231440,19233465,2025,"0","valid"
"18122",25,3,39,123,19242396,19246014,3618,"0","mask"
"18314",25,1,109,124,19252019,19254191,2172,"0","valid"
"18417",25,1,127,125,19257090,19259383,2293,"0","valid"
"18514",25,2,68,126,19262248,19265381,3133,"0","orth"
"18616",25,5,47,127,19268293,19270985,2692,"20","orth"
"18817",25,4,64,128,19277163,19281588,4425,"20","valid"
"18917",25,5,107,129,19284960,19287999,3039,"20","orth"
"19017",25,3,9,130,19293263,19296329,3066,"0","mask"
"19222",25,1,121,131,19310684,19314089,3405,"0","valid"
"19316",25,6,96,132,19350389,19354514,4125,"20","mask"
"19416",25,2,110,133,19357999,19360392,2393,"0","orth"
"19516",25,3,123,134,19363584,19366364,2780,"0","mask"
"19618",25,6,54,135,19371255,19374140,2885,"20","mask"
"19818",25,2,122,136,19380371,19382990,2619,"0","orth"
"19920",25,2,92,137,19388089,19390214,2125,"0","orth"
"20019",25,6,6,138,19394093,19396792,2699,"20","mask"
"10105",26,5,28,1,934780,939025,4245,"20","orth"
"12101",26,5,88,2,945976,949901,3925,"20","orth"
"13103",26,4,39,3,953353,956052,2699,"20","valid"
"15100",26,1,84,4,961837,965862,4025,"0","valid"
"1690",26,3,2,5,974218,977684,3466,"0","mask"
"18102",26,5,118,6,985101,988060,2959,"20","orth"
"19100",26,1,72,7,994818,997210,2392,"0","valid"
"2025",26,5,46,8,1000609,1004634,4025,"20","orth"
"2220",26,6,41,9,1012711,1016290,3579,"20","mask"
"2422",26,1,6,10,1023374,1026299,2925,"0","valid"
"2623",26,6,125,11,1033843,1036376,2533,"20","mask"
"2716",26,2,19,12,1039994,1043226,3232,"0","orth"
"2918",26,6,23,13,1052616,1055888,3272,"20","mask"
"3117",26,2,7,14,1062646,1067810,5164,"0","orth"
"3318",26,2,61,15,1074941,1077687,2746,"0","orth"
"3419",26,6,5,16,1080992,1083585,2593,"20","mask"
"3619",26,2,79,17,1090756,1093788,3032,"0","orth"
"3714",26,1,66,18,1096780,1099039,2259,"0","valid"
"3817",26,3,122,19,1102158,1104144,1986,"0","mask"
"3919",26,2,55,20,1106843,1109162,2319,"0","orth"
"4019",26,1,96,21,1112714,1115166,2452,"0","valid"
"4119",26,5,40,22,1119198,1122630,3432,"20","orth"
"4319",26,4,105,23,1128648,1131260,2612,"20","valid"
"4418",26,2,91,24,1134739,1138451,3712,"0","orth"
"4514",26,3,68,25,1141383,1144462,3079,"0","mask"
"4618",26,6,137,26,1148281,1151819,3538,"20","mask"
"4715",26,1,54,27,1156025,1158490,2465,"0","valid"
"4914",26,6,59,28,1166207,1169073,2866,"20","mask"
"5020",26,2,109,29,1172432,1176257,3825,"0","orth"
"5115",26,5,58,30,1178976,1181742,2766,"20","orth"
"5220",26,4,3,31,1185107,1188526,3419,"20","valid"
"5420",26,3,98,32,1194897,1199328,4431,"0","mask"
"5520",26,4,57,33,1203607,1207645,4038,"20","valid"
"5616",26,6,83,34,1210924,1214603,3679,"20","mask"
"5719",26,5,124,35,1217802,1221734,3932,"20","orth"
"5817",26,3,14,36,1224706,1229277,4571,"0","mask"
"6017",26,1,42,37,1236148,1240267,4119,"0","valid"
"6222",26,2,85,38,1247251,1250729,3478,"0","orth"
"6317",26,5,16,39,1254088,1257414,3326,"20","orth"
"6520",26,4,123,40,1263645,1266510,2865,"20","valid"
"6619",26,3,104,41,1270122,1272522,2400,"0","mask"
"6717",26,4,75,42,1275853,1280738,4885,"20","valid"
"6817",26,2,49,43,1284237,1287382,3145,"0","orth"
"7020",26,2,31,44,1293074,1295906,2832,"0","orth"
"7217",26,1,120,45,1303003,1306589,3586,"0","valid"
"7316",26,1,114,46,1310447,1315052,4605,"0","valid"
"7418",26,4,111,47,1318471,1321197,2726,"20","valid"
"7519",26,5,130,48,1324509,1328194,3685,"20","orth"
"7620",26,5,136,49,1331253,1335145,3892,"20","orth"
"7717",26,2,103,50,1338137,1342729,4592,"0","orth"
"7818",26,3,8,51,1346920,1349713,2793,"0","mask"
"8018",26,6,71,52,1357903,1360575,2672,"20","mask"
"8119",26,5,64,53,1366420,1369692,3272,"20","orth"
"8219",26,6,101,54,1372804,1376017,3213,"20","mask"
"8319",26,2,25,55,1378816,1382521,3705,"0","orth"
"8517",26,4,63,56,1388758,1391544,2786,"20","valid"
"8621",26,3,56,57,1394563,1397642,3079,"0","mask"
"8714",26,4,15,58,1400481,1402380,1899,"20","valid"
"8916",26,5,10,59,1410017,1412776,2759,"20","orth"
"9118",26,1,60,60,1419374,1423139,3765,"0","valid"
"9221",26,4,87,61,1425971,1429637,3666,"20","valid"
"9319",26,4,93,62,1432656,1435201,2545,"20","valid"
"9417",26,3,44,63,1439127,1440759,1632,"0","mask"
"9615",26,5,34,64,1446883,1449256,2373,"20","orth"
"9818",26,6,65,65,1457073,1459652,2579,"20","mask"
"9917",26,6,119,66,1492933,1496725,3792,"20","mask"
"10022",26,6,95,67,1500044,1503683,3639,"20","mask"
"10121",26,5,4,68,1506735,1509067,2332,"20","orth"
"10320",26,6,29,69,1515565,1519790,4225,"20","mask"
"10516",26,6,107,70,1525861,1528060,2199,"20","mask"
"10618",26,1,78,71,1530759,1533418,2659,"0","valid"
"10719",26,5,82,72,1536457,1541728,5271,"20","orth"
"10817",26,1,102,73,1544441,1547066,2625,"0","valid"
"10917",26,6,47,74,1551065,1554584,3519,"20","mask"
"11121",26,6,89,75,1560242,1563514,3272,"20","mask"
"11222",26,3,32,76,1566353,1569165,2812,"0","mask"
"11420",26,2,133,77,1574950,1577922,2972,"0","orth"
"11514",26,2,13,78,1580860,1584559,3699,"0","orth"
"11721",26,1,138,79,1590697,1593396,2699,"0","valid"
"11819",26,5,106,80,1596082,1598454,2372,"20","orth"
"11915",26,1,36,81,1601073,1603052,1979,"0","valid"
"12119",26,3,116,82,1609364,1612202,2838,"0","mask"
"12221",26,4,135,83,1615355,1617700,2345,"20","valid"
"12318",26,5,76,84,1620566,1624205,3639,"20","orth"
"12418",26,3,74,85,1627330,1631369,4039,"0","mask"
"12517",26,1,48,86,1634068,1636693,2625,"0","valid"
"12718",26,4,27,87,1643677,1647489,3812,"20","valid"
"12922",26,5,94,88,1653374,1656359,2985,"20","orth"
"13015",26,4,21,89,1659332,1663956,4624,"20","valid"
"13220",26,4,9,90,1670494,1673487,2993,"20","valid"
"13418",26,3,38,91,1679578,1681637,2059,"0","mask"
"13617",26,3,92,92,1687175,1691206,4031,"0","mask"
"13716",26,4,69,93,1695299,1697058,1759,"20","valid"
"13817",26,1,108,94,1700117,1702216,2099,"0","valid"
"13917",26,5,52,95,1705348,1707740,2392,"20","orth"
"14122",26,4,51,96,1713871,1716531,2660,"20","valid"
"14322",26,2,67,97,1724214,1726160,1946,"0","orth"
"14416",26,5,112,98,1728999,1731325,2326,"20","orth"
"14515",26,4,45,99,1733997,1736176,2179,"20","valid"
"14717",26,4,99,100,1742214,1747686,5472,"20","valid"
"14816",26,3,86,101,1750745,1752657,1912,"0","mask"
"14921",26,2,73,102,1755929,1758408,2479,"0","orth"
"15019",26,1,90,103,1762387,1765139,2752,"0","valid"
"15121",26,6,17,104,1768378,1773263,4885,"20","mask"
"15317",26,4,129,105,1779361,1782453,3092,"20","valid"
"15419",26,1,18,106,1785098,1787624,2526,"0","valid"
"15617",26,4,33,107,1793135,1796641,3506,"20","valid"
"15817",26,1,30,108,1803758,1806204,2446,"0","valid"
"16021",26,4,117,109,1811629,1814401,2772,"20","valid"
"16121",26,6,11,110,1817646,1820286,2640,"20","mask"
"16322",26,1,12,111,1826310,1829455,3145,"0","valid"
"16519",26,5,22,112,1835487,1839345,3858,"20","orth"
"16722",26,2,37,113,1845156,1847509,2353,"0","orth"
"16920",26,3,26,114,1853713,1855832,2119,"0","mask"
"17123",26,3,62,115,1865696,1868387,2691,"0","mask"
"17218",26,5,100,116,1872126,1874639,2513,"20","orth"
"17319",26,6,53,117,1878704,1881429,2725,"20","mask"
"17519",26,1,24,118,1889313,1891805,2492,"0","valid"
"17716",26,6,77,119,1898630,1901682,3052,"20","mask"
"17818",26,6,131,120,1904781,1907140,2359,"20","mask"
"17919",26,6,113,121,1910026,1912671,2645,"20","mask"
"18018",26,3,110,122,1915657,1917463,1806,"0","mask"
"18123",26,3,50,123,1920995,1924607,3612,"0","mask"
"18315",26,4,81,124,1930631,1933677,3046,"20","valid"
"18418",26,3,134,125,1937482,1940261,2779,"0","mask"
"18515",26,2,97,126,1943253,1946239,2986,"0","orth"
"18617",26,2,115,127,1948958,1951957,2999,"0","orth"
"18718",26,3,20,128,1954776,1957208,2432,"0","mask"
"18918",26,2,127,129,1963799,1966491,2692,"0","orth"
"19018",26,1,126,130,1971989,1975395,3406,"0","valid"
"19122",26,6,35,131,1980834,1983312,2478,"20","mask"
"19317",26,3,128,132,1989483,1991862,2379,"0","mask"
"19417",26,2,1,133,1995294,1997326,2032,"0","orth"
"19619",26,5,70,134,2003811,2006583,2772,"20","orth"
"19717",26,1,132,135,2009842,2012334,2492,"0","valid"
"19819",26,2,121,136,2015227,2017712,2485,"0","orth"
"19921",26,2,43,137,2021205,2023870,2665,"0","orth"
"20118",26,3,80,138,2030194,2035433,5239,"0","mask"
"10106",27,4,56,1,3224900,3229172,4272,"20","valid"
"1180",27,3,133,2,3232611,3235783,3172,"0","mask"
"12102",27,3,49,3,3239262,3242167,2905,"0","mask"
"14103",27,1,47,4,3248418,3250724,2306,"0","valid"
"16100",27,6,58,5,3256968,3260107,3139,"20","mask"
"17101",27,6,64,6,3263006,3265965,2959,"20","mask"
"18103",27,6,28,7,3268711,3272250,3539,"20","mask"
"2026",27,3,7,8,3279467,3282666,3199,"0","mask"
"2221",27,6,40,9,3293409,3297487,4078,"20","mask"
"2423",27,4,110,10,3304265,3308396,4131,"20","valid"
"2518",27,2,48,11,3311242,3314467,3225,"0","orth"
"2717",27,4,8,12,3320892,3325403,4511,"20","valid"
"2919",27,2,132,13,3331541,3336206,4665,"0","orth"
"3021",27,1,107,14,3339172,3341930,2758,"0","valid"
"3118",27,4,128,15,3345016,3349854,4838,"20","valid"
"3219",27,3,13,16,3353080,3357238,4158,"0","mask"
"3420",27,6,10,17,3363309,3366442,3133,"20","mask"
"3620",27,3,37,18,3373072,3378690,5618,"0","mask"
"3818",27,6,130,19,3384741,3389540,4799,"20","mask"
"3920",27,5,45,20,3392778,3396464,3686,"20","orth"
"4120",27,6,88,21,3402535,3406800,4265,"20","mask"
"4217",27,4,44,22,3409759,3413877,4118,"20","valid"
"4419",27,3,67,23,3419555,3422034,2479,"0","mask"
"4515",27,1,29,24,3424560,3427132,2572,"0","valid"
"4716",27,1,119,25,3434343,3437329,2986,"0","valid"
"4821",27,1,59,26,3440747,3444959,4212,"0","valid"
"4915",27,6,46,27,3448125,3451650,3525,"20","mask"
"5116",27,4,2,28,3457641,3461766,4125,"20","valid"
"5320",27,6,118,29,3467837,3472469,4632,"20","mask"
"5421",27,4,104,30,3475428,3480406,4978,"20","valid"
"5521",27,2,42,31,3483625,3487550,3925,"0","orth"
"5720",27,2,72,32,3493361,3495660,2299,"0","orth"
"5818",27,4,98,33,3498546,3502558,4012,"20","valid"
"5920",27,1,65,34,3505910,3508916,3006,"0","valid"
"6018",27,2,126,35,3511934,3516786,4852,"0","orth"
"6118",27,2,108,36,3520198,3524297,4099,"0","orth"
"6223",27,2,6,37,3527236,3531561,4325,"0","orth"
"6419",27,5,9,38,3537945,3541650,3705,"20","orth"
"6620",27,2,54,39,3549321,3553732,4411,"0","orth"
"6818",27,4,74,40,3560310,3563575,3265,"20","valid"
"6919",27,5,129,41,3567021,3570360,3339,"20","orth"
"7021",27,5,63,42,3573205,3575871,2666,"20","orth"
"7118",27,3,31,43,3578810,3583561,4751,"0","mask"
"7317",27,5,27,44,3589626,3592738,3112,"20","orth"
"7520",27,3,121,45,3598049,3600562,2513,"0","mask"
"7621",27,2,60,46,3603781,3607539,3758,"0","orth"
"7718",27,2,90,47,3610851,3614537,3686,"0","orth"
"7819",27,3,85,48,3617989,3620828,2839,"0","mask"
"7919",27,3,25,49,3623713,3626532,2819,"0","mask"
"8120",27,2,114,50,3632297,3636055,3758,"0","orth"
"8220",27,6,136,51,3638995,3641880,2885,"20","mask"
"8320",27,4,116,52,3644992,3648824,3832,"20","valid"
"8414",27,6,124,53,3651703,3654075,2372,"20","mask"
"8518",27,4,122,54,3656714,3658374,1660,"20","valid"
"8622",27,6,94,55,3661180,3664911,3731,"20","mask"
"8715",27,5,135,56,3667784,3670329,2545,"20","orth"
"8820",27,1,77,57,3673482,3676194,2712,"0","valid"
"8917",27,1,41,58,3678966,3681425,2459,"0","valid"
"9119",27,5,111,59,3687370,3690509,3139,"20","orth"
"9222",27,1,101,60,3693701,3696560,2859,"0","valid"
"9320",27,5,21,61,3699499,3701544,2045,"20","orth"
"9518",27,2,66,62,3707616,3709988,2372,"0","orth"
"9616",27,2,84,63,3712740,3714733,1993,"0","orth"
"9716",27,3,91,64,3717779,3719838,2059,"0","mask"
"9819",27,5,3,65,3722743,3725662,2919,"20","orth"
"10023",27,6,34,66,3769786,3772705,2919,"20","mask"
"10219",27,3,43,67,3778996,3781855,2859,"0","mask"
"10417",27,4,86,68,3787440,3789319,1879,"20","valid"
"10517",27,3,127,69,3792038,3794350,2312,"0","mask"
"10619",27,4,32,70,3797236,3800295,3059,"20","valid"
"10818",27,5,81,71,3809052,3811384,2332,"20","orth"
"10918",27,1,95,72,3814430,3816935,2505,"0","valid"
"11014",27,4,134,73,3820487,3823420,2933,"20","valid"
"11122",27,2,36,74,3826452,3828318,1866,"0","orth"
"11315",27,3,109,75,3835842,3838347,2505,"0","mask"
"11421",27,6,4,76,3841440,3844399,2959,"20","mask"
"11621",27,1,113,77,3849970,3851789,1819,"0","valid"
"11722",27,4,68,78,3855088,3858407,3319,"20","valid"
"11820",27,2,102,79,3861452,3864325,2873,"0","orth"
"11916",27,6,106,80,3867164,3869976,2812,"20","mask"
"12021",27,5,123,81,3873101,3876167,3066,"20","orth"
"12120",27,4,26,82,3879252,3882451,3199,"20","valid"
"12319",27,1,5,83,3887843,3890248,2405,"0","valid"
"12518",27,3,73,84,3899145,3903130,3985,"0","mask"
"12615",27,5,93,85,3906669,3908861,2192,"20","orth"
"12719",27,4,14,86,3911714,3917798,6084,"20","valid"
"12923",27,6,70,87,3923476,3927855,4379,"20","mask"
"13016",27,6,16,88,3930927,3933212,2285,"20","mask"
"13221",27,1,17,89,3939823,3944042,4219,"0","valid"
"13419",27,5,39,90,3949453,3951592,2139,"20","orth"
"13618",27,5,33,91,3959143,3961535,2392,"20","orth"
"13818",27,1,53,92,3967780,3971078,3298,"0","valid"
"14019",27,1,35,93,3977410,3980622,3212,"0","valid"
"14220",27,6,22,94,3988112,3992384,4272,"20","mask"
"14417",27,2,78,95,3999108,4000807,1699,"0","orth"
"14516",27,5,75,96,4003633,4006972,3339,"20","orth"
"14622",27,2,120,97,4009838,4012403,2565,"0","orth"
"14718",27,1,11,98,4015242,4017348,2106,"0","valid"
"14922",27,5,57,99,4025798,4028011,2213,"20","orth"
"15020",27,6,52,100,4031290,4033949,2659,"20","mask"
"15220",27,6,76,101,4040613,4043445,2832,"20","mask"
"15318",27,6,100,102,4046191,4049336,3145,"20","mask"
"15420",27,3,19,103,4052735,4055068,2333,"0","mask"
"15618",27,2,12,104,4066157,4070022,3865,"0","orth"
"15818",27,5,69,105,4076100,4077979,1879,"20","orth"
"15921",27,1,131,106,4080985,4084170,3185,"0","valid"
"16022",27,4,38,107,4087029,4089028,1999,"20","valid"
"16216",27,1,71,108,4095046,4097498,2452,"0","valid"
"16323",27,2,24,109,4100518,4105849,5331,"0","orth"
"16520",27,3,103,110,4112846,4116052,3206,"0","mask"
"16613",27,3,1,111,4118771,4123722,4951,"0","mask"
"16820",27,4,92,112,4131060,4135391,4331,"20","valid"
"16921",27,5,87,113,4138764,4142736,3972,"20","orth"
"17019",27,6,112,114,4145634,4148920,3286,"20","mask"
"17124",27,3,55,115,4151732,4154224,2492,"0","mask"
"17219",27,3,97,116,4157317,4160216,2899,"0","mask"
"17320",27,1,89,117,4163101,4165467,2366,"0","valid"
"17414",27,2,30,118,4168299,4170818,2519,"0","orth"
"17618",27,1,137,119,4176516,4180875,4359,"0","valid"
"17717",27,2,138,120,4184140,4186633,2493,"0","orth"
"17819",27,2,18,121,4189505,4191557,2052,"0","orth"
"18019",27,4,20,122,4198215,4200914,2699,"20","valid"
"18218",27,5,117,123,4207272,4210670,3398,"20","orth"
"18316",27,2,96,124,4213696,4216128,2432,"0","orth"
"18419",27,3,61,125,4221007,4223979,2972,"0","mask"
"18516",27,3,115,126,4227084,4231183,4099,"0","mask"
"18618",27,5,51,127,4234268,4236647,2379,"20","orth"
"18818",27,4,50,128,4242999,4247050,4051,"20","valid"
"19019",27,4,80,129,4252961,4255287,2326,"20","valid"
"19123",27,3,79,130,4258213,4260752,2539,"0","mask"
"19223",27,6,82,131,4263624,4265930,2306,"20","mask"
"19318",27,1,125,132,4268775,4271015,2240,"0","valid"
"19418",27,4,62,133,4273814,4275939,2125,"20","valid"
"19517",27,5,15,134,4278732,4280658,1926,"20","orth"
"19718",27,1,23,135,4286523,4289021,2498,"0","valid"
"19922",27,5,105,136,4295559,4298351,2792,"20","orth"
"20020",27,1,83,137,4301437,4304669,3232,"0","valid"
"20119",27,5,99,138,4308101,4311526,3425,"20","orth"
"10107",28,2,5,1,7527040,7530779,3739,"0","orth"
"12103",28,6,87,2,7537924,7543819,5895,"20","mask"
"13104",28,4,73,3,7549532,7554434,4902,"20","valid"
"14104",28,3,96,4,7562095,7565716,3621,"0","mask"
"15101",28,5,32,5,7569030,7573180,4150,"20","orth"
"17102",28,4,43,6,7579417,7582436,3019,"20","valid"
"19101",28,3,66,7,7588855,7592247,3392,"0","mask"
"2027",28,6,21,8,7595555,7599542,3987,"20","mask"
"2222",28,4,79,9,7606470,7609810,3340,"20","valid"
"2315",28,3,42,10,7612811,7616536,3725,"0","mask"
"2519",28,4,127,11,7622707,7625982,3275,"20","valid"
"2624",28,2,47,12,7629015,7632701,3686,"0","orth"
"2818",28,6,69,13,7639211,7643094,3883,"20","mask"
"2920",28,4,85,14,7646375,7650630,4255,"20","valid"
"3022",28,3,12,15,7653827,7657206,3379,"0","mask"
"3220",28,1,76,16,7664370,7667952,3582,"0","valid"
"3319",28,5,104,17,7671364,7675109,3745,"20","orth"
"3421",28,4,49,18,7678240,7682129,3889,"20","valid"
"3621",28,5,62,19,7687802,7691927,4125,"20","orth"
"3715",28,1,112,20,7695620,7698039,2419,"0","valid"
"3819",28,2,89,21,7701751,7705980,4229,"0","orth"
"3921",28,2,11,22,7709582,7713497,3915,"0","orth"
"4121",28,6,57,23,7720021,7724321,4300,"20","mask"
"4218",28,3,108,24,7727766,7731773,4007,"0","mask"
"4320",28,6,75,25,7734793,7739584,4791,"20","mask"
"4420",28,4,7,26,7742983,7747578,4595,"20","valid"
"4619",28,5,74,27,7755114,7759206,4092,"20","orth"
"4717",28,3,120,28,7762605,7766121,3516,"0","mask"
"4822",28,6,15,29,7769050,7772344,3294,"20","mask"
"5021",28,5,56,30,7779626,7784953,5327,"20","orth"
"5117",28,5,38,31,7788176,7790267,2091,"20","orth"
"5321",28,1,106,32,7796084,7799143,3059,"0","valid"
"5422",28,5,92,33,7802621,7806660,4039,"20","orth"
"5522",28,2,83,34,7810242,7814850,4608,"0","orth"
"5617",28,1,58,35,7818086,7822145,4059,"0","valid"
"5721",28,2,23,36,7825289,7827276,1987,"0","orth"
"5921",28,3,6,37,7832485,7835342,2857,"0","mask"
"6119",28,6,129,38,7841931,7845767,3836,"20","mask"
"6224",28,6,3,39,7849931,7852768,2837,"20","mask"
"6420",28,5,80,40,7859631,7863566,3935,"20","orth"
"6521",28,4,13,41,7866821,7869540,2719,"20","valid"
"6718",28,2,59,42,7875867,7878789,2922,"0","orth"
"6819",28,1,88,43,7882149,7884933,2784,"0","valid"
"6920",28,5,44,44,7888051,7890829,2778,"20","orth"
"7119",28,4,19,45,7897653,7900555,2902,"20","valid"
"7318",28,4,115,46,7907438,7910451,3013,"20","valid"
"7419",28,1,40,47,7913778,7916935,3157,"0","valid"
"7622",28,2,77,48,7923492,7926426,2934,"0","orth"
"7719",28,4,91,49,7929361,7932917,3556,"20","valid"
"7820",28,3,138,50,7936113,7939982,3869,"0","mask"
"7920",28,1,130,51,7943323,7945996,2673,"0","valid"
"8019",28,2,95,52,7948957,7952337,3380,"0","orth"
"8121",28,1,124,53,7956245,7958369,2124,"0","valid"
"8221",28,3,54,54,7961363,7963795,2432,"0","mask"
"8415",28,3,18,55,7970677,7973782,3105,"0","mask"
"8623",28,2,17,56,7981306,7984744,3438,"0","orth"
"8821",28,6,45,57,7991404,7994594,3190,"20","mask"
"9017",28,2,101,58,8000222,8003484,3262,"0","orth"
"9120",28,2,65,59,8006693,8008935,2242,"0","orth"
"9223",28,1,46,60,8012347,8014877,2530,"0","valid"
"9418",28,5,134,61,8021668,8024995,3327,"20","orth"
"9519",28,1,34,62,8028119,8030799,2680,"0","valid"
"9717",28,3,60,63,8038950,8042767,3817,"0","mask"
"9820",28,2,131,64,8046153,8049212,3059,"0","orth"
"9918",28,3,24,65,8051977,8055317,3340,"0","mask"
"10122",28,6,51,66,8085502,8089169,3667,"20","mask"
"10321",28,1,118,67,8094810,8098451,3641,"0","valid"
"10418",28,2,29,68,8101549,8104294,2745,"0","orth"
"10620",28,3,72,69,8110438,8112824,2386,"0","mask"
"10720",28,1,16,70,8116138,8119295,3157,"0","valid"
"10919",28,6,105,71,8125237,8128204,2967,"20","mask"
"11015",28,6,33,72,8131433,8134662,3229,"20","mask"
"11223",28,6,111,73,8141375,8144493,3118,"20","mask"
"11316",28,6,81,74,8148755,8151761,3006,"20","mask"
"11422",28,6,117,75,8155356,8157618,2262,"20","mask"
"11515",28,1,70,76,8161278,8164481,3203,"0","valid"
"11622",28,4,121,77,8168103,8170606,2503,"20","valid"
"11723",28,4,55,78,8174442,8176652,2210,"20","valid"
"11821",28,2,71,79,8179979,8182711,2732,"0","orth"
"11917",28,3,114,80,8186136,8189783,3647,"0","mask"
"12022",28,4,1,81,8192908,8196202,3294,"20","valid"
"12222",28,1,94,82,8203353,8206013,2660,"0","valid"
"12320",28,2,113,83,8209641,8212197,2556,"0","orth"
"12419",28,6,27,84,8216432,8219478,3046,"20","mask"
"12616",28,6,39,85,8225662,8228753,3091,"20","mask"
"12817",28,3,48,86,8235126,8236904,1778,"0","mask"
"13017",28,2,35,87,8243009,8245925,2916,"0","orth"
"13222",28,2,53,88,8252533,8255259,2726,"0","orth"
"13420",28,2,107,89,8261285,8264697,3412,"0","orth"
"13515",28,1,4,90,8267828,8270913,3085,"0","valid"
"13717",28,5,122,91,8276560,8279149,2589,"20","orth"
"13819",28,4,67,92,8282528,8286306,3778,"20","valid"
"13918",28,4,109,93,8289319,8292653,3334,"20","valid"
"14020",28,5,110,94,8295765,8298595,2830,"20","orth"
"14123",28,3,36,95,8301928,8305726,3798,"0","mask"
"14323",28,5,8,96,8313027,8316053,3026,"20","orth"
"14517",28,4,25,97,8322701,8325838,3137,"20","valid"
"14719",28,6,135,98,8332728,8335950,3222,"20","mask"
"14817",28,5,14,99,8339395,8342722,3327,"20","orth"
"15021",28,6,93,100,8349186,8352245,3059,"20","mask"
"15122",28,4,61,101,8355788,8358919,3131,"20","valid"
"15221",28,1,22,102,8362135,8365821,3686,"0","valid"
"15421",28,1,64,103,8372841,8375717,2876,"0","valid"
"15518",28,3,30,104,8378973,8381803,2830,"0","mask"
"15722",28,3,78,105,8387313,8390261,2948,"0","mask"
"15819",28,5,50,106,8394686,8396967,2281,"20","orth"
"16023",28,5,20,107,8403098,8405674,2576,"20","orth"
"16217",28,5,128,108,8413517,8416609,3092,"20","orth"
"16324",28,3,102,109,8420603,8423420,2817,"0","mask"
"16417",28,6,123,110,8426616,8429858,3242,"20","mask"
"16521",28,3,126,111,8433094,8437159,4065,"0","mask"
"16614",28,5,98,112,8441526,8445068,3542,"20","orth"
"16723",28,2,41,113,8448487,8452402,3915,"0","orth"
"16922",28,1,52,114,8459305,8461671,2366,"0","valid"
"17125",28,6,9,115,8467887,8470913,3026,"20","mask"
"17321",28,3,90,116,8477352,8480142,2790,"0","mask"
"17415",28,2,125,117,8483633,8486444,2811,"0","orth"
"17520",28,1,136,118,8489516,8492692,3176,"0","valid"
"17619",28,4,133,119,8495915,8498713,2798,"20","valid"
"17718",28,5,86,120,8502994,8506301,3307,"20","orth"
"17820",28,5,26,121,8509818,8512975,3157,"20","orth"
"18020",28,2,137,122,8518668,8521368,2700,"0","orth"
"18124",28,1,10,123,8524675,8527747,3072,"0","valid"
"18317",28,1,100,124,8534375,8537264,2889,"0","valid"
"18420",28,6,99,125,8540401,8542892,2491,"20","mask"
"18517",28,1,28,126,8546637,8549598,2961,"0","valid"
"18719",28,3,132,127,8555762,8558377,2615,"0","mask"
"18819",28,3,84,128,8562318,8565978,3660,"0","mask"
"18919",28,4,97,129,8569371,8572168,2797,"20","valid"
"19020",28,4,31,130,8575979,8578763,2784,"20","valid"
"19224",28,5,68,131,8585300,8588235,2935,"20","orth"
"19319",28,4,37,132,8591973,8596614,4641,"20","valid"
"19518",28,5,116,133,8603014,8606164,3150,"20","orth"
"19620",28,5,2,134,8609733,8612328,2595,"20","orth"
"19820",28,2,119,135,8618851,8622917,4066,"0","orth"
"19923",28,6,63,136,8626289,8629388,3099,"20","mask"
"20021",28,4,103,137,8633394,8636565,3171,"20","valid"
"20120",28,1,82,138,8639970,8642657,2687,"0","valid"
"10108",29,5,121,1,8106455,8111113,4658,"20","orth"
"1190",29,4,30,2,8114219,8118431,4212,"20","valid"
"13105",29,5,73,3,8124935,8128680,3745,"20","orth"
"14105",29,3,107,4,8131999,8135638,3639,"0","mask"
"15102",29,3,113,5,8138783,8142715,3932,"0","mask"
"16101",29,5,7,6,8145641,8150746,5105,"20","orth"
"18104",29,5,31,7,8158443,8162854,4411,"20","orth"
"2028",29,6,86,8,8170345,8175177,4832,"20","mask"
"2121",29,1,81,9,8178569,8182121,3552,"0","valid"
"2223",29,3,101,10,8185053,8188812,3759,"0","mask"
"2316",29,6,104,11,8191991,8195776,3785,"20","mask"
"2424",29,1,21,12,8199208,8202860,3652,"0","valid"
"2625",29,5,13,13,8209411,8213529,4118,"20","orth"
"2819",29,2,82,14,8219760,8222446,2686,"0","orth"
"2921",29,5,109,15,8225278,8230269,4991,"20","orth"
"3023",29,1,33,16,8233575,8237234,3659,"0","valid"
"3221",29,2,10,17,8244365,8247603,3238,"0","orth"
"3422",29,5,55,18,8253841,8256687,2846,"20","orth"
"3518",29,3,137,19,8259672,8262091,2419,"0","mask"
"3622",29,4,72,20,8265004,8268329,3325,"20","valid"
"3716",29,5,67,21,8271088,8274160,3072,"20","orth"
"3820",29,6,44,22,8277112,8280365,3253,"20","mask"
"4020",29,5,97,23,8286529,8289754,3225,"20","orth"
"4122",29,2,34,24,8292680,8295286,2606,"0","orth"
"4321",29,6,20,25,8303856,8307115,3259,"20","mask"
"4516",29,2,94,26,8314672,8318664,3992,"0","orth"
"4620",29,1,87,27,8321823,8325201,3378,"0","valid"
"4718",29,5,61,28,8328054,8331925,3871,"20","orth"
"4823",29,5,43,29,8335171,8338883,3712,"20","orth"
"5022",29,4,60,30,8346720,8351758,5038,"20","valid"
"5118",29,3,59,31,8355064,8359222,4158,"0","mask"
"5221",29,6,62,32,8362594,8366546,3952,"20","mask"
"5322",29,3,29,33,8369385,8372831,3446,"0","mask"
"5523",29,3,17,34,8379122,8382374,3252,"0","mask"
"5722",29,4,132,35,8388505,8392716,4211,"20","valid"
"5819",29,1,93,36,8395942,8398501,2559,"0","valid"
"5922",29,6,14,37,8401580,8406338,4758,"20","mask"
"6120",29,6,110,38,8412029,8414775,2746,"20","mask"
"6225",29,4,42,39,8417634,8422039,4405,"20","valid"
"6421",29,6,116,40,8428897,8432755,3858,"20","mask"
"6522",29,2,106,41,8436660,8439486,2826,"0","orth"
"6621",29,2,118,42,8442732,8445404,2672,"0","orth"
"6719",29,1,51,43,8448336,8451348,3012,"0","valid"
"6921",29,1,3,44,8457333,8460298,2965,"0","valid"
"7120",29,6,80,45,8466523,8470455,3932,"20","mask"
"7218",29,1,27,46,8473247,8476399,3152,"0","valid"
"7420",29,4,18,47,8482403,8486009,3606,"20","valid"
"7623",29,6,74,48,8492246,8495932,3686,"20","mask"
"7720",29,5,79,49,8499297,8502463,3166,"20","orth"
"7821",29,1,135,50,8505995,8509460,3465,"0","valid"
"7921",29,5,19,51,8512286,8515805,3519,"20","orth"
"8122",29,2,124,52,8523582,8527007,3425,"0","orth"
"8222",29,4,102,53,8529753,8532785,3032,"20","valid"
"8321",29,5,127,54,8535691,8538503,2812,"20","orth"
"8416",29,1,57,55,8541442,8544107,2665,"0","valid"
"8519",29,3,89,56,8547146,8551371,4225,"0","mask"
"8624",29,2,16,57,8554683,8557549,2866,"0","orth"
"8822",29,4,36,58,8564033,8567272,3239,"20","valid"
"9018",29,3,83,59,8573624,8576895,3271,"0","mask"
"9121",29,2,76,60,8579754,8583053,3299,"0","orth"
"9224",29,2,88,61,8586359,8589491,3132,"0","orth"
"9321",29,6,128,62,8592410,8597114,4704,"20","mask"
"9419",29,6,98,63,8600207,8603799,3592,"20","mask"
"9520",29,4,24,64,8607011,8611496,4485,"20","valid"
"9718",29,1,75,65,8618607,8622299,3692,"0","valid"
"9821",29,4,6,66,8648802,8653474,4672,"20","valid"
"10024",29,3,41,67,8659471,8662964,3493,"0","mask"
"10220",29,3,47,68,8669068,8672360,3292,"0","mask"
"10419",29,1,123,69,8679611,8682797,3186,"0","valid"
"10518",29,6,26,70,8685895,8689674,3779,"20","mask"
"10721",29,5,1,71,8696125,8699150,3025,"20","orth"
"10920",29,6,8,72,8705695,8709347,3652,"20","mask"
"11123",29,2,28,73,8715338,8718903,3565,"0","orth"
"11317",29,3,11,74,8725454,8728159,2705,"0","mask"
"11516",29,6,2,75,8734437,8737903,3466,"20","mask"
"11724",29,6,50,76,8743980,8748679,4699,"20","mask"
"11918",29,3,77,77,8754430,8757222,2792,"0","mask"
"12023",29,4,90,78,8759928,8763200,3272,"20","valid"
"12121",29,6,134,79,8765972,8770278,4306,"20","mask"
"12223",29,1,15,80,8773110,8775609,2499,"0","valid"
"12420",29,2,64,81,8781320,8783886,2566,"0","orth"
"12519",29,3,131,82,8786865,8789457,2592,"0","mask"
"12617",29,2,52,83,8792076,8795328,3252,"0","orth"
"12818",29,6,92,84,8801159,8804925,3766,"20","mask"
"12924",29,1,9,85,8808244,8810896,2652,"0","valid"
"13122",29,2,136,86,8817420,8820539,3119,"0","orth"
"13223",29,1,63,87,8823718,8826630,2912,"0","valid"
"13318",29,3,71,88,8829623,8832622,2999,"0","mask"
"13421",29,5,25,89,8835560,8838846,3286,"20","orth"
"13619",29,3,5,90,8844650,8847762,3112,"0","mask"
"13820",29,3,65,91,8854300,8857205,2905,"0","mask"
"13919",29,1,111,92,8860058,8862990,2932,"0","valid"
"14021",29,2,100,93,8865983,8868101,2118,"0","orth"
"14124",29,5,37,94,8870814,8873913,3099,"20","orth"
"14324",29,5,115,95,8879951,8883016,3065,"20","orth"
"14418",29,2,4,96,8886295,8888774,2479,"0","orth"
"14623",29,1,39,97,8894751,8897137,2386,"0","valid"
"14818",29,2,130,98,8903348,8906381,3033,"0","orth"
"14923",29,5,103,99,8909833,8914238,4405,"20","orth"
"15022",29,4,126,100,8917317,8920915,3598,"20","valid"
"15123",29,1,99,101,8924441,8926713,2272,"0","valid"
"15222",29,4,48,102,8929399,8931345,1946,"20","valid"
"15422",29,4,108,103,8938249,8941694,3445,"20","valid"
"15519",29,2,112,104,8944673,8947046,2373,"0","orth"
"15619",29,6,38,105,8949885,8953230,3345,"20","mask"
"15820",29,6,32,106,8959734,8963153,3419,"20","mask"
"16024",29,5,133,107,8969178,8973169,3991,"20","orth"
"16122",29,1,105,108,8976142,8978174,2032,"0","valid"
"16218",29,1,45,109,8980987,8983632,2645,"0","valid"
"16418",29,3,23,110,8989910,8993022,3112,"0","mask"
"16615",29,3,119,111,8999020,9003511,4491,"0","mask"
"16724",29,5,85,112,9006497,9010562,4065,"20","orth"
"16821",29,2,22,113,9013588,9016400,2812,"0","orth"
"17020",29,4,54,114,9022971,9026670,3699,"20","valid"
"17220",29,2,46,115,9033174,9035473,2299,"0","orth"
"17416",29,4,84,116,9041931,9045656,3725,"20","valid"
"17521",29,4,120,117,9048808,9051134,2326,"20","valid"
"17620",29,4,12,118,9054160,9057192,3032,"20","valid"
"17821",29,4,66,119,9063083,9066102,3019,"20","valid"
"17920",29,3,125,120,9068934,9071300,2366,"0","mask"
"18021",29,4,96,121,9074452,9077678,3226,"20","valid"
"18125",29,3,95,122,9080723,9083762,3039,"0","mask"
"18219",29,5,49,123,9086881,9090093,3212,"20","orth"
"18421",29,5,91,124,9096891,9101335,4444,"20","orth"
"18518",29,4,78,125,9103921,9106407,2486,"20","valid"
"18619",29,1,117,126,9112551,9115097,2546,"0","valid"
"18720",29,4,138,127,9118449,9121888,3439,"20","valid"
"18820",29,2,70,128,9125054,9127859,2805,"0","orth"
"18920",29,3,53,129,9132977,9135663,2686,"0","mask"
"19124",29,6,122,130,9141407,9143307,1900,"20","mask"
"19225",29,1,69,131,9146206,9148525,2319,"0","valid"
"19320",29,3,35,132,9151344,9154116,2772,"0","mask"
"19519",29,6,56,133,9160607,9163786,3179,"20","mask"
"19621",29,4,114,134,9166805,9170323,3518,"20","valid"
"19719",29,2,58,135,9173396,9176388,2992,"0","orth"
"19821",29,6,68,136,9179394,9184265,4871,"20","mask"
"19924",29,2,40,137,9187297,9190356,3059,"0","orth"
"20121",29,1,129,138,9196441,9199166,2725,"0","valid"
"10109",30,3,16,1,1226979,1231004,4025,"0","mask"
"12104",30,5,84,2,1237721,1241913,4192,"20","orth"
"13106",30,4,107,3,1245272,1249697,4425,"20","valid"
"14106",30,5,72,4,1254069,1258633,4564,"20","orth"
"15103",30,6,73,5,1261533,1266151,4618,"20","mask"
"16102",30,4,29,6,1269729,1274821,5092,"20","valid"
"18105",30,6,43,7,1281792,1285350,3558,"20","mask"
"2029",30,5,126,8,1291175,1295273,4098,"20","orth"
"2122",30,2,93,9,1299072,1302884,3812,"0","orth"
"2224",30,2,135,10,1306869,1312140,5271,"0","orth"
"2317",30,5,48,11,1315319,1317392,2073,"20","orth"
"2520",30,4,47,12,1323223,1326322,3099,"20","valid"
"2718",30,3,82,13,1332940,1336118,3178,"0","mask"
"2820",30,2,129,14,1339244,1343742,4498,"0","orth"
"2922",30,6,7,15,1346828,1350906,4078,"20","mask"
"3119",30,1,2,16,1357564,1361842,4278,"0","valid"
"3320",30,4,137,17,1368586,1371472,2886,"20","valid"
"3423",30,4,11,18,1375150,1378623,3473,"20","valid"
"3623",30,2,69,19,1384240,1387606,3366,"0","orth"
"3717",30,3,76,20,1391384,1395943,4559,"0","mask"
"3821",30,2,81,21,1398928,1402434,3506,"0","orth"
"3922",30,1,116,22,1405746,1410924,5178,"0","valid"
"4021",30,3,130,23,1415062,1419174,4112,"0","mask"
"4123",30,3,46,24,1422400,1426052,3652,"0","mask"
"4322",30,2,63,25,1434009,1437734,3725,"0","orth"
"4421",30,5,36,26,1441453,1444918,3465,"20","orth"
"4621",30,2,99,27,1451336,1454361,3025,"0","orth"
"4719",30,6,79,28,1458333,1462225,3892,"20","mask"
"4824",30,6,25,29,1466250,1470022,3772,"20","mask"
"5023",30,6,133,30,1476613,1480685,4072,"20","mask"
"5119",30,1,80,31,1484270,1488182,3912,"0","valid"
"5222",30,1,98,32,1519544,1522682,3138,"0","valid"
"5323",30,1,92,33,1526068,1531859,5791,"0","valid"
"5423",30,3,22,34,1535438,1538796,3358,"0","mask"
"5618",30,6,37,35,1545361,1549193,3832,"20","mask"
"5820",30,6,67,36,1556044,1559729,3685,"20","mask"
"5923",30,2,123,37,1563554,1567706,4152,"0","orth"
"6019",30,4,35,38,1571111,1575210,4099,"20","valid"
"6226",30,6,85,39,1582354,1587185,4831,"20","mask"
"6318",30,6,1,40,1591284,1594523,3239,"20","mask"
"6523",30,1,20,41,1601973,1603932,1959,"0","valid"
"6720",30,5,96,42,1609924,1613356,3432,"20","orth"
"6820",30,6,109,43,1616715,1619700,2985,"20","mask"
"6922",30,2,27,44,1622585,1625424,2839,"0","orth"
"7121",30,2,57,45,1631376,1634954,3578,"0","orth"
"7219",30,5,42,46,1638613,1641685,3072,"20","orth"
"7421",30,6,55,47,1648023,1650662,2639,"20","mask"
"7521",30,4,65,48,1653661,1656993,3332,"20","valid"
"7624",30,4,77,49,1659912,1662571,2659,"20","valid"
"7721",30,3,70,50,1665756,1669841,4085,"0","mask"
"7822",30,2,111,51,1673394,1676985,3591,"0","orth"
"7922",30,2,15,52,1679938,1682723,2785,"0","orth"
"8123",30,3,106,53,1689761,1692306,2545,"0","mask"
"8223",30,1,104,54,1695805,1699290,3485,"0","valid"
"8322",30,1,128,55,1701990,1707581,5591,"0","valid"
"8417",30,6,19,56,1710606,1713179,2573,"20","mask"
"8625",30,2,87,57,1722002,1725501,3499,"0","orth"
"8716",30,1,134,58,1728640,1732272,3632,"0","valid"
"8823",30,5,114,59,1735444,1739369,3925,"20","orth"
"8918",30,5,12,60,1742488,1745573,3085,"20","orth"
"9122",30,3,34,61,1752218,1755236,3018,"0","mask"
"9322",30,1,50,62,1763834,1767185,3351,"0","valid"
"9521",30,4,5,63,1772737,1776295,3558,"20","valid"
"9719",30,1,110,64,1782753,1786265,3512,"0","valid"
"9822",30,5,54,65,1790024,1792796,2772,"20","orth"
"10025",30,5,30,66,1859711,1862443,2732,"20","orth"
"10221",30,4,53,67,1870361,1873979,3618,"20","valid"
"10420",30,2,21,68,1879924,1883342,3418,"0","orth"
"10621",30,3,112,69,1891133,1893805,2672,"0","mask"
"10722",30,6,103,70,1897091,1900922,3831,"20","mask"
"10819",30,5,90,71,1903928,1907647,3719,"20","orth"
"10921",30,6,97,72,1910759,1914517,3758,"20","mask"
"11016",30,5,66,73,1917637,1920435,2798,"20","orth"
"11124",30,2,105,74,1923221,1926780,3559,"0","orth"
"11224",30,3,118,75,1929692,1932991,3299,"0","mask"
"11318",30,5,6,76,1939129,1943034,3905,"20","orth"
"11517",30,1,74,77,1950744,1953583,2839,"0","valid"
"11623",30,3,88,78,1956722,1961234,4512,"0","mask"
"11725",30,6,121,79,1964279,1967538,3259,"20","mask"
"11822",30,3,94,80,1970410,1975342,4932,"0","mask"
"11919",30,6,31,81,1978507,1982952,4445,"20","mask"
"12122",30,4,59,82,1990536,1994268,3732,"20","valid"
"12224",30,5,18,83,1997280,2000206,2926,"20","orth"
"12421",30,3,100,84,2006224,2011455,5231,"0","mask"
"12520",30,6,49,85,2014721,2018812,4091,"20","mask"
"12720",30,4,113,86,2024190,2027789,3599,"20","valid"
"12819",30,1,68,87,2030795,2034127,3332,"0","valid"
"12925",30,2,51,88,2036979,2040624,3645,"0","orth"
"13123",30,1,44,89,2046482,2048721,2239,"0","valid"
"13319",30,4,23,90,2079637,2082855,3218,"20","valid"
"13516",30,5,132,91,2089266,2093145,3879,"20","orth"
"13620",30,1,122,92,2096970,2099229,2259,"0","valid"
"13718",30,1,38,93,2103048,2106207,3159,"0","valid"
"13920",30,2,33,94,2112691,2117103,4412,"0","orth"
"14125",30,2,39,95,2125853,2129585,3732,"0","orth"
"14325",30,1,8,96,2135423,2138428,3005,"0","valid"
"14518",30,1,26,97,2145259,2149671,4412,"0","valid"
"14720",30,1,14,98,2158308,2162073,3765,"0","valid"
"14924",30,3,124,99,2167637,2170876,3239,"0","mask"
"15023",30,4,89,100,2174162,2178640,4478,"20","valid"
"15124",30,3,64,101,2182225,2186957,4732,"0","mask"
"15223",30,6,127,102,2191955,2195587,3632,"20","mask"
"15319",30,5,138,103,2198973,2205643,6670,"20","orth"
"15423",30,4,83,104,2209382,2213314,3932,"20","valid"
"15520",30,2,45,105,2216346,2219192,2846,"0","orth"
"15723",30,6,61,106,2225343,2229061,3718,"20","mask"
"15821",30,2,9,107,2232320,2236832,4512,"0","orth"
"16025",30,4,71,108,2243696,2247215,3519,"20","valid"
"16123",30,2,75,109,2253046,2258030,4984,"0","orth"
"16219",30,3,52,110,2261616,2265295,3679,"0","mask"
"16419",30,1,32,111,2272712,2278023,5311,"0","valid"
"16616",30,5,120,112,2284141,2287106,2965,"20","orth"
"16725",30,2,3,113,2290799,2294664,3865,"0","orth"
"16923",30,1,56,114,2302108,2305853,3745,"0","valid"
"17021",30,5,108,115,2309219,2312297,3078,"20","orth"
"17126",30,4,95,116,2315696,2318641,2945,"20","valid"
"17221",30,6,13,117,2321754,2324493,2739,"20","mask"
"17417",30,4,119,118,2332403,2335409,3006,"20","valid"
"17522",30,5,102,119,2338614,2342333,3719,"20","orth"
"17621",30,6,91,120,2345998,2350137,4139,"20","mask"
"17719",30,6,115,121,2353495,2356341,2846,"20","mask"
"17822",30,4,131,122,2359586,2362619,3033,"20","valid"
"17921",30,3,28,123,2365271,2367970,2699,"0","mask"
"18126",30,3,136,124,2374974,2378153,3179,"0","mask"
"18220",30,4,17,125,2382771,2385450,2679,"20","valid"
"18422",30,4,41,126,2391888,2394800,2912,"20","valid"
"18620",30,5,78,127,2400725,2405023,4298,"20","orth"
"18721",30,4,125,128,2408229,2411574,3345,"20","valid"
"18821",30,3,4,129,2414546,2417452,2906,"0","mask"
"19021",30,1,62,130,2423076,2426901,3825,"0","valid"
"19125",30,3,40,131,2431007,2434825,3818,"0","mask"
"19321",30,5,24,132,2442663,2446474,3811,"20","orth"
"19520",30,5,60,133,2453445,2457624,4179,"20","orth"
"19622",30,3,10,134,2461162,2464994,3832,"0","mask"
"19822",30,3,58,135,2472725,2476377,3652,"0","mask"
"19925",30,1,86,136,2480022,2482907,2885,"0","valid"
"20022",30,4,101,137,2487233,2491344,4111,"20","valid"
"20122",30,2,117,138,2507385,2510171,2786,"0","orth"
"10123",31,2,116,1,3401355,3406620,5265,"0","orth"
"11100",31,1,61,2,3409992,3414324,4332,"0","valid"
"12105",31,6,48,3,3417969,3421028,3059,"20","mask"
"14107",31,6,78,4,3427393,3431044,3651,"20","mask"
"15104",31,6,6,5,3434363,3438408,4045,"20","mask"
"17103",31,1,115,6,3445193,3449971,4778,"0","valid"
"18106",31,6,126,7,3453143,3457708,4565,"20","mask"
"19102",31,4,52,8,3460573,3464839,4266,"20","valid"
"2123",31,3,33,9,3471216,3477047,5831,"0","mask"
"2318",31,6,42,10,3483765,3487530,3765,"20","mask"
"2521",31,6,138,11,3494414,3498626,4212,"20","mask"
"2626",31,1,31,12,3501612,3507003,5391,"0","valid"
"2821",31,4,28,13,3513207,3519378,6171,"20","valid"
"3024",31,4,76,14,3525550,3531087,5537,"20","valid"
"3120",31,1,85,15,3534266,3538638,4372,"0","valid"
"3222",31,1,133,16,3541963,3546262,4299,"0","valid"
"3321",31,2,32,17,3549461,3553632,4171,"0","orth"
"3519",31,3,27,18,3560243,3564209,3966,"0","mask"
"3718",31,2,92,19,3570080,3575198,5118,"0","orth"
"3822",31,6,114,20,3578030,3583961,5931,"20","mask"
"3923",31,5,59,21,3587167,3592071,4904,"20","orth"
"4022",31,2,134,22,3595177,3599835,4658,"0","orth"
"4124",31,4,118,23,3603207,3607219,4012,"20","valid"
"4219",31,2,44,24,3610665,3615723,5058,"0","orth"
"4422",31,5,107,25,3622061,3625826,3765,"20","orth"
"4517",31,6,108,26,3628745,3633363,4618,"20","mask"
"4622",31,6,90,27,3636375,3640647,4272,"20","mask"
"4720",31,1,55,28,3643693,3646925,3232,"0","valid"
"4825",31,5,23,29,3650677,3653975,3298,"20","orth"
"5024",31,6,24,30,3660006,3663765,3759,"20","mask"
"5223",31,1,7,31,3669849,3674961,5112,"0","valid"
"5424",31,2,80,32,3681072,3685657,4585,"0","orth"
"5524",31,6,66,33,3688496,3692794,4298,"20","mask"
"5619",31,4,4,34,3695867,3699738,3871,"20","valid"
"5821",31,5,101,35,3705443,3709182,3739,"20","orth"
"5924",31,1,91,36,3712181,3716006,3825,"0","valid"
"6020",31,5,137,37,3718525,3722383,3858,"20","orth"
"6121",31,2,56,38,3725349,3730400,5051,"0","orth"
"6227",31,2,98,39,3733419,3738877,5458,"0","orth"
"6319",31,2,122,40,3742129,3745861,3732,"0","orth"
"6422",31,2,128,41,3749047,3753998,4951,"0","orth"
"6524",31,1,1,42,3757091,3760403,3312,"0","valid"
"6721",31,4,58,43,3766721,3771139,4418,"20","valid"
"6821",31,3,45,44,3773798,3777397,3599,"0","mask"
"7022",31,5,5,45,3783641,3787193,3552,"20","orth"
"7220",31,5,77,46,3793777,3798562,4785,"20","orth"
"7319",31,5,125,47,3801461,3805639,4178,"20","orth"
"7422",31,4,64,48,3808512,3812730,4218,"20","valid"
"7522",31,1,73,49,3815563,3820781,5218,"0","valid"
"7625",31,2,14,50,3823806,3829071,5265,"0","orth"
"7823",31,2,104,51,3835328,3838307,2979,"0","orth"
"7923",31,1,103,52,3841013,3845838,4825,"0","valid"
"8020",31,3,51,53,3849077,3852295,3218,"0","mask"
"8224",31,5,83,54,3858473,3863298,4825,"20","orth"
"8323",31,4,16,55,3866497,3870869,4372,"20","valid"
"8520",31,5,65,56,3876680,3880798,4118,"20","orth"
"8626",31,5,113,57,3883957,3888069,4112,"20","orth"
"8717",31,3,3,58,3891121,3895346,4225,"0","mask"
"8919",31,5,41,59,3902650,3906016,3366,"20","orth"
"9123",31,3,75,60,3913626,3918471,4845,"0","mask"
"9225",31,2,74,61,3921523,3925535,4012,"0","orth"
"9323",31,3,9,62,3928507,3933912,5405,"0","mask"
"9522",31,4,40,63,3941889,3945901,4012,"20","valid"
"9720",31,4,136,64,3952479,3956504,4025,"20","valid"
"9823",31,2,62,65,3959363,3963654,4291,"0","orth"
"9919",31,6,96,66,4005372,4009757,4385,"20","mask"
"10026",31,2,2,67,4012897,4017095,4198,"0","orth"
"10222",31,3,57,68,4023333,4028377,5044,"0","mask"
"10322",31,6,102,69,4031210,4036221,5011,"20","mask"
"10421",31,1,109,70,4039260,4044038,4778,"0","valid"
"10519",31,6,60,71,4047497,4051062,3565,"20","mask"
"10622",31,4,22,72,4054181,4059606,5425,"20","valid"
"10820",31,5,95,73,4065870,4070748,4878,"20","orth"
"10922",31,5,17,74,4074000,4078059,4059,"20","orth"
"11125",31,5,131,75,4084050,4088555,4505,"20","orth"
"11225",31,1,127,76,4091707,4096932,5225,"0","valid"
"11319",31,1,25,77,4100017,4104982,4965,"0","valid"
"11518",31,4,112,78,4110947,4115925,4978,"20","valid"
"11624",31,3,129,79,4118924,4124142,5218,"0","mask"
"11726",31,3,81,80,4127101,4132459,5358,"0","mask"
"11823",31,3,69,81,4135544,4141329,5785,"0","mask"
"11920",31,3,39,82,4144388,4149905,5517,"0","mask"
"12123",31,2,20,83,4156170,4160475,4305,"0","orth"
"12321",31,1,79,84,4166593,4172217,5624,"0","valid"
"12422",31,6,72,85,4175076,4180701,5625,"20","mask"
"12521",31,5,29,86,4184080,4188078,3998,"20","orth"
"12721",31,3,99,87,4194929,4199694,4765,"0","mask"
"12820",31,4,34,88,4202553,4208271,5718,"20","valid"
"13018",31,3,21,89,4214975,4220366,5391,"0","mask"
"13224",31,4,130,90,4226611,4231049,4438,"20","valid"
"13320",31,3,111,91,4234148,4239439,5291,"0","mask"
"13422",31,2,26,92,4242371,4247430,5059,"0","orth"
"13621",31,3,105,93,4254554,4260938,6384,"0","mask"
"13719",31,2,110,94,4264350,4268795,4445,"0","orth"
"13821",31,3,135,95,4273200,4278252,5052,"0","mask"
"13921",31,5,47,96,4281157,4285549,4392,"20","orth"
"14126",31,4,100,97,4291893,4296771,4878,"20","valid"
"14221",31,6,132,98,4299784,4304755,4971,"20","mask"
"14326",31,4,70,99,4308074,4313385,5311,"20","valid"
"14419",31,3,87,100,4316224,4323355,7131,"0","mask"
"14519",31,6,36,101,4325947,4329586,3639,"20","mask"
"14721",31,1,19,102,4335637,4342441,6804,"0","valid"
"14925",31,2,68,103,4348619,4353770,5151,"0","orth"
"15024",31,3,63,104,4357036,4360888,3852,"0","mask"
"15125",31,3,123,105,4363840,4370131,6291,"0","mask"
"15224",31,2,86,106,4372923,4377129,4206,"0","orth"
"15320",31,6,12,107,4380614,4384299,3685,"20","mask"
"15521",31,2,38,108,4390650,4395209,4559,"0","orth"
"15724",31,4,94,109,4400953,4405145,4192,"20","valid"
"15822",31,2,50,110,4407844,4412122,4278,"0","orth"
"16026",31,5,119,111,4418233,4422945,4712,"20","orth"
"16124",31,6,54,112,4426091,4430289,4198,"20","mask"
"16325",31,6,120,113,4436280,4439752,3472,"20","mask"
"16420",31,6,84,114,4442884,4448562,5678,"20","mask"
"16522",31,1,121,115,4452001,4456712,4711,"0","valid"
"16617",31,4,10,116,4459738,4463417,3679,"20","valid"
"16822",31,4,82,117,4469861,4472887,3026,"20","valid"
"16924",31,5,89,118,4476239,4482456,6217,"20","orth"
"17022",31,1,13,119,4485342,4491400,6058,"0","valid"
"17222",31,3,15,120,4497571,4502409,4838,"0","mask"
"17418",31,4,124,121,4508487,4512678,4191,"20","valid"
"17523",31,4,88,122,4516231,4521915,5684,"20","valid"
"17622",31,6,30,123,4525001,4531485,6484,"20","mask"
"17823",31,2,8,124,4537783,4542174,4391,"0","orth"
"18022",31,3,117,125,4548239,4552624,4385,"0","mask"
"18127",31,5,35,126,4555323,4559874,4551,"20","orth"
"18318",31,5,11,127,4566665,4570364,3699,"20","orth"
"18519",31,1,37,128,4576082,4580913,4831,"0","valid"
"18722",31,1,49,129,4586978,4591589,4611,"0","valid"
"18921",31,4,46,130,4597254,4601399,4145,"20","valid"
"19126",31,4,106,131,4607244,4611002,3758,"20","valid"
"19226",31,5,71,132,4614001,4617786,3785,"20","orth"
"19322",31,5,53,133,4620719,4624930,4211,"20","orth"
"19521",31,1,43,134,4630922,4635067,4145,"0","valid"
"19720",31,1,67,135,4641104,4644623,3519,"0","valid"
"19823",31,3,93,136,4647675,4650894,3219,"0","mask"
"19926",31,6,18,137,4653840,4658525,4685,"20","mask"
"20123",31,1,97,138,4664649,4668868,4219,"0","valid"
"10124",32,3,116,1,5794632,5801883,7251,"0","mask"
"11101",32,5,112,2,5804902,5809520,4618,"20","orth"
"12106",32,2,73,3,5812426,5816644,4218,"0","orth"
"13107",32,3,68,4,5819563,5823188,3625,"0","mask"
"14108",32,6,107,5,5825940,5832738,6798,"20","mask"
"15105",32,2,7,6,5835677,5838916,3239,"0","orth"
"17104",32,4,123,7,5847752,5852264,4512,"20","valid"
"18107",32,4,93,8,5855223,5858295,3072,"20","valid"
"19103",32,1,24,9,5861188,5864247,3059,"0","valid"
"2124",32,5,130,10,5870771,5875616,4845,"20","orth"
"2225",32,2,79,11,5879174,5882733,3559,"0","orth"
"2319",32,1,30,12,5885679,5888617,2938,"0","valid"
"2522",32,3,80,13,5894669,5898447,3778,"0","mask"
"2627",32,3,44,14,5901413,5904132,2719,"0","mask"
"2822",32,3,134,15,5909716,5913515,3799,"0","mask"
"2923",32,3,86,16,5916407,5921259,4852,"0","mask"
"3025",32,2,97,17,5924111,5927770,3659,"0","orth"
"3121",32,6,89,18,5931135,5934454,3319,"20","mask"
"3223",32,4,63,19,5937373,5939619,2246,"20","valid"
"3322",32,1,72,20,5942491,5947349,4858,"0","valid"
"3424",32,4,105,21,5950135,5954813,4678,"20","valid"
"3520",32,2,85,22,5957912,5961777,3865,"0","orth"
"3624",32,2,115,23,5965849,5968908,3059,"0","orth"
"3719",32,6,47,24,5971680,5976385,4705,"20","mask"
"3924",32,2,31,25,5982690,5986715,4025,"0","orth"
"4125",32,4,69,26,5993366,5996251,2885,"20","valid"
"4220",32,2,103,27,5999170,6001782,2612,"0","orth"
"4323",32,5,76,28,6004635,6009979,5344,"20","orth"
"4423",32,1,138,29,6013125,6016690,3565,"0","valid"
"4518",32,6,131,30,6019816,6024094,4278,"20","mask"
"4623",32,2,121,31,6026927,6030225,3298,"0","orth"
"4721",32,3,32,32,6033104,6036723,3619,"0","mask"
"4916",32,2,133,33,6043661,6047166,3505,"0","orth"
"5025",32,6,59,34,6050171,6053697,3526,"20","mask"
"5120",32,4,51,35,6056815,6060074,3259,"20","valid"
"5324",32,4,135,36,6066085,6071756,5671,"20","valid"
"5425",32,3,26,37,6074949,6079040,4091,"0","mask"
"5620",32,2,49,38,6085905,6089537,3632,"0","orth"
"5822",32,4,27,39,6095048,6099200,4152,"20","valid"
"6021",32,3,2,40,6104891,6108656,3765,"0","mask"
"6228",32,4,75,41,6116120,6123077,6957,"20","valid"
"6320",32,3,56,42,6126070,6130575,4505,"0","mask"
"6423",32,1,132,43,6133547,6136426,2879,"0","valid"
"6525",32,2,67,44,6139212,6142251,3039,"0","orth"
"6622",32,4,3,45,6145010,6150408,5398,"20","valid"
"6822",32,5,70,46,6156765,6160144,3379,"20","orth"
"6923",32,1,18,47,6162916,6166402,3486,"0","valid"
"7122",32,3,20,48,6172586,6175358,2772,"0","mask"
"7320",32,4,45,49,6181936,6185082,3146,"20","valid"
"7523",32,1,126,50,6191333,6194725,3392,"0","valid"
"7626",32,5,46,51,6197744,6201295,3551,"20","orth"
"7824",32,5,58,52,6207113,6211812,4699,"20","orth"
"7924",32,5,52,53,6214644,6218403,3759,"20","orth"
"8124",32,5,34,54,6225460,6228925,3465,"20","orth"
"8324",32,1,120,55,6236083,6239954,3871,"0","valid"
"8418",32,5,16,56,6243074,6245646,2572,"20","orth"
"8627",32,1,90,57,6251664,6254976,3312,"0","valid"
"8718",32,6,119,58,6257995,6261926,3931,"20","mask"
"8824",32,6,5,59,6264706,6268364,3658,"20","mask"
"9019",32,3,62,60,6274455,6278101,3646,"0","mask"
"9124",32,3,74,61,6280940,6283698,2758,"0","mask"
"9226",32,4,33,62,6286604,6289316,2712,"20","valid"
"9420",32,5,82,63,6295128,6297820,2692,"20","orth"
"9523",32,1,96,64,6300772,6303411,2639,"0","valid"
"9617",32,1,84,65,6306250,6311215,4965,"0","valid"
"9721",32,3,14,66,6358191,6361610,3419,"0","mask"
"9920",32,4,117,67,6368154,6370606,2452,"20","valid"
"10027",32,1,48,68,6374405,6377071,2666,"0","valid"
"10223",32,2,43,69,6384102,6386894,2792,"0","orth"
"10422",32,2,13,70,6392751,6397930,5179,"0","orth"
"10623",32,4,81,71,6404421,6408459,4038,"20","valid"
"10723",32,5,100,72,6411345,6414097,2752,"20","orth"
"10821",32,1,60,73,6417189,6421021,3832,"0","valid"
"10923",32,2,37,74,6423887,6428605,4718,"0","orth"
"11126",32,5,64,75,6437169,6440880,3711,"20","orth"
"11226",32,3,8,76,6444946,6449117,4171,"0","mask"
"11423",32,6,41,77,6456475,6459667,3192,"20","mask"
"11625",32,3,110,78,6480973,6485524,4551,"0","mask"
"11727",32,1,6,79,6488350,6494434,6084,"0","valid"
"11921",32,2,19,80,6499945,6502584,2639,"0","orth"
"12124",32,1,36,81,6510088,6513340,3252,"0","valid"
"12322",32,6,101,82,6519651,6522970,3319,"20","mask"
"12423",32,4,21,83,6525982,6530234,4252,"20","valid"
"12618",32,2,61,84,6536805,6540324,3519,"0","orth"
"12722",32,4,111,85,6543463,6546288,2825,"20","valid"
"12821",32,5,106,86,6549220,6552013,2793,"20","orth"
"12926",32,1,108,87,6554965,6557984,3019,"0","valid"
"13019",32,3,92,88,6560957,6564848,3891,"0","mask"
"13124",32,4,99,89,6567774,6571919,4145,"20","valid"
"13225",32,2,1,90,6575138,6578710,3572,"0","orth"
"13423",32,4,87,91,6585014,6590112,5098,"20","valid"
"13517",32,6,113,92,6592924,6596803,3879,"20","mask"
"13622",32,4,129,93,6599589,6603687,4098,"20","valid"
"13720",32,4,9,94,6606819,6611044,4225,"20","valid"
"13922",32,1,114,95,6617149,6621247,4098,"0","valid"
"14022",32,2,127,96,6624100,6626752,2652,"0","orth"
"14127",32,2,91,97,6629744,6633236,3492,"0","orth"
"14222",32,6,71,98,6636202,6639914,3712,"20","mask"
"14327",32,5,124,99,6642879,6645918,3039,"20","orth"
"14420",32,6,83,100,6648724,6651409,2685,"20","mask"
"14520",32,5,94,101,6654255,6659153,4898,"20","orth"
"14624",32,5,118,102,6662226,6665131,2905,"20","orth"
"14722",32,5,28,103,6667844,6671656,3812,"20","orth"
"14926",32,3,122,104,6677920,6680219,2299,"0","mask"
"15025",32,5,4,105,6683318,6686743,3425,"20","orth"
"15225",32,3,38,106,6692794,6696693,3899,"0","mask"
"15424",32,6,95,107,6702278,6705756,3478,"20","mask"
"15522",32,6,65,108,6708702,6712794,4092,"20","mask"
"15620",32,6,77,109,6715719,6719258,3539,"20","mask"
"15725",32,4,15,110,6722024,6724163,2139,"20","valid"
"15922",32,6,11,111,6730187,6732866,2679,"20","mask"
"16125",32,3,128,112,6739297,6743955,4658,"0","mask"
"16220",32,6,17,113,6747154,6752139,4985,"20","mask"
"16421",32,6,137,114,6758344,6762096,3752,"20","mask"
"16523",32,4,39,115,6764714,6768107,3393,"20","valid"
"16726",32,5,88,116,6774584,6777556,2972,"20","orth"
"16823",32,6,29,117,6780489,6787546,7057,"20","mask"
"17023",32,1,102,118,6793457,6795710,2253,"0","valid"
"17127",32,6,125,119,6798455,6801994,3539,"20","mask"
"17223",32,1,42,120,6805593,6809851,4258,"0","valid"
"17419",32,1,12,121,6816122,6818501,2379,"0","valid"
"17623",32,1,78,122,6824726,6827618,2892,"0","valid"
"17720",32,1,66,123,6830830,6833982,3152,"0","valid"
"17824",32,2,109,124,6836948,6840107,3159,"0","orth"
"17922",32,4,57,125,6842926,6845785,2859,"20","valid"
"18023",32,3,50,126,6848704,6851949,3245,"0","mask"
"18221",32,3,104,127,6857827,6861605,3778,"0","mask"
"18319",32,3,98,128,6864544,6868323,3779,"0","mask"
"18423",32,5,136,129,6871209,6874974,3765,"20","orth"
"18520",32,2,55,130,6877999,6880759,2760,"0","orth"
"18621",32,5,22,131,6883937,6886503,2566,"20","orth"
"18822",32,2,25,132,6892387,6895606,3219,"0","orth"
"19022",32,5,40,133,6901477,6905089,3612,"20","orth"
"19227",32,6,35,134,6911980,6915565,3585,"20","mask"
"19419",32,1,54,135,6922470,6925262,2792,"0","valid"
"19623",32,5,10,136,6932613,6935772,3159,"20","orth"
"19824",32,6,23,137,6941649,6945095,3446,"20","mask"
"20023",32,6,53,138,6950779,6954371,3592,"20","mask"
"10125",33,4,74,1,8222251,8226656,4405,"20","valid"
"11102",33,2,30,2,8229648,8234446,4798,"0","orth"
"13108",33,3,43,3,8240071,8242963,2892,"0","mask"
"15106",33,6,22,4,8249221,8253199,3978,"20","mask"
"17105",33,3,67,5,8259418,8262056,2638,"0","mask"
"18108",33,3,115,6,8265149,8269114,3965,"0","mask"
"19104",33,6,76,7,8273026,8278797,5771,"20","mask"
"2030",33,6,130,8,8282189,8287593,5404,"20","mask"
"2125",33,5,105,9,8290399,8294698,4299,"20","orth"
"2226",33,1,77,10,8298190,8302515,4325,"0","valid"
"2320",33,4,38,11,8305980,8311418,5438,"20","valid"
"2523",33,2,126,12,8317603,8323081,5478,"0","orth"
"2628",33,2,36,13,8326366,8329091,2725,"0","orth"
"2823",33,5,15,14,8337222,8341600,4378,"20","orth"
"3026",33,4,2,15,8347932,8352576,4644,"20","valid"
"3224",33,1,53,16,8359767,8362146,2379,"0","valid"
"3425",33,2,72,17,8367304,8369730,2426,"0","orth"
"3521",33,6,34,18,8373376,8378307,4931,"20","mask"
"3720",33,4,68,19,8384605,8389149,4544,"20","valid"
"3823",33,6,52,20,8393521,8398313,4792,"20","mask"
"4023",33,4,128,21,8404617,8412727,8110,"20","valid"
"4126",33,3,7,22,8415633,8418965,3332,"0","mask"
"4324",33,1,119,23,8425803,8430448,4645,"0","valid"
"4424",33,4,26,24,8433593,8441997,8404,"20","valid"
"4624",33,5,3,25,8450240,8454878,4638,"20","orth"
"4826",33,5,135,26,8461083,8466014,4931,"20","orth"
"4917",33,3,109,27,8469287,8472765,3478,"0","mask"
"5026",33,5,129,28,8475611,8480196,4585,"20","orth"
"5121",33,1,131,29,8505540,8508958,3418,"0","valid"
"5224",33,1,11,30,8511864,8514677,2813,"0","valid"
"5426",33,3,19,31,8520181,8522567,2386,"0","mask"
"5621",33,1,101,32,8531824,8534903,3079,"0","valid"
"5723",33,6,112,33,8537755,8541760,4005,"20","mask"
"5823",33,1,41,34,8544906,8548517,3611,"0","valid"
"6022",33,1,83,35,8555068,8558574,3506,"0","valid"
"6122",33,5,93,36,8561659,8565711,4052,"20","orth"
"6229",33,4,44,37,8568750,8572882,4132,"20","valid"
"6424",33,3,85,38,8578460,8582345,3885,"0","mask"
"6526",33,2,138,39,8585291,8587976,2685,"0","orth"
"6623",33,5,21,40,8590875,8596193,5318,"20","orth"
"6823",33,6,124,41,8601805,8605043,3238,"20","mask"
"6924",33,5,81,42,8608522,8612534,4012,"20","orth"
"7023",33,2,96,43,8615719,8620884,5165,"0","orth"
"7123",33,6,46,44,8623856,8628535,4679,"20","mask"
"7321",33,4,104,45,8634326,8637984,3658,"20","valid"
"7423",33,4,8,46,8641490,8646555,5065,"20","valid"
"7627",33,3,25,47,8653819,8656671,2852,"0","mask"
"7825",33,4,116,48,8661969,8665834,3865,"20","valid"
"7925",33,5,99,49,8669439,8672658,3219,"20","orth"
"8021",33,1,23,50,8675517,8680409,4892,"0","valid"
"8225",33,1,47,51,8686180,8691431,5251,"0","valid"
"8419",33,4,86,52,8698576,8703647,5071,"20","valid"
"8521",33,6,136,53,8708125,8710771,2646,"20","mask"
"8628",33,6,64,54,8714177,8723366,9189,"20","mask"
"8719",33,1,89,55,8727112,8730597,3485,"0","valid"
"8825",33,4,98,56,8772828,8775800,2972,"20","valid"
"8920",33,3,31,57,8778833,8782025,3192,"0","mask"
"9125",33,2,54,58,8789822,8792634,2812,"0","orth"
"9324",33,6,28,59,8799945,8803996,4051,"20","mask"
"9524",33,2,84,60,8811380,8818731,7351,"0","orth"
"9618",33,5,39,61,8821943,8826528,4585,"20","orth"
"9824",33,6,106,62,8831720,8834125,2405,"20","mask"
"9921",33,1,65,63,8837005,8841823,4818,"0","valid"
"10028",33,4,110,64,8845082,8847520,2438,"20","valid"
"10126",33,5,33,65,8850806,8854351,3545,"20","orth"
"10323",33,6,82,66,8912210,8915555,3345,"20","mask"
"10423",33,2,90,67,8919987,8923073,3086,"0","orth"
"10520",33,5,117,68,8926445,8929384,2939,"20","orth"
"10624",33,3,13,69,8932356,8935775,3419,"0","mask"
"10822",33,2,42,70,8940826,8944785,3959,"0","orth"
"11017",33,6,70,71,8951682,8956107,4425,"20","mask"
"11127",33,1,17,72,8959339,8962385,3046,"0","valid"
"11320",33,3,97,73,8968989,8971348,2359,"0","mask"
"11424",33,2,24,74,8975227,8979698,4471,"0","orth"
"11626",33,5,75,75,8986116,8990301,4185,"20","orth"
"11728",33,4,50,76,8993440,8997112,3672,"20","valid"
"11922",33,3,79,77,9002210,9006708,4498,"0","mask"
"12024",33,5,63,78,9010874,9014765,3891,"20","orth"
"12125",33,4,62,79,9019064,9022063,2999,"20","valid"
"12225",33,2,66,80,9025282,9028267,2985,"0","orth"
"12323",33,1,29,81,9032159,9036451,4292,"0","valid"
"12522",33,3,91,82,9041922,9045761,3839,"0","mask"
"12619",33,3,61,83,9048920,9051679,2759,"0","mask"
"12723",33,6,94,84,9054771,9059302,4531,"20","mask"
"12822",33,1,107,85,9062295,9066100,3805,"0","valid"
"12927",33,6,10,86,9068959,9073390,4431,"20","mask"
"13125",33,6,58,87,9080988,9084893,3905,"20","mask"
"13226",33,2,102,88,9088365,9091517,3152,"0","orth"
"13321",33,5,9,89,9095096,9100061,4965,"20","orth"
"13518",33,3,37,90,9105246,9111903,6657,"0","mask"
"13721",33,4,92,91,9118134,9121599,3465,"20","valid"
"13822",33,6,16,92,9124432,9128857,4425,"20","mask"
"14023",33,6,4,93,9135095,9138447,3352,"20","mask"
"14223",33,2,78,94,9151422,9153727,2305,"0","orth"
"14328",33,6,88,95,9157866,9161205,3339,"20","mask"
"14421",33,5,123,96,9165077,9170521,5444,"20","orth"
"14521",33,5,27,97,9175340,9178485,3145,"20","orth"
"14723",33,3,1,98,9184816,9188121,3305,"0","mask"
"14927",33,2,114,99,9196819,9199890,3071,"0","orth"
"15026",33,2,12,100,9207548,9211773,4225,"0","orth"
"15226",33,1,95,101,9274656,9277082,2426,"0","valid"
"15321",33,4,14,102,9280054,9284399,4345,"20","valid"
"15523",33,2,6,103,9290897,9297708,6811,"0","orth"
"15726",33,1,71,104,9302746,9305411,2665,"0","valid"
"15823",33,2,108,105,9308350,9311736,3386,"0","orth"
"15923",33,5,51,106,9370121,9373766,3645,"20","orth"
"16126",33,2,60,107,9379605,9383710,4105,"0","orth"
"16221",33,3,49,108,9386802,9390201,3399,"0","mask"
"16422",33,5,57,109,9397871,9400990,3119,"20","orth"
"16524",33,3,73,110,9404355,9407581,3226,"0","mask"
"16618",33,5,69,111,9416524,9419483,2959,"20","orth"
"16727",33,3,103,112,9424421,9427626,3205,"0","mask"
"16824",33,2,120,113,9430612,9434271,3659,"0","orth"
"16925",33,3,55,114,9437776,9439322,1546,"0","mask"
"17024",33,2,48,115,9443627,9444973,1346,"0","orth"
"17224",33,1,59,116,9452358,9454904,2546,"0","valid"
"17322",33,5,87,117,9458329,9464633,6304,"20","orth"
"17420",33,2,18,118,9479701,9482520,2819,"0","orth"
"17624",33,5,111,119,9488984,9491703,2719,"20","orth"
"17721",33,4,20,120,9495735,9498320,2585,"20","valid"
"17923",33,4,122,121,9504552,9506931,2379,"20","valid"
"18024",33,4,80,122,9510063,9512795,2732,"20","valid"
"18128",33,4,32,123,9516487,9520706,4219,"20","valid"
"18320",33,6,40,124,9526997,9530463,3466,"20","mask"
"18521",33,4,134,125,9537226,9541258,4032,"20","valid"
"18622",33,1,35,126,9544817,9547163,2346,"0","valid"
"18823",33,6,118,127,9554660,9557685,3025,"20","mask"
"18922",33,4,56,128,9562004,9565489,3485,"20","valid"
"19023",33,2,132,129,9568415,9572647,4232,"0","orth"
"19127",33,6,100,130,9576618,9579550,2932,"20","mask"
"19228",33,1,113,131,9584202,9588021,3819,"0","valid"
"19323",33,3,121,132,9590866,9593472,2606,"0","mask"
"19420",33,1,5,133,9598097,9601389,3292,"0","valid"
"19624",33,3,127,134,9609140,9611112,1972,"0","mask"
"19721",33,5,45,135,9614678,9618190,3512,"20","orth"
"19927",33,3,133,136,9625061,9627233,2172,"0","mask"
"20024",33,1,137,137,9631032,9635263,4231,"0","valid"
"20124",33,1,125,138,9641574,9644367,2793,"0","valid"
"10127",34,6,81,1,772970,778168,5198,"20","mask"
"11103",34,6,63,2,781374,786485,5111,"20","mask"
"12107",34,5,68,3,789351,794155,4804,"20","orth"
"13109",34,5,8,4,797541,802499,4958,"20","orth"
"15107",34,1,88,5,809570,814035,4465,"0","valid"
"16103",34,5,32,6,816921,821206,4285,"20","orth"
"18109",34,5,20,7,828037,832555,4518,"20","orth"
"2031",34,4,121,8,840292,844117,3825,"20","valid"
"2126",34,2,107,9,846916,850781,3865,"0","orth"
"2227",34,2,137,10,853507,857372,3865,"0","orth"
"2321",34,6,21,11,860271,865616,5345,"20","mask"
"2524",34,5,110,12,871480,876552,5072,"20","orth"
"2629",34,4,79,13,879890,885808,5918,"20","valid"
"2719",34,2,35,14,889020,892526,3506,"0","orth"
"2924",34,5,80,15,899930,903835,3905,"20","orth"
"3027",34,3,108,16,907174,913205,6031,"0","mask"
"3122",34,1,124,17,916397,919889,3492,"0","valid"
"3225",34,5,62,18,922635,927173,4538,"20","orth"
"3323",34,6,123,19,930138,934650,4512,"20","mask"
"3426",34,6,111,20,938502,943287,4785,"20","mask"
"3522",34,6,9,21,946299,951064,4765,"20","mask"
"3721",34,1,40,22,958581,962960,4379,"0","valid"
"3925",34,6,87,23,970090,974962,4872,"20","mask"
"4024",34,2,125,24,978301,982986,4685,"0","orth"
"4127",34,3,96,25,986045,990430,4385,"0","mask"
"4221",34,3,24,26,993562,1000053,6491,"0","mask"
"4425",34,5,86,27,1006930,1012968,6038,"20","orth"
"4519",34,4,7,28,1016353,1021971,5618,"20","valid"
"4722",34,1,82,29,1030595,1033967,3372,"0","valid"
"4827",34,2,59,30,1036939,1041171,4232,"0","orth"
"4918",34,5,50,31,1044436,1048528,4092,"20","orth"
"5122",34,5,104,32,1055146,1059144,3998,"20","orth"
"5225",34,4,91,33,1062583,1068081,5498,"20","valid"
"5325",34,5,44,34,1071306,1075391,4085,"20","orth"
"5525",34,4,55,35,1083222,1086401,3179,"20","valid"
"5622",34,1,28,36,1089333,1092985,3652,"0","valid"
"5824",34,1,106,37,1100622,1103541,2919,"0","valid"
"5925",34,2,71,38,1110491,1114943,4452,"0","orth"
"6023",34,4,97,39,1139294,1143559,4265,"20","valid"
"6123",34,1,34,40,1146705,1150897,4192,"0","valid"
"6321",34,1,58,41,1158367,1162146,3779,"0","valid"
"6425",34,2,131,42,1164998,1169397,4399,"0","orth"
"6527",34,1,118,43,1172369,1176434,4065,"0","valid"
"6624",34,3,54,44,1179719,1182845,3126,"0","mask"
"6824",34,4,37,45,1191435,1198919,7484,"20","valid"
"7024",34,2,101,46,1206343,1211015,4672,"0","orth"
"7124",34,1,22,47,1213873,1218452,4579,"0","valid"
"7322",34,4,109,48,1225323,1228681,3358,"20","valid"
"7424",34,2,77,49,1259297,1263388,4091,"0","orth"
"7524",34,6,99,50,1266840,1271559,4719,"20","mask"
"7628",34,4,67,51,1274745,1278250,3505,"20","valid"
"7722",34,2,113,52,1281109,1286287,5178,"0","orth"
"7826",34,1,4,53,1289692,1293284,3592,"0","valid"
"8022",34,2,119,54,1299855,1304366,4511,"0","orth"
"8125",34,2,41,55,1307706,1310784,3078,"0","orth"
"8325",34,4,49,56,1316855,1323113,6258,"20","valid"
"8522",34,5,14,57,1328944,1333802,4858,"20","orth"
"8720",34,5,134,58,1339853,1343159,3306,"20","orth"
"8826",34,6,45,59,1346291,1349383,3092,"20","mask"
"9020",34,6,117,60,1355508,1359126,3618,"20","mask"
"9126",34,6,57,61,1362219,1365744,3525,"20","mask"
"9227",34,3,72,62,1368610,1372934,4324,"0","mask"
"9325",34,3,114,63,1376027,1380085,4058,"0","mask"
"9421",34,2,29,64,1383344,1387189,3845,"0","orth"
"9619",34,3,66,65,1393660,1397672,4012,"0","mask"
"9722",34,2,95,66,1458336,1462268,3932,"0","orth"
"9825",34,3,84,67,1465780,1470898,5118,"0","mask"
"9922",34,1,94,68,1474111,1478875,4764,"0","valid"
"10029",34,2,47,69,1481814,1484100,2286,"0","orth"
"10224",34,2,23,70,1490624,1494723,4099,"0","orth"
"10424",34,3,90,71,1500761,1504213,3452,"0","mask"
"10521",34,5,98,72,1507658,1510797,3139,"20","orth"
"10625",34,3,138,73,1513749,1517455,3706,"0","mask"
"10724",34,1,16,74,1520367,1523165,2798,"0","valid"
"10924",34,3,120,75,1603936,1608107,4171,"0","mask"
"11018",34,4,61,76,1611406,1615465,4059,"20","valid"
"11128",34,6,39,77,1618244,1622895,4651,"20","mask"
"11321",34,6,69,78,1629026,1632225,3199,"20","mask"
"11425",34,2,83,79,1635371,1640009,4638,"0","orth"
"11519",34,2,89,80,1643061,1648126,5065,"0","orth"
"11627",34,3,30,81,1651072,1654877,3805,"0","mask"
"11824",34,5,92,82,1661201,1665100,3899,"20","orth"
"11923",34,4,127,83,1668312,1672044,3732,"20","valid"
"12025",34,1,70,84,1675170,1679335,4165,"0","valid"
"12126",34,4,103,85,1682727,1686985,4258,"20","valid"
"12226",34,6,51,86,1689964,1694256,4292,"20","mask"
"12424",34,1,52,87,1700460,1704005,3545,"0","valid"
"12620",34,4,25,88,1710250,1713715,3465,"20","valid"
"12823",34,2,53,89,1719353,1722705,3352,"0","orth"
"13020",34,6,27,90,1728323,1732302,3979,"20","mask"
"13227",34,4,13,91,1738179,1742291,4112,"20","valid"
"13424",34,3,132,92,1747622,1751208,3586,"0","mask"
"13519",34,6,75,93,1754027,1758659,4632,"20","mask"
"13623",34,3,48,94,1761251,1763550,2299,"0","mask"
"13823",34,2,17,95,1770134,1775006,4872,"0","orth"
"14024",34,3,12,96,1782016,1784729,2713,"0","mask"
"14224",34,1,46,97,1790913,1795178,4265,"0","valid"
"14422",34,4,43,98,1801236,1804562,3326,"20","valid"
"14625",34,1,112,99,1811066,1814425,3359,"0","valid"
"14724",34,3,36,100,1817490,1821402,3912,"0","mask"
"14928",34,3,6,101,1827606,1832451,4845,"0","mask"
"15126",34,2,65,102,1840055,1843334,3279,"0","orth"
"15227",34,4,1,103,1846066,1849838,3772,"20","valid"
"15425",34,4,115,104,1855476,1859061,3585,"20","valid"
"15524",34,2,11,105,1861867,1865486,3619,"0","orth"
"15727",34,6,93,106,1871917,1875962,4045,"20","mask"
"15824",34,3,42,107,1878834,1881746,2912,"0","mask"
"16027",34,1,130,108,1890223,1894162,3939,"0","valid"
"16127",34,3,126,109,1897374,1902765,5391,"0","mask"
"16222",34,3,102,110,1905837,1908796,2959,"0","mask"
"16326",34,5,56,111,1911749,1916553,4804,"20","orth"
"16423",34,4,85,112,1919579,1923777,4198,"20","valid"
"16525",34,6,129,113,1926810,1931628,4818,"20","mask"
"16619",34,4,133,114,1934887,1938645,3758,"20","valid"
"16728",34,5,128,115,1941784,1946676,4892,"20","orth"
"16825",34,3,60,116,1950414,1955126,4712,"0","mask"
"16926",34,6,135,117,1958398,1962883,4485,"20","mask"
"17025",34,1,64,118,1966388,1970413,4025,"0","valid"
"17128",34,1,76,119,1973513,1978191,4678,"0","valid"
"17225",34,6,3,120,1981350,1985408,4058,"20","mask"
"17421",34,5,2,121,1992246,1995411,3165,"20","orth"
"17625",34,4,73,122,2003528,2008019,4491,"20","valid"
"17722",34,5,74,123,2011052,2015010,3958,"20","orth"
"17825",34,2,5,124,2017790,2021448,3658,"0","orth"
"18025",34,6,15,125,2027759,2030491,2732,"20","mask"
"18222",34,5,38,126,2036795,2040341,3546,"20","orth"
"18424",34,1,100,127,2046412,2050064,3652,"0","valid"
"18522",34,5,116,128,2053030,2056928,3898,"20","orth"
"18623",34,4,31,129,2059767,2064272,4505,"20","valid"
"18824",34,6,105,130,2074082,2080426,6344,"20","mask"
"18923",34,6,33,131,2083652,2088450,4798,"20","mask"
"19128",34,3,78,132,2094528,2097393,2865,"0","mask"
"19229",34,5,26,133,2100419,2104157,3738,"20","orth"
"19421",34,3,18,134,2112274,2119519,7245,"0","mask"
"19625",34,4,19,135,2125823,2129375,3552,"20","valid"
"19825",34,5,122,136,2137658,2142944,5286,"20","orth"
"19928",34,1,10,137,2146462,2149654,3192,"0","valid"
"20125",34,1,136,138,2156152,2160497,4345,"0","valid"
"10128",35,4,108,1,3395920,3399879,3959,"20","valid"
"11104",35,5,79,2,3403071,3406796,3725,"20","orth"
"12108",35,5,67,3,3412234,3415373,3139,"20","orth"
"13126",35,5,43,4,3418312,3420791,2479,"20","orth"
"15108",35,1,27,5,3427882,3430474,2592,"0","valid"
"17106",35,2,130,6,3436458,3440031,3573,"0","orth"
"18129",35,2,28,7,3443689,3446875,3186,"0","orth"
"2032",35,3,83,8,3453472,3456971,3499,"0","mask"
"2127",35,3,23,9,3459577,3462256,2679,"0","mask"
"2322",35,3,17,10,3467780,3471019,3239,"0","mask"
"2525",35,1,33,11,3477624,3480629,3005,"0","valid"
"2720",35,4,96,12,3486694,3491552,4858,"20","valid"
"2824",35,5,55,13,3494797,3497023,2226,"20","orth"
"2925",35,2,46,14,3500682,3503447,2765,"0","orth"
"3123",35,4,42,15,3509365,3512457,3092,"20","valid"
"3324",35,4,48,16,3518122,3522387,4265,"20","valid"
"3523",35,6,44,17,3528725,3531777,3052,"20","mask"
"3722",35,1,51,18,3537948,3541140,3192,"0","valid"
"3926",35,2,40,19,3546971,3549990,3019,"0","orth"
"4128",35,2,82,20,3557188,3559906,2718,"0","orth"
"4222",35,5,37,21,3562659,3566537,3878,"20","orth"
"4426",35,1,15,22,3573888,3576580,2692,"0","valid"
"4625",35,1,99,23,3582345,3585684,3339,"0","valid"
"4723",35,2,52,24,3588782,3591535,2753,"0","orth"
"4919",35,2,4,25,3599505,3602877,3372,"0","orth"
"5123",35,6,134,26,3609168,3613207,4039,"20","mask"
"5226",35,1,129,27,3616126,3621117,4991,"0","valid"
"5326",35,3,131,28,3624296,3626575,2279,"0","mask"
"5427",35,4,90,29,3629461,3633119,3658,"20","valid"
"5526",35,3,101,30,3636198,3638651,2453,"0","mask"
"5623",35,3,119,31,3642549,3645934,3385,"0","mask"
"5724",35,6,2,32,3649160,3651866,2706,"20","mask"
"5926",35,3,47,33,3658130,3660836,2706,"0","mask"
"6124",35,2,16,34,3666614,3669306,2692,"0","orth"
"6322",35,2,136,35,3675703,3679022,3319,"0","orth"
"6426",35,1,135,36,3682394,3686060,3666,"0","valid"
"6528",35,6,80,37,3689625,3693064,3439,"20","mask"
"6625",35,1,87,38,3697249,3701714,4465,"0","valid"
"6722",35,6,32,39,3706186,3709331,3145,"20","mask"
"6925",35,3,71,40,3715129,3717388,2259,"0","mask"
"7025",35,1,39,41,3720421,3722779,2358,"0","valid"
"7221",35,1,21,42,3728644,3731050,2406,"0","valid"
"7425",35,6,74,43,3740600,3743578,2978,"20","mask"
"7525",35,3,41,44,3746924,3749323,2399,"0","mask"
"7723",35,3,107,45,3755861,3758580,2719,"0","mask"
"7827",35,2,112,46,3761385,3763671,2286,"0","orth"
"7926",35,6,122,47,3767623,3769682,2059,"20","mask"
"8023",35,3,11,48,3772601,3774907,2306,"0","mask"
"8226",35,2,64,49,3784484,3787516,3032,"0","orth"
"8326",35,5,7,50,3790608,3794753,4145,"20","orth"
"8523",35,4,72,51,3801011,3803143,2132,"20","valid"
"8629",35,6,104,52,3807501,3809501,2000,"20","mask"
"8721",35,6,38,53,3813779,3816006,2227,"20","mask"
"8921",35,4,30,54,3821683,3824129,2446,"20","valid"
"9127",35,1,75,55,3829240,3831519,2279,"0","valid"
"9228",35,2,124,56,3834585,3836897,2312,"0","orth"
"9326",35,2,34,57,3839456,3843115,3659,"0","orth"
"9525",35,1,45,58,3849366,3851319,1953,"0","valid"
"9723",35,4,36,59,3857430,3860149,2719,"20","valid"
"9923",35,2,88,60,3866240,3868592,2352,"0","orth"
"10030",35,2,10,61,3871504,3874677,3173,"0","orth"
"10225",35,5,73,62,3881081,3883847,2766,"20","orth"
"10324",35,6,26,63,3886939,3889505,2566,"20","mask"
"10522",35,6,92,64,3896589,3900167,3578,"20","mask"
"10626",35,3,113,65,3903366,3906078,2712,"0","mask"
"10725",35,1,93,66,3957680,3960318,2638,"0","valid"
"10823",35,4,78,67,3963331,3966523,3192,"20","valid"
"10925",35,6,14,68,3970955,3974473,3518,"20","mask"
"11129",35,6,62,69,3980865,3983650,2785,"20","mask"
"11227",35,5,31,70,3986762,3989194,2432,"20","orth"
"11426",35,4,84,71,3994606,3997398,2792,"20","valid"
"11520",35,2,22,72,4001537,4005175,3638,"0","orth"
"11729",35,3,65,73,4010713,4013206,2493,"0","mask"
"11825",35,4,6,74,4017064,4020483,3419,"20","valid"
"12026",35,3,53,75,4025534,4030986,5452,"0","mask"
"12227",35,5,19,76,4036217,4038623,2406,"20","orth"
"12425",35,1,105,77,4044634,4047387,2753,"0","valid"
"12523",35,3,137,78,4056090,4059095,3005,"0","mask"
"12621",35,3,35,79,4094342,4097128,2786,"0","mask"
"12824",35,5,121,80,4103539,4105725,2186,"20","orth"
"12928",35,1,111,81,4108810,4111076,2266,"0","valid"
"13021",35,2,118,82,4115594,4118340,2746,"0","orth"
"13127",35,3,125,83,4121326,4123971,2645,"0","mask"
"13228",35,2,106,84,4126757,4128816,2059,"0","orth"
"13322",35,6,50,85,4131702,4133868,2166,"20","mask"
"13520",35,1,3,86,4140272,4142885,2613,"0","valid"
"13722",35,4,54,87,4148916,4151148,2232,"20","valid"
"13923",35,6,128,88,4157226,4159785,2559,"20","mask"
"14025",35,6,20,89,4162737,4164863,2126,"20","mask"
"14225",35,2,70,90,4171541,4199923,28382,"0","orth"
"14329",35,5,103,91,4202929,4205128,2199,"20","orth"
"14423",35,6,86,92,4214292,4216111,1819,"20","mask"
"14522",35,5,61,93,4218897,4221329,2432,"20","orth"
"14626",35,5,13,94,4226047,4228293,2246,"20","orth"
"14819",35,4,24,95,4234151,4236550,2399,"20","valid"
"15027",35,3,95,96,4242481,4244840,2359,"0","mask"
"15127",35,1,117,97,4247699,4249525,1826,"0","valid"
"15228",35,6,56,98,4252444,4255316,2872,"20","mask"
"15322",35,3,29,99,4258602,4261207,2605,"0","mask"
"15525",35,5,133,100,4267558,4270038,2480,"20","orth"
"15621",35,3,59,101,4273423,4275102,1679,"0","mask"
"15728",35,3,77,102,4277888,4280773,2885,"0","mask"
"15825",35,4,132,103,4283499,4285938,2439,"20","valid"
"15924",35,4,60,104,4289317,4292249,2932,"20","valid"
"16028",35,2,94,105,4295848,4298327,2479,"0","orth"
"16128",35,6,68,106,4301166,4304612,3446,"20","mask"
"16223",35,4,18,107,4307370,4309363,1993,"20","valid"
"16424",35,1,9,108,4316314,4319379,3065,"0","valid"
"16620",35,5,85,109,4327916,4330822,2906,"20","orth"
"16729",35,3,89,110,4359191,4361770,2579,"0","mask"
"16826",35,5,127,111,4365396,4367815,2419,"20","orth"
"16927",35,6,116,112,4373406,4375119,1713,"20","mask"
"17026",35,6,110,113,4378177,4380277,2100,"20","mask"
"17129",35,1,69,114,4383282,4385102,1820,"0","valid"
"17226",35,5,91,115,4393052,4395478,2426,"20","orth"
"17323",35,2,100,116,4401836,4405434,3598,"0","orth"
"17422",35,1,57,117,4411032,4413758,2726,"0","valid"
"17524",35,4,138,118,4437036,4439708,2672,"20","valid"
"17626",35,4,102,119,4442474,4444706,2232,"20","valid"
"17723",35,5,115,120,4448438,4450258,1820,"20","orth"
"17826",35,1,123,121,4453237,4455256,2019,"0","valid"
"17924",35,6,8,122,4458901,4461433,2532,"20","mask"
"18130",35,5,25,123,4473016,4475628,2612,"20","orth"
"18321",35,4,126,124,4481979,4484592,2613,"20","valid"
"18425",35,2,58,125,4487437,4490030,2593,"0","orth"
"18523",35,5,97,126,4492989,4495354,2365,"20","orth"
"18624",35,6,98,127,4499040,4502192,3152,"20","mask"
"18723",35,1,63,128,4505790,4508223,2433,"0","valid"
"18825",35,2,76,129,4511069,4513628,2559,"0","orth"
"18924",35,5,1,130,4517106,4519726,2620,"20","orth"
"19129",35,5,109,131,4526743,4529682,2939,"20","orth"
"19230",35,1,81,132,4532554,4535213,2659,"0","valid"
"19324",35,4,66,133,4538079,4540531,2452,"20","valid"
"19422",35,4,114,134,4543323,4546276,2953,"20","valid"
"19522",35,4,12,135,4549201,4551227,2026,"20","valid"
"19722",35,4,120,136,4558831,4561237,2406,"20","valid"
"19826",35,3,5,137,4564142,4567088,2946,"0","mask"
"20025",35,5,49,138,4573152,4576178,3026,"20","orth"
"10129",36,5,12,1,221658,226682,5024,"20","orth"
"12109",36,6,79,2,233247,237831,4584,"20","mask"
"13128",36,3,52,3,240964,243823,2859,"0","mask"
"15109",36,3,88,4,249900,254266,4366,"0","mask"
"16104",36,4,23,5,257364,260763,3399,"20","valid"
"18131",36,1,50,6,266488,270819,4331,"0","valid"
"2033",36,3,118,7,277950,283861,5911,"0","mask"
"2128",36,5,42,8,287367,291192,3825,"20","orth"
"2323",36,2,99,9,297130,300396,3266,"0","orth"
"2425",36,5,6,10,304100,310378,6278,"20","orth"
"2630",36,1,80,11,316589,320401,3812,"0","valid"
"2721",36,6,67,12,323753,326972,3219,"20","mask"
"2825",36,1,110,13,329744,332950,3206,"0","valid"
"2926",36,1,26,14,336655,340187,3532,"0","valid"
"3124",36,6,133,15,348644,351836,3192,"20","mask"
"3226",36,4,95,16,354782,359360,4578,"20","valid"
"3325",36,6,7,17,362746,368264,5518,"20","mask"
"3524",36,6,25,18,374714,378466,3752,"20","mask"
"3723",36,2,123,19,384504,392001,7497,"0","orth"
"3824",36,6,55,20,394880,397193,2313,"20","mask"
"3927",36,3,10,21,400545,404917,4372,"0","mask"
"4129",36,4,107,22,411288,415026,3738,"20","valid"
"4223",36,4,53,23,418092,422130,4038,"20","valid"
"4427",36,5,54,24,427335,431860,4525,"20","orth"
"4626",36,2,69,25,439111,441690,2579,"0","orth"
"4724",36,6,43,26,444555,448008,3453,"20","mask"
"4920",36,4,137,27,453646,458623,4977,"20","valid"
"5027",36,4,11,28,461729,464555,2826,"20","valid"
"5227",36,3,28,29,471325,477210,5885,"0","mask"
"5428",36,1,86,30,483048,487226,4178,"0","valid"
"5527",36,2,15,31,490432,493617,3185,"0","orth"
"5725",36,2,63,32,499728,505066,5338,"0","orth"
"5825",36,4,71,33,507992,511024,3032,"20","valid"
"5927",36,1,68,34,513797,516796,2999,"0","valid"
"6024",36,1,92,35,520607,525286,4679,"0","valid"
"6125",36,1,32,36,528618,531790,3172,"0","valid"
"6323",36,3,34,37,538247,543399,5152,"0","mask"
"6529",36,3,130,38,550090,553575,3485,"0","mask"
"6626",36,4,17,39,556974,562179,5205,"20","valid"
"6825",36,6,103,40,568723,573188,4465,"20","mask"
"6926",36,4,89,41,576500,580599,4099,"20","valid"
"7026",36,6,13,42,584697,589015,4318,"20","mask"
"7222",36,6,37,43,596393,603423,7030,"20","mask"
"7426",36,2,57,44,609681,612813,3132,"0","orth"
"7526",36,5,126,45,616279,622136,5857,"20","orth"
"7629",36,1,14,46,625302,629887,4585,"0","valid"
"7828",36,4,77,47,636165,640576,4411,"20","valid"
"7927",36,4,47,48,643962,646734,2772,"20","valid"
"8126",36,1,2,49,654258,656710,2452,"0","valid"
"8327",36,3,16,50,664787,667467,2680,"0","mask"
"8524",36,4,59,51,675097,681021,5924,"20","valid"
"8630",36,6,115,52,684480,687772,3292,"20","mask"
"8722",36,2,27,53,691078,694323,3245,"0","orth"
"8922",36,3,112,54,701315,704393,3078,"0","mask"
"9021",36,3,46,55,707625,710624,2999,"0","mask"
"9229",36,4,101,56,716235,719781,3546,"20","valid"
"9327",36,2,51,57,722813,724972,2159,"0","orth"
"9526",36,5,78,58,731063,735555,4492,"20","orth"
"9620",36,6,61,59,738714,744371,5657,"20","mask"
"9724",36,6,85,60,747770,751782,4012,"20","mask"
"9826",36,3,76,61,754728,758320,3592,"0","mask"
"9924",36,2,75,62,761305,766497,5192,"0","orth"
"10031",36,3,124,63,770109,772528,2419,"0","mask"
"10130",36,2,21,64,775520,779332,3812,"0","orth"
"10325",36,4,29,65,785736,790768,5032,"20","valid"
"10523",36,5,96,66,830966,835631,4665,"20","orth"
"10627",36,2,117,67,838783,841816,3033,"0","orth"
"10726",36,6,73,68,845048,849119,4071,"20","mask"
"10824",36,1,20,69,852192,855824,3632,"0","valid"
"11019",36,3,64,70,862548,867279,4731,"0","mask"
"11130",36,1,128,71,870638,875650,5012,"0","valid"
"11228",36,1,62,72,879075,882874,3799,"0","valid"
"11322",36,1,56,73,886279,890071,3792,"0","valid"
"11427",36,3,136,74,893296,896322,3026,"0","mask"
"11521",36,2,81,75,899681,902133,2452,"0","orth"
"11628",36,1,98,76,905052,908498,3446,"0","valid"
"11730",36,4,41,77,911503,914929,3426,"20","valid"
"11924",36,6,19,78,921573,924512,2939,"20","mask"
"12127",36,4,113,79,933682,938306,4624,"20","valid"
"12228",36,1,116,80,941539,945450,3911,"0","valid"
"12324",36,6,31,81,948529,952275,3746,"20","mask"
"12524",36,3,70,82,959872,964563,4691,"0","mask"
"12622",36,3,58,83,968109,972141,4032,"0","mask"
"12724",36,5,72,84,975160,977918,2758,"20","orth"
"12825",36,6,97,85,981911,986202,4291,"20","mask"
"12929",36,6,49,86,989828,993773,3945,"20","mask"
"13129",36,1,8,87,1000384,1002603,2219,"0","valid"
"13323",36,1,134,88,1009241,1011906,2665,"0","valid"
"13425",36,5,48,89,1016384,1019377,2993,"20","orth"
"13624",36,5,102,90,1026641,1028933,2292,"20","orth"
"13723",36,5,18,91,1031685,1034398,2713,"20","orth"
"13924",36,5,108,92,1040442,1043395,2953,"20","orth"
"14026",36,3,22,93,1047220,1050432,3212,"0","mask"
"14226",36,2,111,94,1056916,1060042,3126,"0","orth"
"14330",36,5,84,95,1063207,1066759,3552,"20","orth"
"14424",36,5,36,96,1069925,1073670,3745,"20","orth"
"14627",36,4,5,97,1080108,1083486,3378,"20","valid"
"14820",36,5,30,98,1089251,1091570,2319,"20","orth"
"15028",36,6,91,99,1097555,1100347,2792,"20","mask"
"15128",36,6,127,100,1103266,1106198,2932,"20","mask"
"15229",36,1,104,101,1109210,1114182,4972,"0","valid"
"15323",36,3,106,102,1117420,1119513,2093,"0","mask"
"15426",36,2,39,103,1122825,1125084,2259,"0","orth"
"15622",36,5,114,104,1134761,1139432,4671,"20","orth"
"15729",36,6,121,105,1142498,1145870,3372,"20","mask"
"15826",36,2,3,106,1148529,1152382,3853,"0","orth"
"16029",36,4,35,107,1158372,1161124,2752,"20","valid"
"16224",36,5,66,108,1169108,1171554,2446,"20","orth"
"16327",36,2,93,109,1174680,1176699,2019,"0","orth"
"16425",36,6,109,110,1180017,1183396,3379,"20","mask"
"16526",36,1,38,111,1186742,1189734,2992,"0","valid"
"16730",36,1,44,112,1195065,1197691,2626,"0","valid"
"16928",36,5,132,113,1203722,1206688,2966,"20","orth"
"17027",36,2,33,114,1209580,1212866,3286,"0","orth"
"17227",36,4,65,115,1218337,1220702,2365,"20","valid"
"17324",36,3,94,116,1224848,1228886,4038,"0","mask"
"17423",36,5,138,117,1232018,1235171,3153,"20","orth"
"17525",36,2,87,118,1240136,1243641,3505,"0","orth"
"17627",36,5,24,119,1246753,1250445,3692,"20","orth"
"17827",36,3,40,120,1256656,1260834,4178,"0","mask"
"18026",36,1,74,121,1267565,1271717,4152,"0","valid"
"18132",36,5,90,122,1275169,1277935,2766,"20","orth"
"18223",36,4,131,123,1281907,1285212,3305,"20","valid"
"18322",36,4,125,124,1287824,1291456,3632,"20","valid"
"18426",36,2,105,125,1294788,1297501,2713,"0","orth"
"18524",36,2,9,126,1301286,1305491,4205,"0","orth"
"18724",36,2,45,127,1311496,1313955,2459,"0","orth"
"18925",36,4,119,128,1320033,1324491,4458,"20","valid"
"19024",36,2,129,129,1327277,1331302,4025,"0","orth"
"19130",36,5,60,130,1334500,1338579,4079,"20","orth"
"19231",36,2,135,131,1341998,1345510,3512,"0","orth"
"19325",36,3,82,132,1350195,1352454,2259,"0","mask"
"19423",36,4,83,133,1355526,1360071,4545,"20","valid"
"19523",36,5,120,134,1362890,1365816,2926,"20","orth"
"19626",36,1,122,135,1368575,1370294,1719,"0","valid"
"19723",36,3,4,136,1373360,1375998,2638,"0","mask"
"19929",36,3,100,137,1383896,1387281,3385,"0","mask"
"20026",36,6,1,138,1391860,1394632,2772,"20","mask"
"10131",37,1,43,1,3583816,3587078,3262,"0","valid"
"12128",37,6,126,2,3593281,3598288,5007,"20","mask"
"13130",37,5,17,3,3601648,3605138,3490,"20","orth"
"15129",37,5,41,4,3610975,3614446,3471,"20","orth"
"17107",37,6,96,5,3620629,3624512,3883,"20","mask"
"18133",37,3,63,6,3628172,3631748,3576,"0","mask"
"19105",37,2,92,7,3635316,3638598,3282,"0","orth"
"2034",37,4,76,8,3643676,3648128,4452,"20","valid"
"2129",37,2,62,9,3651468,3654886,3418,"0","orth"
"2228",37,4,106,10,3657854,3661416,3562,"20","valid"
"2324",37,4,10,11,3664645,3669423,4778,"20","valid"
"2526",37,1,115,12,3675652,3679032,3380,"0","valid"
"2631",37,2,50,13,3682195,3685692,3497,"0","orth"
"2826",37,1,79,14,3693346,3696994,3648,"0","valid"
"2927",37,6,84,15,3700406,3703791,3385,"20","mask"
"3028",37,6,72,16,3706785,3709923,3138,"20","mask"
"3125",37,3,93,17,3712846,3715930,3084,"0","mask"
"3227",37,4,46,18,3719309,3723074,3765,"20","valid"
"3427",37,2,14,19,3729976,3733244,3268,"0","orth"
"3625",37,2,80,20,3740160,3745317,5157,"0","orth"
"3724",37,4,40,21,3748631,3752841,4210,"20","valid"
"3928",37,4,58,22,3759253,3762704,3451,"20","valid"
"4025",37,5,83,23,3765717,3769221,3504,"20","orth"
"4130",37,6,60,24,3772319,3776966,4647,"20","mask"
"4224",37,3,39,25,3779836,3782594,2758,"0","mask"
"4428",37,5,125,26,3788582,3791739,3157,"20","orth"
"4520",37,6,24,27,3795150,3798562,3412,"20","mask"
"4725",37,2,8,28,3805341,3809805,4464,"0","orth"
"4921",37,4,124,29,3816433,3818845,2412,"20","valid"
"5028",37,1,55,30,3821544,3824139,2595,"0","valid"
"5124",37,2,98,31,3827303,3829930,2627,"0","orth"
"5228",37,4,16,32,3833068,3836121,3053,"20","valid"
"5429",37,3,75,33,3842291,3846958,4667,"0","mask"
"5528",37,2,134,34,3850494,3853880,3386,"0","orth"
"5624",37,1,49,35,3857475,3860403,2928,"0","valid"
"5826",37,1,25,36,3866240,3869319,3079,"0","valid"
"6025",37,1,133,37,3875489,3879744,4255,"0","valid"
"6126",37,5,11,38,3882509,3885516,3007,"20","orth"
"6324",37,5,137,39,3892190,3896386,4196,"20","orth"
"6427",37,4,82,40,3900099,3902602,2503,"20","valid"
"6530",37,4,4,41,3906151,3909204,3053,"20","valid"
"6723",37,1,7,42,3914877,3918512,3635,"0","valid"
"6927",37,4,64,43,3926545,3929578,3033,"20","valid"
"7027",37,4,112,44,3932369,3935291,2922,"20","valid"
"7125",37,6,66,45,3938095,3940833,2738,"20","mask"
"7223",37,1,85,46,3943788,3948651,4863,"0","valid"
"7323",37,6,114,47,3955638,3959410,3772,"20","mask"
"7427",37,2,26,48,3962561,3966201,3640,"0","orth"
"7630",37,6,12,49,3973019,3976881,3862,"20","mask"
"7829",37,5,107,50,3983170,3986477,3307,"20","orth"
"7928",37,5,53,51,3989425,3992863,3438,"20","orth"
"8127",37,3,27,52,3999203,4004445,5242,"0","mask"
"8328",37,3,9,53,4010295,4013550,3255,"0","mask"
"8525",37,2,68,54,4020179,4023924,3745,"0","orth"
"8631",37,6,6,55,4026800,4030617,3817,"20","mask"
"8827",37,1,91,56,4035866,4040258,4392,"0","valid"
"8923",37,3,45,57,4043265,4046572,3307,"0","mask"
"9128",37,4,34,58,4052802,4057011,4209,"20","valid"
"9328",37,2,110,59,4063881,4066266,2385,"0","orth"
"9422",37,6,132,60,4069280,4072633,3353,"20","mask"
"9527",37,3,33,61,4075692,4078136,2444,"0","mask"
"9725",37,6,30,62,4085216,4088105,2889,"20","mask"
"9925",37,1,1,63,4093889,4097053,3164,"0","valid"
"10132",37,1,67,64,4103034,4105746,2712,"0","valid"
"10226",37,3,69,65,4108557,4111073,2516,"0","mask"
"10326",37,4,136,66,4134905,4138912,4007,"20","valid"
"10425",37,3,21,67,4160011,4162913,2902,"0","mask"
"10628",37,1,19,68,4169725,4172247,2522,"0","valid"
"10825",37,3,99,69,4181725,4186105,4380,"0","mask"
"10926",37,3,87,70,4189196,4193170,3974,"0","mask"
"11020",37,6,108,71,4196203,4198988,2785,"20","mask"
"11131",37,2,38,72,4202125,4205393,3268,"0","orth"
"11323",37,6,90,73,4210904,4214309,3405,"20","mask"
"11428",37,3,117,74,4217538,4219610,2072,"0","mask"
"11522",37,2,116,75,4224610,4229950,5340,"0","orth"
"11629",37,5,113,76,4232996,4235866,2870,"20","orth"
"11731",37,3,3,77,4239219,4242592,3373,"0","mask"
"11925",37,1,127,78,4249122,4251207,2085,"0","valid"
"12027",37,4,70,79,4254089,4258364,4275,"20","valid"
"12129",37,6,120,80,4262541,4265430,2889,"20","mask"
"12229",37,4,130,81,4268875,4272430,3555,"20","valid"
"12325",37,5,77,82,4279614,4282745,3131,"20","orth"
"12426",37,2,20,83,4286065,4288699,2634,"0","orth"
"12623",37,2,74,84,4294634,4298792,4158,"0","orth"
"12725",37,2,56,85,4301707,4305165,3458,"0","orth"
"12826",37,4,100,86,4308354,4310831,2477,"20","valid"
"12930",37,5,59,87,4314009,4317133,3124,"20","orth"
"13022",37,4,88,88,4320506,4323728,3222,"20","valid"
"13131",37,2,2,89,4327316,4330356,3040,"0","orth"
"13324",37,1,109,90,4336958,4339991,3033,"0","valid"
"13426",37,6,36,91,4342618,4345023,2405,"20","mask"
"13625",37,6,138,92,4353651,4356802,3151,"20","mask"
"13724",37,3,111,93,4360077,4363868,3791,"0","mask"
"13824",37,5,5,94,4367261,4370208,2947,"20","orth"
"14027",37,4,28,95,4376588,4379849,3261,"20","valid"
"14227",37,6,54,96,4387909,4390556,2647,"20","mask"
"14425",37,1,31,97,4401080,4405740,4660,"0","valid"
"14628",37,1,37,98,4412917,4415911,2994,"0","valid"
"14821",37,3,81,99,4421963,4424963,3000,"0","mask"
"14929",37,5,35,100,4428186,4431748,3562,"20","orth"
"15130",37,4,22,101,4438585,4441625,3040,"20","valid"
"15324",37,2,128,102,4448442,4452246,3804,"0","orth"
"15427",37,2,104,103,4455266,4458691,3425,"0","orth"
"15526",37,3,123,104,4461757,4465992,4235,"0","mask"
"15623",37,3,105,105,4468862,4471999,3137,"0","mask"
"15730",37,5,71,106,4474869,4478686,3817,"20","orth"
"15827",37,2,32,107,4481575,4485079,3504,"0","orth"
"16030",37,3,15,108,4491504,4494190,2686,"0","mask"
"16225",37,1,97,109,4501956,4505746,3790,"0","valid"
"16328",37,5,101,110,4508649,4511812,3163,"20","orth"
"16426",37,6,18,111,4514545,4517662,3117,"20","mask"
"16621",37,2,122,112,4523826,4526133,2307,"0","orth"
"16731",37,4,94,113,4530454,4534036,3582,"20","valid"
"16827",37,5,23,114,4537095,4539683,2588,"20","orth"
"17028",37,3,51,115,4545534,4548397,2863,"0","mask"
"17228",37,6,42,116,4554279,4556998,2719,"20","mask"
"17424",37,2,44,117,4563097,4565188,2091,"0","orth"
"17628",37,3,129,118,4571437,4574280,2843,"0","mask"
"17724",37,2,86,119,4576974,4579621,2647,"0","orth"
"17828",37,5,95,120,4585347,4588602,3255,"20","orth"
"17925",37,1,73,121,4591805,4594609,2804,"0","valid"
"18027",37,4,52,122,4597701,4601433,3732,"20","valid"
"18224",37,1,61,123,4607655,4610930,3275,"0","valid"
"18323",37,6,102,124,4613924,4616813,2889,"20","mask"
"18427",37,5,47,125,4619826,4622244,2418,"20","orth"
"18625",37,1,103,126,4628147,4632428,4281,"0","valid"
"18725",37,1,13,127,4635755,4639396,3641,"0","valid"
"18926",37,3,57,128,4645482,4648645,3163,"0","mask"
"19025",37,5,131,129,4651429,4654449,3020,"20","orth"
"19131",37,5,119,130,4657326,4660398,3072,"20","orth"
"19232",37,6,48,131,4663411,4665528,2117,"20","mask"
"19424",37,4,118,132,4671555,4674294,2739,"20","valid"
"19524",37,3,135,133,4677202,4680693,3491,"0","mask"
"19627",37,5,89,134,4683974,4686727,2753,"20","orth"
"19724",37,1,121,135,4689608,4693066,3458,"0","valid"
"19827",37,5,65,136,4696308,4699439,3131,"20","orth"
"19930",37,5,29,137,4702367,4705224,2857,"20","orth"
"20126",37,6,78,138,4710969,4713244,2275,"20","mask"
"10133",38,3,26,1,5809323,5813578,4255,"0","mask"
"12130",38,2,37,2,5820880,5828318,7438,"0","orth"
"14109",38,4,3,3,5837404,5842842,5438,"20","valid"
"16105",38,1,30,4,5850783,5855895,5112,"0","valid"
"18134",38,6,47,5,5861922,5865497,3575,"20","mask"
"2035",38,3,104,6,5873040,5877648,4608,"0","mask"
"2130",38,5,94,7,5880786,5884374,3588,"20","orth"
"2229",38,6,59,8,5888433,5892904,4471,"20","mask"
"2325",38,2,73,9,5896002,5900983,4981,"0","orth"
"2426",38,2,49,10,5905768,5908938,3170,"0","orth"
"2632",38,3,80,11,5915409,5919762,4353,"0","mask"
"2722",38,2,13,12,5922834,5928141,5307,"0","orth"
"2928",38,2,25,13,5936979,5939593,2614,"0","orth"
"3126",38,1,60,14,5945300,5950470,5170,"0","valid"
"3228",38,5,100,15,5953679,5957359,3680,"20","orth"
"3326",38,5,130,16,5960869,5964131,3262,"20","orth"
"3428",38,3,110,17,6158765,6162615,3850,"0","mask"
"3525",38,3,68,18,6165628,6169850,4222,"0","mask"
"3626",38,2,43,19,6174635,6178465,3830,"0","orth"
"3825",38,5,106,20,6184204,6187642,3438,"20","orth"
"3929",38,4,93,21,6191094,6193689,2595,"20","valid"
"4026",38,1,114,22,6197428,6200408,2980,"0","valid"
"4131",38,3,86,23,6203990,6206494,2504,"0","mask"
"4225",38,2,67,24,6213912,6216082,2170,"0","orth"
"4325",38,5,118,25,6219423,6221540,2117,"20","orth"
"4429",38,2,103,26,6225357,6229103,3746,"0","orth"
"4521",38,2,121,27,6231874,6234835,2961,"0","orth"
"4627",38,2,97,28,6237522,6241117,3595,"0","orth"
"4726",38,5,46,29,6245097,6249647,4550,"20","orth"
"4922",38,3,92,30,6257092,6261589,4497,"0","mask"
"5029",38,3,62,31,6385322,6388819,3497,"0","mask"
"5125",38,2,55,32,6392009,6395232,3223,"0","orth"
"5229",38,3,50,33,6398578,6401709,3131,"0","mask"
"5430",38,6,107,34,6409912,6413128,3216,"20","mask"
"5529",38,4,87,35,6416403,6421044,4641,"20","valid"
"5625",38,5,124,36,6424501,6428018,3517,"20","orth"
"5726",38,5,52,37,6430966,6433567,2601,"20","orth"
"5928",38,1,132,38,6439437,6442555,3118,"0","valid"
"6026",38,5,70,39,6445470,6450947,5477,"20","orth"
"6127",38,1,138,40,6455079,6458203,3124,"0","valid"
"6230",38,6,53,41,6461641,6465452,3811,"20","mask"
"6428",38,2,115,42,6471622,6475969,4347,"0","orth"
"6531",38,2,79,43,6480035,6482911,2876,"0","orth"
"6627",38,6,95,44,6485943,6490643,4700,"20","mask"
"6724",38,6,83,45,6493924,6498108,4184,"20","mask"
"6826",38,6,41,46,6501304,6504291,2987,"20","mask"
"7028",38,4,75,47,6511311,6514958,3647,"20","valid"
"7126",38,3,32,48,6518102,6521416,3314,"0","mask"
"7324",38,4,129,49,6527430,6531332,3902,"20","valid"
"7428",38,3,116,50,6534254,6539659,5405,"0","mask"
"7527",38,4,21,51,6543535,6548725,5190,"20","valid"
"7724",38,4,15,52,6554713,6558001,3288,"20","valid"
"7929",38,5,58,53,6564504,6567707,3203,"20","orth"
"8024",38,3,14,54,6570949,6573779,2830,"0","mask"
"8227",38,4,123,55,6580106,6585290,5184,"20","valid"
"8329",38,1,78,56,6588153,6591676,3523,"0","valid"
"8420",38,5,22,57,6594807,6597984,3177,"20","orth"
"8632",38,4,105,58,6607187,6610886,3699,"20","valid"
"8723",38,1,36,59,6618782,6621259,2477,"0","valid"
"8924",38,1,72,60,6628214,6631679,3465,"0","valid"
"9022",38,4,45,61,6634725,6638398,3673,"20","valid"
"9230",38,4,57,62,6644006,6647294,3288,"20","valid"
"9329",38,1,24,63,6652517,6656092,3575,"0","valid"
"9528",38,2,61,64,6662746,6667740,4994,"0","orth"
"9621",38,3,20,65,6670707,6675642,4935,"0","mask"
"9827",38,1,96,66,6722201,6725828,3627,"0","valid"
"9926",38,2,109,67,6728724,6730894,2170,"0","orth"
"10032",38,4,63,68,6733581,6735868,2287,"20","valid"
"10134",38,4,135,69,6742078,6744869,2791,"20","valid"
"10227",38,5,88,70,6747869,6751157,3288,"20","orth"
"10327",38,1,84,71,6755438,6758308,2870,"0","valid"
"10426",38,1,12,72,6761341,6763308,1967,"0","valid"
"10629",38,6,17,73,6769368,6771956,2588,"20","mask"
"10826",38,5,4,74,6777688,6780087,2399,"20","orth"
"11021",38,6,35,75,6785839,6788598,2759,"20","mask"
"11229",38,6,131,76,6796520,6799271,2751,"20","mask"
"11324",38,3,134,77,6802193,6804736,2543,"0","mask"
"11429",38,6,101,78,6809233,6811828,2595,"20","mask"
"11523",38,3,98,79,6814743,6817161,2418,"0","mask"
"11630",38,2,1,80,6820671,6822743,2072,"0","orth"
"11826",38,6,5,81,6829300,6833051,3751,"20","mask"
"12028",38,5,40,82,6839235,6842117,2882,"20","orth"
"12230",38,3,38,83,6849523,6853739,4216,"0","mask"
"12427",38,3,128,84,6863609,6867308,3699,"0","mask"
"12525",38,1,108,85,6906102,6908363,2261,"0","valid"
"12624",38,6,23,86,6911338,6913677,2339,"20","mask"
"12827",38,4,51,87,6920756,6923116,2360,"20","valid"
"13023",38,1,54,88,6955497,6958478,2981,"0","valid"
"13229",38,4,69,89,6968668,6972485,3817,"20","valid"
"13325",38,1,126,90,6978578,6981845,3267,"0","valid"
"13427",38,6,119,91,6985166,6987924,2758,"20","mask"
"13521",38,3,8,92,6991310,6993382,2072,"0","mask"
"13725",38,1,42,93,6999847,7002357,2510,"0","valid"
"13925",38,3,122,94,7009396,7011096,1700,"0","mask"
"14028",38,6,89,95,7013730,7016730,3000,"20","mask"
"14128",38,3,56,96,7020175,7023110,2935,"0","mask"
"14228",38,4,117,97,7027489,7030195,2706,"20","valid"
"14331",38,1,18,98,7033254,7035483,2229,"0","valid"
"14523",38,4,99,99,7042163,7044601,2438,"20","valid"
"14629",38,6,11,100,7047752,7050026,2274,"20","mask"
"14822",38,2,133,101,7058740,7062517,3777,"0","orth"
"14930",38,5,76,102,7065707,7068838,3131,"20","orth"
"15029",38,5,82,103,7072074,7076460,4386,"20","orth"
"15131",38,2,85,104,7079656,7083303,3647,"0","orth"
"15230",38,6,113,105,7086859,7091519,4660,"20","mask"
"15325",38,1,120,106,7094513,7096977,2464,"0","valid"
"15428",38,1,66,107,7100716,7104507,3791,"0","valid"
"15527",38,5,112,108,7107475,7110253,2778,"20","orth"
"15624",38,1,102,109,7112992,7116554,3562,"0","valid"
"15731",38,5,136,110,7119763,7122861,3098,"20","orth"
"15828",38,6,125,111,7126162,7128790,2628,"20","mask"
"15925",38,5,34,112,7131744,7134182,2438,"20","orth"
"16129",38,6,65,113,7157687,7161517,3830,"20","mask"
"16226",38,2,31,114,7164694,7167413,2719,"0","orth"
"16427",38,4,111,115,7175022,7177028,2006,"20","valid"
"16527",38,5,64,116,7180467,7182336,1869,"20","orth"
"16622",38,1,90,117,7315757,7318018,2261,"0","valid"
"16732",38,4,33,118,7321313,7323822,2509,"20","valid"
"16929",38,1,48,119,7333398,7334620,1222,"0","valid"
"17130",38,4,39,120,7340242,7343634,3392,"20","valid"
"17325",38,4,27,121,7351713,7355439,3726,"20","valid"
"17526",38,5,28,122,7365420,7369865,4445,"20","orth"
"17725",38,5,10,123,7376297,7380120,3823,"20","orth"
"17926",38,5,16,124,7388297,7391722,3425,"20","orth"
"18135",38,2,19,125,7397834,7401867,4033,"0","orth"
"18324",38,6,137,126,7410920,7413711,2791,"20","mask"
"18428",38,2,7,127,7416822,7421352,4530,"0","orth"
"18626",38,4,9,128,7428156,7431143,2987,"20","valid"
"18826",38,3,2,129,7439236,7442007,2771,"0","mask"
"19026",38,2,127,130,7449962,7453687,3725,"0","orth"
"19132",38,6,71,131,7456544,7459459,2915,"20","mask"
"19233",38,1,6,132,7462283,7463904,1621,"0","valid"
"19425",38,6,29,133,7469865,7472270,2405,"20","mask"
"19628",38,2,91,134,7479983,7483585,3602,"0","orth"
"19725",38,3,44,135,7487833,7490173,2340,"0","mask"
"19931",38,6,77,136,7499632,7502455,2823,"20","mask"
"20027",38,4,81,137,7507247,7509697,2450,"20","valid"
"20127",38,3,74,138,7513221,7515312,2091,"0","mask"
"10135",39,2,66,1,8177893,8182461,4568,"0","orth"
"11105",39,6,34,2,8185540,8189788,4248,"20","mask"
"13132",39,4,2,3,8200561,8203783,3222,"20","valid"
"15132",39,1,23,4,8210770,8213986,3216,"0","valid"
"17108",39,4,86,5,8219771,8222588,2817,"20","valid"
"18136",39,1,53,6,8230158,8233386,3228,"0","valid"
"2036",39,6,118,7,8240040,8243897,3857,"20","mask"
"2131",39,3,127,8,8247191,8252583,5392,"0","mask"
"2230",39,1,83,9,8256336,8261643,5307,"0","valid"
"2326",39,5,27,10,8264853,8271010,6157,"20","orth"
"2527",39,6,136,11,8283259,8287762,4503,"20","mask"
"2633",39,6,112,12,8292279,8296194,3915,"20","mask"
"2723",39,2,108,13,8300097,8304378,4281,"0","orth"
"2827",39,3,97,14,8308241,8312457,4216,"0","mask"
"2929",39,4,110,15,8316418,8320072,3654,"20","valid"
"3029",39,3,49,16,8323621,8329039,5418,"0","mask"
"3229",39,2,36,17,8335419,8338073,2654,"0","orth"
"3429",39,3,55,18,8345544,8349257,3713,"0","mask"
"3526",39,2,54,19,8352335,8355440,3105,"0","orth"
"3725",39,5,99,20,8364278,8369539,5261,"20","orth"
"3826",39,3,43,21,8372938,8376651,3713,"0","mask"
"4027",39,4,56,22,8383697,8390952,7255,"20","valid"
"4132",39,5,111,23,8396103,8400593,4490,"20","orth"
"4226",39,6,4,24,8405411,8409646,4235,"20","mask"
"4430",39,4,50,25,8417019,8420745,3726,"20","valid"
"4628",39,6,10,26,8431805,8436674,4869,"20","mask"
"4828",39,1,17,27,8445243,8449185,3942,"0","valid"
"5030",39,2,90,28,8456676,8461173,4497,"0","orth"
"5126",39,2,24,29,8464513,8469167,4654,"0","orth"
"5327",39,1,11,30,8475971,8478579,2608,"0","valid"
"5530",39,5,75,31,8485018,8491469,6451,"20","orth"
"5626",39,6,70,32,8494743,8499757,5014,"20","mask"
"5727",39,3,19,33,8502783,8508032,5249,"0","mask"
"5929",39,5,135,34,8515523,8518889,3366,"20","orth"
"6027",39,4,128,35,8522844,8527465,4621,"20","valid"
"6128",39,4,116,36,8530805,8536910,6105,"20","valid"
"6231",39,2,102,37,8540047,8543158,3111,"0","orth"
"6325",39,3,37,38,8550832,8555264,4432,"0","mask"
"6532",39,2,78,39,8561885,8565101,3216,"0","orth"
"6628",39,1,47,40,8568206,8571383,3177,"0","valid"
"6827",39,2,84,41,8578233,8580945,2712,"0","orth"
"6928",39,4,92,42,8587090,8592351,5261,"20","valid"
"7029",39,2,126,43,8610169,8614555,4386,"0","orth"
"7127",39,1,29,44,8617804,8620837,3033,"0","valid"
"7325",39,1,71,45,8627615,8630053,2438,"0","valid"
"7429",39,4,98,46,8633079,8636844,3765,"20","valid"
"7528",39,4,134,47,8640080,8643198,3118,"20","valid"
"7631",39,6,124,48,8646296,8649688,3392,"20","mask"
"7725",39,2,96,49,8652702,8656238,3536,"0","orth"
"7830",39,2,120,50,8659415,8663108,3693,"0","orth"
"7930",39,1,59,51,8666395,8669945,3550,"0","valid"
"8025",39,1,107,52,8673102,8676239,3137,"0","valid"
"8128",39,3,79,53,8681017,8685959,4942,"0","mask"
"8228",39,3,61,54,8689619,8693737,4118,"0","mask"
"8330",39,2,12,55,8697123,8700169,3046,"0","orth"
"8526",39,6,82,56,8706594,8709536,2942,"20","mask"
"8633",39,5,9,57,8716582,8720170,3588,"20","orth"
"8828",39,4,68,58,8726850,8730119,3269,"20","valid"
"8925",39,1,119,59,8733302,8737701,4399,"0","valid"
"9023",39,5,15,60,8740864,8743871,3007,"20","orth"
"9231",39,3,103,61,8750780,8755375,4595,"0","mask"
"9330",39,6,40,62,8759467,8764069,4602,"20","mask"
"9529",39,3,133,63,8772337,8775710,3373,"0","mask"
"9622",39,3,115,64,8778834,8782906,4072,"0","mask"
"9726",39,4,14,65,8786253,8791554,5301,"20","valid"
"9927",39,5,117,66,8848440,8851806,3366,"20","orth"
"10033",39,3,121,67,8856147,8859715,3568,"0","mask"
"10136",39,4,8,68,8863219,8867350,4131,"20","valid"
"10328",39,6,76,69,8873108,8878272,5164,"20","mask"
"10427",39,5,63,70,8881325,8884658,3333,"20","orth"
"10524",39,1,5,71,8887652,8890750,3098,"0","valid"
"10727",39,3,13,72,8897711,8901705,3994,"0","mask"
"10927",39,2,6,73,8909438,8913235,3797,"0","orth"
"11132",39,5,3,74,8919197,8922315,3118,"20","orth"
"11325",39,5,129,75,8929027,8934420,5393,"20","orth"
"11430",39,6,46,76,8938289,8943355,5066,"20","mask"
"11631",39,1,77,77,8949832,8953440,3608,"0","valid"
"11732",39,5,93,78,8956356,8959500,3144,"20","orth"
"11827",39,6,22,79,8963030,8966814,3784,"20","mask"
"12029",39,5,39,80,8973678,8977677,3999,"20","orth"
"12231",39,5,21,81,8984096,8987587,3491,"20","orth"
"12428",39,1,95,82,8993764,8999581,5817,"0","valid"
"12526",39,3,109,83,9002842,9007013,4171,"0","mask"
"12625",39,2,72,84,9010078,9013771,3693,"0","orth"
"12726",39,3,73,85,9016595,9020484,3889,"0","mask"
"12828",39,5,33,86,9023792,9028014,4222,"20","orth"
"13024",39,6,100,87,9034067,9038021,3954,"20","mask"
"13133",39,5,123,88,9042335,9048944,6609,"20","orth"
"13230",39,5,87,89,9052493,9058023,5530,"20","orth"
"13326",39,2,114,90,9061677,9065539,3862,"0","orth"
"13428",39,3,67,91,9068939,9074004,5065,"0","mask"
"13522",39,1,101,92,9077495,9080122,2627,"0","valid"
"13626",39,2,60,93,9083077,9087005,3928,"0","orth"
"13726",39,2,42,94,9090038,9093123,3085,"0","orth"
"13926",39,6,88,95,9100176,9104215,4039,"20","mask"
"14029",39,5,51,96,9107765,9111863,4098,"20","orth"
"14229",39,2,30,97,9118412,9120824,2412,"0","orth"
"14426",39,4,104,98,9127714,9131812,4098,"20","valid"
"14524",39,3,1,99,9135603,9138446,2843,"0","mask"
"14725",39,4,32,100,9145329,9149663,4334,"20","valid"
"14931",39,3,91,101,9156899,9160441,3542,"0","mask"
"15030",39,6,106,102,9163651,9167769,4118,"20","mask"
"15133",39,1,125,103,9170886,9174625,3739,"0","valid"
"15231",39,2,48,104,9177168,9179135,1967,"0","orth"
"15429",39,4,20,105,9187286,9190718,3432,"20","valid"
"15625",39,1,113,106,9199379,9202438,3059,"0","valid"
"15732",39,4,44,107,9205987,9209373,3386,"20","valid"
"15926",39,4,122,108,9215661,9219243,3582,"20","valid"
"16031",39,4,38,109,9221936,9226197,4261,"20","valid"
"16227",39,6,58,110,9232767,9237159,4392,"20","mask"
"16329",39,6,64,111,9240754,9244055,3301,"20","mask"
"16428",39,5,81,112,9247493,9251944,4451,"20","orth"
"16528",39,1,41,113,9254938,9258088,3150,"0","valid"
"16733",39,5,69,114,9263703,9267912,4209,"20","orth"
"16828",39,4,62,115,9270658,9274913,4255,"20","valid"
"16930",39,2,138,116,9277972,9280567,2595,"0","orth"
"17029",39,5,57,117,9283737,9287293,3556,"20","orth"
"17131",39,3,85,118,9291437,9295986,4549,"0","mask"
"17229",39,6,52,119,9298947,9301797,2850,"20","mask"
"17425",39,1,65,120,9309621,9312700,3079,"0","valid"
"17527",39,1,131,121,9316315,9318916,2601,"0","valid"
"17629",39,6,130,122,9322230,9327766,5536,"20","mask"
"17726",39,4,74,123,9331244,9335440,4196,"20","valid"
"17829",39,5,45,124,9338820,9342466,3646,"20","orth"
"18028",39,6,94,125,9349435,9354095,4660,"20","mask"
"18137",39,2,132,126,9357108,9361657,4549,"0","orth"
"18225",39,6,16,127,9365102,9369239,4137,"20","mask"
"18429",39,1,137,128,9376874,9381861,4987,"0","valid"
"18525",39,3,25,129,9385045,9388372,3327,"0","mask"
"18726",39,4,26,130,9394562,9397627,3065,"20","valid"
"18927",39,1,35,131,9404824,9408131,3307,"0","valid"
"19133",39,3,31,132,9415256,9418707,3451,"0","mask"
"19326",39,1,89,133,9425250,9429309,4059,"0","valid"
"19426",39,3,7,134,9432355,9438192,5837,"0","mask"
"19629",39,5,105,135,9446173,9450121,3948,"20","orth"
"19726",39,2,18,136,9452762,9455507,2745,"0","orth"
"19932",39,6,28,137,9461618,9466566,4948,"20","mask"
"20128",39,4,80,138,9472488,9476815,4327,"20","valid"
"10137",40,1,52,1,10448697,10453051,4354,"0","valid"
"12131",40,3,120,2,10484301,10487386,3085,"0","mask"
"13134",40,4,121,3,10491249,10495838,4589,"20","valid"
"14129",40,6,3,4,10498622,10503603,4981,"20","mask"
"16106",40,1,94,5,10510218,10513891,3673,"0","valid"
"17109",40,5,74,6,10517565,10521839,4274,"20","orth"
"18138",40,6,129,7,10530043,10535167,5124,"20","mask"
"19106",40,6,63,8,10538207,10541481,3274,"20","mask"
"2037",40,2,89,9,10544410,10548501,4091,"0","orth"
"2132",40,5,38,10,10551737,10554757,3020,"20","orth"
"2327",40,3,108,11,10562444,10566019,3575,"0","mask"
"2427",40,1,46,12,10570032,10573764,3732,"0","valid"
"2634",40,1,112,13,10579575,10582706,3131,"0","valid"
"2724",40,2,65,14,10586243,10589380,3137,"0","orth"
"2828",40,5,104,15,10593341,10599171,5830,"20","orth"
"2930",40,6,69,16,10602610,10605283,2673,"20","mask"
"3030",40,5,80,17,10608126,10614401,6275,"20","orth"
"3127",40,4,61,18,10617846,10621787,3941,"20","valid"
"3230",40,6,123,19,10625409,10629892,4483,"20","mask"
"3327",40,3,24,20,10633599,10637429,3830,"0","mask"
"3527",40,6,51,21,10647992,10651142,3150,"20","mask"
"3726",40,3,126,22,10658078,10661189,3111,"0","mask"
"3827",40,5,26,23,10665006,10669189,4183,"20","orth"
"4028",40,1,118,24,10677798,10681589,3791,"0","valid"
"4133",40,4,7,25,10684883,10690086,5203,"20","valid"
"4326",40,2,101,26,10698224,10701669,3445,"0","orth"
"4431",40,5,122,27,10704584,10707525,2941,"20","orth"
"4522",40,3,96,28,10710310,10714107,3797,"0","mask"
"4629",40,5,2,29,10717447,10720820,3373,"20","orth"
"4829",40,4,19,30,10726722,10729435,2713,"20","valid"
"5031",40,6,105,31,10737501,10741057,3556,"20","mask"
"5127",40,4,109,32,10744541,10750025,5484,"20","valid"
"5230",40,6,135,33,10754437,10758679,4242,"20","mask"
"5328",40,6,9,34,10762241,10766431,4190,"20","mask"
"5531",40,5,86,35,10775059,10779118,4059,"20","orth"
"5627",40,1,100,36,10782517,10786622,4105,"0","valid"
"5728",40,4,37,37,10789701,10793930,4229,"20","valid"
"5930",40,1,82,38,10800348,10804447,4099,"0","valid"
"6028",40,6,87,39,10808709,10814911,6202,"20","mask"
"6129",40,6,93,40,10818794,10821892,3098,"20","mask"
"6232",40,1,28,41,10825193,10828977,3784,"0","valid"
"6429",40,6,81,42,10836181,10839456,3275,"20","mask"
"6533",40,2,17,43,10843129,10849711,6582,"0","orth"
"6725",40,5,98,44,10856032,10859777,3745,"20","orth"
"6828",40,3,114,45,10863039,10865882,2843,"0","mask"
"6929",40,6,45,46,10868987,10872778,3791,"20","mask"
"7128",40,2,41,47,10879340,10882785,3445,"0","orth"
"7326",40,6,99,48,10888844,10893185,4341,"20","mask"
"7430",40,4,67,49,10896819,10901996,5177,"20","valid"
"7529",40,3,36,50,10905427,10908199,2772,"0","mask"
"7726",40,1,124,51,10915415,10918990,3575,"0","valid"
"7831",40,3,138,52,10922598,10926357,3759,"0","mask"
"7931",40,6,27,53,10929383,10932180,2797,"20","mask"
"8129",40,4,55,54,10937711,10940462,2751,"20","valid"
"8229",40,3,72,55,10943554,10946607,3053,"0","mask"
"8331",40,3,102,56,10949286,10951678,2392,"0","mask"
"8421",40,2,23,57,10954908,10957032,2124,"0","orth"
"8634",40,2,131,58,10963274,10966046,2772,"0","orth"
"8724",40,1,106,59,10970242,10972360,2118,"0","valid"
"8829",40,5,68,60,10975275,10979367,4092,"20","orth"
"8926",40,2,71,61,10982798,10986158,3360,"0","orth"
"9024",40,2,47,62,10988831,10991086,2255,"0","orth"
"9232",40,4,25,63,10997662,11001623,3961,"20","valid"
"9423",40,1,88,64,11007042,11010800,3758,"0","valid"
"9530",40,2,95,65,11014003,11017886,3883,"0","orth"
"9623",40,1,4,66,11051234,11054836,3602,"0","valid"
"9828",40,4,91,67,11060379,11064045,3666,"20","valid"
"9928",40,2,113,68,11066941,11069301,2360,"0","orth"
"10034",40,2,107,69,11071961,11075511,3550,"0","orth"
"10138",40,2,119,70,11078622,11082099,3477,"0","orth"
"10228",40,4,127,71,11085315,11089015,3700,"20","valid"
"10329",40,5,134,72,11092054,11095224,3170,"20","orth"
"10428",40,3,18,73,11098388,11100780,2392,"0","mask"
"10630",40,3,132,74,11106578,11109663,3085,"0","mask"
"10728",40,1,34,75,11112304,11115892,3588,"0","valid"
"10928",40,4,115,76,11123291,11126128,2837,"20","valid"
"11022",40,6,111,77,11129462,11132272,2810,"20","mask"
"11133",40,4,73,78,11135390,11139292,3902,"20","valid"
"11230",40,1,40,79,11142724,11147156,4432,"0","valid"
"11431",40,5,56,80,11153071,11157457,4386,"20","orth"
"11524",40,2,5,81,11160908,11164124,3216,"0","orth"
"11733",40,3,84,82,11172060,11175876,3816,"0","mask"
"11828",40,5,62,83,11178707,11182282,3575,"20","orth"
"11926",40,3,90,84,11184904,11187132,2228,"0","mask"
"12030",40,3,54,85,11189826,11192472,2646,"0","mask"
"12232",40,1,64,86,11199427,11203173,3746,"0","valid"
"12326",40,2,83,87,11207369,11213108,5739,"0","orth"
"12429",40,4,1,88,11216409,11219370,2961,"20","valid"
"12626",40,4,13,89,11225017,11229187,4170,"20","valid"
"12829",40,5,8,90,11237351,11240901,3550,"20","orth"
"13025",40,6,21,91,11247522,11250927,3405,"20","mask"
"13231",40,1,22,92,11257032,11260876,3844,"0","valid"
"13429",40,4,97,93,11273014,11275550,2536,"20","valid"
"13523",40,4,85,94,11279354,11284060,4706,"20","valid"
"13627",40,2,137,95,11287217,11290538,3321,"0","orth"
"13727",40,6,15,96,11293388,11296754,3366,"20","mask"
"13927",40,3,60,97,11302173,11305088,2915,"0","mask"
"14030",40,2,35,98,11308389,11311278,2889,"0","orth"
"14230",40,5,14,99,11324782,11328566,3784,"20","orth"
"14427",40,5,92,100,11334574,11338789,4215,"20","orth"
"14525",40,6,33,101,11342162,11346542,4380,"20","mask"
"14726",40,6,75,102,11352706,11356241,3535,"20","mask"
"14823",40,6,39,103,11360353,11362804,2451,"20","mask"
"15031",40,5,44,104,11368805,11370883,2078,"20","orth"
"15232",40,1,130,105,11376701,11379459,2758,"0","valid"
"15326",40,4,31,106,11382511,11385976,3465,"20","valid"
"15528",40,3,30,107,11394519,11397179,2660,"0","mask"
"15733",40,3,78,108,11403082,11406212,3130,"0","mask"
"15829",40,5,20,109,11409154,11411683,2529,"20","orth"
"16032",40,1,70,110,11418180,11421723,3543,"0","valid"
"16130",40,4,43,111,11425540,11428044,2504,"20","valid"
"16330",40,1,58,112,11433463,11437195,3732,"0","valid"
"16429",40,4,103,113,11440018,11443175,3157,"20","valid"
"16529",40,4,79,114,11446411,11449241,2830,"20","valid"
"16623",40,3,6,115,11452098,11455856,3758,"0","mask"
"16829",40,2,59,116,11463759,11466824,3065,"0","orth"
"16931",40,3,48,117,11469393,11471530,2137,"0","mask"
"17132",40,5,50,118,11477283,11480368,3085,"20","orth"
"17326",40,6,117,119,11485806,11488309,2503,"20","mask"
"17426",40,4,49,120,11491218,11495114,3896,"20","valid"
"17630",40,5,116,121,11500722,11504010,3288,"20","orth"
"17727",40,6,57,122,11507291,11510984,3693,"20","mask"
"17830",40,2,53,123,11513854,11517828,3974,"0","orth"
"18029",40,1,76,124,11522893,11526031,3138,"0","valid"
"18139",40,1,16,125,11529397,11531770,2373,"0","valid"
"18325",40,1,10,126,11538868,11542470,3602,"0","valid"
"18526",40,2,29,127,11548326,11551954,3628,"0","orth"
"18727",40,5,128,128,11559269,11563530,4261,"20","orth"
"18827",40,2,11,129,11567001,11569007,2006,"0","orth"
"19027",40,5,32,130,11574158,11577047,2889,"20","orth"
"19234",40,3,42,131,11582499,11585584,3085,"0","mask"
"19427",40,1,136,132,11591976,11595859,3883,"0","valid"
"19525",40,3,66,133,11600193,11604467,4274,"0","mask"
"19630",40,4,133,134,11607298,11610808,3510,"20","valid"
"19727",40,5,110,135,11613912,11617266,3354,"20","orth"
"19828",40,2,77,136,11620148,11622547,2399,"0","orth"
"19933",40,2,125,137,11625345,11627220,1875,"0","orth"
"20028",40,3,12,138,11629979,11632208,2229,"0","mask"
"10139",41,6,110,1,12978586,12982004,3418,"20","mask"
"11106",41,4,24,2,12985331,12991076,5745,"20","valid"
"13135",41,2,58,3,12999260,13003620,4360,"0","orth"
"14130",41,2,22,4,13007208,13011529,4321,"0","orth"
"16107",41,5,31,5,13019608,13025856,6248,"20","orth"
"18140",41,1,93,6,13033602,13036812,3210,"0","valid"
"19107",41,6,68,7,13039753,13044204,4451,"20","mask"
"2038",41,2,70,8,13047387,13052159,4772,"0","orth"
"2133",41,2,64,9,13055094,13059754,4660,"0","orth"
"2231",41,5,103,10,13062820,13067179,4359,"20","orth"
"2328",41,3,113,11,13070147,13073892,3745,"0","mask"
"2428",41,5,91,12,13077108,13080893,3785,"20","orth"
"2528",41,2,106,13,13083684,13086508,2824,"0","orth"
"2635",41,2,100,14,13089848,13094305,4457,"0","orth"
"2725",41,3,77,15,13097450,13102437,4987,"0","mask"
"2829",41,4,96,16,13105614,13112156,6542,"20","valid"
"2931",41,4,48,17,13115150,13117771,2621,"20","valid"
"3128",41,4,36,18,13124536,13127445,2909,"20","valid"
"3328",41,1,9,19,13134321,13139014,4693,"0","valid"
"3528",41,3,101,20,13145446,13148610,3164,"0","mask"
"3627",41,2,16,21,13151479,13155283,3804,"0","orth"
"3828",41,6,50,22,13161565,13165912,4347,"20","mask"
"4029",41,3,125,23,13171807,13176383,4576,"0","mask"
"4134",41,6,56,24,13179357,13187214,7857,"20","mask"
"4227",41,6,134,25,13190063,13197116,7053,"20","mask"
"4327",41,6,38,26,13200051,13203215,3164,"20","mask"
"4523",41,2,28,27,13210091,13215627,5536,"0","orth"
"4727",41,4,66,28,13222569,13227236,4667,"20","valid"
"4830",41,1,3,29,13230439,13235138,4699,"0","valid"
"5032",41,2,94,30,13241106,13247734,6628,"0","orth"
"5128",41,3,89,31,13251846,13257826,5980,"0","mask"
"5231",41,2,40,32,13260944,13264546,3602,"0","orth"
"5431",41,6,26,33,13270402,13275448,5046,"20","mask"
"5628",41,5,49,34,13281893,13286220,4327,"20","orth"
"5827",41,6,92,35,13292325,13298724,6399,"20","mask"
"5931",41,4,30,36,13301855,13306241,4386,"20","valid"
"6130",41,2,4,37,13311791,13315209,3418,"0","orth"
"6326",41,3,119,38,13321275,13327491,6216,"0","mask"
"6430",41,1,81,39,13330700,13334413,3713,"0","valid"
"6534",41,5,127,40,13337420,13342302,4882,"20","orth"
"6629",41,1,33,41,13345786,13352205,6419,"0","valid"
"6829",41,5,115,42,13358924,13363944,5020,"20","orth"
"6930",41,5,133,43,13367258,13372089,4831,"20","orth"
"7030",41,6,98,44,13375141,13381089,5948,"20","mask"
"7129",41,3,137,45,13384220,13388358,4138,"0","mask"
"7224",41,3,53,46,13391391,13396156,4765,"0","mask"
"7431",41,3,65,47,13401790,13405411,3621,"0","mask"
"7530",41,5,73,48,13408411,13412666,4255,"20","orth"
"7632",41,4,78,49,13415569,13418915,3346,"20","valid"
"7727",41,6,74,50,13421844,13427066,5222,"20","mask"
"7832",41,1,63,51,13431831,13436694,4863,"0","valid"
"7932",41,3,59,52,13439904,13445355,5451,"0","mask"
"8026",41,6,104,53,13448898,13456258,7360,"20","mask"
"8130",41,2,124,54,13459277,13463317,4040,"0","orth"
"8230",41,6,8,55,13466539,13471082,4543,"20","mask"
"8422",41,4,90,56,13477030,13481619,4589,"20","valid"
"8527",41,5,97,57,13484724,13489352,4628,"20","orth"
"8635",41,1,39,58,13492175,13495783,3608,"0","valid"
"8830",41,1,123,59,13501817,13507699,5882,"0","valid"
"8927",41,2,88,60,13511359,13515922,4563,"0","orth"
"9025",41,4,84,61,13519144,13523648,4504,"20","valid"
"9129",41,2,130,62,13526720,13531230,4510,"0","orth"
"9233",41,1,51,63,13534243,13538263,4020,"0","valid"
"9424",41,6,122,64,13545009,13547538,2529,"20","mask"
"9531",41,3,5,65,13550591,13554768,4177,"0","mask"
"9727",41,3,41,66,13596653,13600581,3928,"0","mask"
"9929",41,5,43,67,13606327,13609255,2928,"20","orth"
"10140",41,1,105,68,13614399,13618635,4236,"0","valid"
"10229",41,4,108,69,13621759,13628256,6497,"20","valid"
"10330",41,2,10,70,13631590,13638754,7164,"0","orth"
"10525",41,2,136,71,13646002,13649898,3896,"0","orth"
"10631",41,4,120,72,13652984,13657448,4464,"20","valid"
"10729",41,1,99,73,13660670,13665618,4948,"0","valid"
"10827",41,4,138,74,13668919,13674684,5765,"20","valid"
"10929",41,4,72,75,13678462,13681162,2700,"20","valid"
"11023",41,2,112,76,13684025,13686999,2974,"0","orth"
"11134",41,5,67,77,13689822,13694130,4308,"20","orth"
"11231",41,3,29,78,13697450,13703039,5589,"0","mask"
"11432",41,6,2,79,13709909,13714752,4843,"20","mask"
"11632",41,2,46,80,13721511,13725936,4425,"0","orth"
"11829",41,5,79,81,13732185,13736623,4438,"20","orth"
"11927",41,1,27,82,13739440,13744133,4693,"0","valid"
"12132",41,1,75,83,13749918,13755689,5771,"0","valid"
"12233",41,6,20,84,13759213,13763174,3961,"20","mask"
"12430",41,3,11,85,13769775,13774880,5105,"0","mask"
"12627",41,4,12,86,13782901,13786783,3882,"20","valid"
"12830",41,4,18,87,13791868,13797045,5177,"20","valid"
"13026",41,2,82,88,13805176,13811118,5942,"0","orth"
"13136",41,4,42,89,13814177,13818837,4660,"20","valid"
"13327",41,1,117,90,13824498,13826969,2471,"0","valid"
"13430",41,5,25,91,13829799,13834401,4602,"20","orth"
"13628",41,6,116,92,13840904,13846205,5301,"20","mask"
"13728",41,2,52,93,13849238,13853062,3824,"0","orth"
"13928",41,5,1,94,13859827,13865605,5778,"20","orth"
"14131",41,6,86,95,13873737,13878129,4392,"20","mask"
"14231",41,4,114,96,13880770,13884731,3961,"20","valid"
"14332",41,3,95,97,13887737,13893032,5295,"0","mask"
"14428",41,4,54,98,13898150,13901444,3294,"20","valid"
"14630",41,1,129,99,13908340,13914099,5759,"0","valid"
"14727",41,2,34,100,13917616,13925008,7392,"0","orth"
"14932",41,5,13,101,13931793,13936505,4712,"20","orth"
"15134",41,1,21,102,13942251,13946199,3948,"0","valid"
"15327",41,5,37,103,13956213,13960572,4359,"20","orth"
"15529",41,6,80,104,13967972,13974449,6477,"20","mask"
"15626",41,3,35,105,13977672,13982855,5183,"0","mask"
"15830",41,3,47,106,13989274,13992771,3497,"0","mask"
"16033",41,6,14,107,13999451,14004974,5523,"20","mask"
"16228",41,4,132,108,14013079,14018831,5752,"20","valid"
"16331",41,3,107,109,14022145,14026511,4366,"0","mask"
"16430",41,5,109,110,14029682,14035460,5778,"20","orth"
"16530",41,1,111,111,14038774,14043826,5052,"0","valid"
"16624",41,5,7,112,14047095,14052134,5039,"20","orth"
"16830",41,5,121,113,14059337,14064135,4798,"20","orth"
"16932",41,4,126,114,14067272,14071724,4452,"20","valid"
"17030",41,3,23,115,14074783,14077901,3118,"0","mask"
"17230",41,1,15,116,14084437,14087797,3360,"0","valid"
"17427",41,3,131,117,14094850,14099523,4673,"0","mask"
"17528",41,5,61,118,14102497,14107445,4948,"20","orth"
"17631",41,2,76,119,14110661,14114825,4164,"0","orth"
"17728",41,6,62,120,14117733,14123329,5596,"20","mask"
"17831",41,1,87,121,14126760,14132140,5380,"0","valid"
"17927",41,5,19,122,14135290,14140271,4981,"20","orth"
"18141",41,4,60,123,14146663,14151638,4975,"20","valid"
"18226",41,4,102,124,14156265,14160187,3922,"20","valid"
"18326",41,6,44,125,14163338,14167652,4314,"20","mask"
"18527",41,3,71,126,14173057,14177450,4393,"0","mask"
"18627",41,4,6,127,14180953,14186516,5563,"20","valid"
"18828",41,6,128,128,14193157,14199236,6079,"20","mask"
"18928",41,5,55,129,14202138,14205106,2968,"20","orth"
"19028",41,1,69,130,14207890,14210975,3085,"0","valid"
"19134",41,1,135,131,14214400,14219328,4928,"0","valid"
"19235",41,5,85,132,14222342,14225812,3470,"20","orth"
"19327",41,3,83,133,14229055,14235048,5993,"0","mask"
"19428",41,3,17,134,14238356,14242088,3732,"0","mask"
"19631",41,2,118,135,14248272,14253252,4980,"0","orth"
"19728",41,1,45,136,14256017,14259769,3752,"0","valid"
"19934",41,1,57,137,14265292,14269534,4242,"0","valid"
"20029",41,6,32,138,14272352,14276574,4222,"20","mask"
"10141",42,4,113,1,15322462,15330776,8314,"20","valid"
"11107",42,3,118,2,15334724,15339489,4765,"0","mask"
"12133",42,5,72,3,15345875,15350326,4451,"20","orth"
"13137",42,3,100,4,15357189,15361510,4321,"0","mask"
"14132",42,2,69,5,15378929,15381622,2693,"0","orth"
"15135",42,2,135,6,15384636,15388394,3758,"0","orth"
"16108",42,1,68,7,15392675,15397042,4367,"0","valid"
"17133",42,3,58,8,15400375,15406637,6262,"0","mask"
"18142",42,5,96,9,15413455,15422887,9432,"20","orth"
"19108",42,4,53,10,15426292,15431482,5190,"20","valid"
"2134",42,3,70,11,15438770,15443502,4732,"0","mask"
"2232",42,5,30,12,15447000,15451693,4693,"20","orth"
"2429",42,1,104,13,15459242,15465615,6373,"0","valid"
"2529",42,5,132,14,15469556,15474661,5105,"20","orth"
"2636",42,2,81,15,15479014,15484440,5426,"0","orth"
"2726",42,3,112,16,15488545,15493885,5340,"0","mask"
"2830",42,6,79,17,15497657,15503010,5353,"20","mask"
"2932",42,2,75,18,15507480,15512906,5426,"0","orth"
"3031",42,4,23,19,15516357,15521102,4745,"20","valid"
"3231",42,4,65,20,15529626,15534103,4477,"20","valid"
"3329",42,5,108,21,15537385,15541437,4052,"20","orth"
"3430",42,3,94,22,15545516,15551137,5621,"0","mask"
"3529",42,4,131,23,15554510,15559209,4699,"20","valid"
"3628",42,3,130,24,15562491,15571282,8791,"0","mask"
"3727",42,2,111,25,15574805,15581093,6288,"0","orth"
"3829",42,2,51,26,15585440,15591506,6066,"0","orth"
"4030",42,6,55,27,15598474,15602971,4497,"20","mask"
"4135",42,4,101,28,15607435,15611814,4379,"20","valid"
"4228",42,5,126,29,15614782,15620632,5850,"20","orth"
"4328",42,5,90,30,15624201,15628606,4405,"20","orth"
"4432",42,6,37,31,15633208,15637777,4569,"20","mask"
"4630",42,6,97,32,15644993,15649451,4458,"20","mask"
"4728",42,6,91,33,15653458,15659053,5595,"20","mask"
"4831",42,2,99,34,15663138,15668093,4955,"0","orth"
"4923",42,6,61,35,15671642,15677002,5360,"20","mask"
"5033",42,1,128,36,15680394,15685126,4732,"0","valid"
"5129",42,3,22,37,15688251,15692460,4209,"0","mask"
"5329",42,5,138,38,15699958,15704742,4784,"20","orth"
"5432",42,2,39,39,15707749,15712161,4412,"0","orth"
"5629",42,5,120,40,15719691,15725031,5340,"20","orth"
"5729",42,3,34,41,15728450,15733934,5484,"0","mask"
"5932",42,5,66,42,15744019,15747843,3824,"20","orth"
"6029",42,4,137,43,15751314,15755602,4288,"20","valid"
"6131",42,3,40,44,15758935,15763197,4262,"0","mask"
"6327",42,6,49,45,15770577,15776420,5843,"20","mask"
"6535",42,4,17,46,15783774,15788061,4287,"20","valid"
"6726",42,5,6,47,15795624,15801363,5739,"20","orth"
"6931",42,6,1,48,15815992,15821364,5372,"20","mask"
"7130",42,1,86,49,15835797,15840124,4327,"0","valid"
"7225",42,1,38,50,15845131,15849301,4170,"0","valid"
"7432",42,2,27,51,15857269,15861275,4006,"0","orth"
"7633",42,4,35,52,15868708,15873780,5072,"20","valid"
"7833",42,6,115,53,15883009,15886787,3778,"20","mask"
"7933",42,4,29,54,15890696,15897062,6366,"20","valid"
"8131",42,2,93,55,15904939,15909691,4752,"0","orth"
"8231",42,4,95,56,15913168,15918129,4961,"20","valid"
"8332",42,1,56,57,15921443,15929757,8314,"0","valid"
"8423",42,2,15,58,15933836,15936660,2824,"0","orth"
"8636",42,1,44,59,15944869,15947817,2948,"0","valid"
"8831",42,1,134,60,15955936,15959400,3464,"0","valid"
"8928",42,1,74,61,15963106,15966897,3791,"0","valid"
"9026",42,4,59,62,15970217,15974800,4583,"20","valid"
"9130",42,6,25,63,15978231,15982408,4177,"20","mask"
"9331",42,3,46,64,15989905,15994186,4281,"0","mask"
"9532",42,5,12,65,16002867,16007148,4281,"20","orth"
"9728",42,5,78,66,16083180,16088239,5059,"20","orth"
"9829",42,4,77,67,16091154,16095618,4464,"20","valid"
"9930",42,3,16,68,16098925,16102115,3190,"0","mask"
"10142",42,3,106,69,16109371,16113972,4601,"0","mask"
"10230",42,6,43,70,16116959,16121149,4190,"20","mask"
"10429",42,6,13,71,16128255,16132804,4549,"20","mask"
"10632",42,2,33,72,16139726,16145008,5282,"0","orth"
"10828",42,6,133,73,16152740,16159609,6869,"20","mask"
"10930",42,3,4,74,16162949,16167649,4700,"0","mask"
"11135",42,5,60,75,16173918,16179447,5529,"20","orth"
"11232",42,1,2,76,16182441,16185631,3190,"0","valid"
"11433",42,3,52,77,16195396,16200174,4778,"0","mask"
"11633",42,6,31,78,16207168,16217541,10373,"20","mask"
"11830",42,4,41,79,16224372,16228104,3732,"20","valid"
"12031",42,2,117,80,16234719,16237150,2431,"0","orth"
"12134",42,3,10,81,16240216,16244249,4033,"0","mask"
"12327",42,4,5,82,16251923,16256217,4294,"20","valid"
"12527",42,3,124,83,16263997,16269623,5626,"0","mask"
"12628",42,3,88,84,16272839,16276931,4092,"0","mask"
"12727",42,1,50,85,16280611,16284631,4020,"0","valid"
"12931",42,5,36,86,16291664,16296259,4595,"20","orth"
"13138",42,6,73,87,16305619,16309992,4373,"20","mask"
"13232",42,1,20,88,16313881,16318051,4170,"0","valid"
"13431",42,4,71,89,16325425,16329680,4255,"20","valid"
"13524",42,6,109,90,16332641,16337393,4752,"20","mask"
"13629",42,6,67,91,16340922,16345138,4216,"20","mask"
"13729",42,6,85,92,16348158,16352786,4628,"20","mask"
"13825",42,5,54,93,16356021,16360545,4524,"20","orth"
"14031",42,4,89,94,16369957,16375121,5164,"20","valid"
"14133",42,2,63,95,16378579,16381794,3215,"0","orth"
"14232",42,5,84,96,16385559,16389873,4314,"20","orth"
"14333",42,3,64,97,16393096,16397573,4477,"0","mask"
"14429",42,3,136,98,16401083,16406090,5007,"0","mask"
"14526",42,6,127,99,16409594,16412718,3124,"20","mask"
"14631",42,1,98,100,16416130,16419111,2981,"0","valid"
"14728",42,6,103,101,16422045,16429177,7132,"20","mask"
"14824",42,3,28,102,16432216,16437027,4811,"0","mask"
"15032",42,5,48,103,16445720,16449152,3432,"20","orth"
"15233",42,1,122,104,16455675,16457492,1817,"0","valid"
"15328",42,3,82,105,16460421,16464741,4320,"0","mask"
"15430",42,2,57,106,16467859,16471114,3255,"0","orth"
"15530",42,5,24,107,16474101,16479095,4994,"20","orth"
"15734",42,4,107,108,16487115,16490573,3458,"20","valid"
"15831",42,1,14,109,16493665,16497397,3732,"0","valid"
"16034",42,1,8,110,16505626,16509581,3955,"0","valid"
"16229",42,4,119,111,16516705,16521915,5210,"20","valid"
"16332",42,2,123,112,16524974,16529824,4850,"0","orth"
"16431",42,2,9,113,16533053,16536472,3419,"0","orth"
"16625",42,4,83,114,16543465,16548021,4556,"20","valid"
"16734",42,1,110,115,16551616,16554211,2595,"0","valid"
"16831",42,6,7,116,16557225,16560630,3405,"20","mask"
"17031",42,5,114,117,16570788,16588102,17314,"20","orth"
"17134",42,2,45,118,16591377,16594135,2758,"0","orth"
"17327",42,1,26,119,16601816,16605103,3287,"0","valid"
"17529",42,1,80,120,16613660,16617098,3438,"0","valid"
"17632",42,1,32,121,16620699,16624190,3491,"0","valid"
"17832",42,2,21,122,16633210,16636596,3386,"0","orth"
"18030",42,3,76,123,16643047,16647780,4733,"0","mask"
"18143",42,2,87,124,16651009,16655349,4340,"0","orth"
"18227",42,6,121,125,16658715,16663166,4451,"20","mask"
"18327",42,5,42,126,16666461,16673350,6889,"20","orth"
"18528",42,2,129,127,16683207,16689952,6745,"0","orth"
"18628",42,1,116,128,16693253,16700221,6968,"0","valid"
"18728",42,1,92,129,16703777,16707163,3386,"0","valid"
"18829",42,4,125,130,16710294,16715085,4791,"20","valid"
"18929",42,1,62,131,16718268,16723183,4915,"0","valid"
"19029",42,4,11,132,16726543,16729864,3321,"20","valid"
"19236",42,5,102,133,16735903,16740315,4412,"20","orth"
"19328",42,5,18,134,16743381,16746512,3131,"20","orth"
"19526",42,2,3,135,16752499,16756467,3968,"0","orth"
"19729",42,6,19,136,16768154,16771794,3640,"20","mask"
"19935",42,4,47,137,16783129,16786325,3196,"20","valid"
"20129",42,2,105,138,16792535,16795855,3320,"0","orth"
"10143",43,6,96,1,17016831,17022086,5255,"20","mask"
"11108",43,4,4,2,17025302,17030681,5379,"20","valid"
"13139",43,5,11,3,17037185,17041774,4589,"20","orth"
"15136",43,5,29,4,17049029,17054873,5844,"20","orth"
"17135",43,4,16,5,17061468,17067553,6085,"20","valid"
"19109",43,3,99,6,17074312,17080345,6033,"0","mask"
"2039",43,1,91,7,17083345,17087790,4445,"0","valid"
"2135",43,4,52,8,17090699,17095071,4372,"20","valid"
"2329",43,6,72,9,17101144,17104752,3608,"20","mask"
"2430",43,4,22,10,17107745,17112831,5086,"20","valid"
"2637",43,6,90,11,17118629,17122276,3647,"20","mask"
"2727",43,3,135,12,17125622,17130564,4942,"0","mask"
"2831",43,5,53,13,17134225,17139617,5392,"20","orth"
"3032",43,2,92,14,17146258,17151421,5163,"0","orth"
"3129",43,6,66,15,17154291,17158540,4249,"20","mask"
"3232",43,6,48,16,17161102,17164043,2941,"20","mask"
"3431",43,6,6,17,17170737,17175214,4477,"20","mask"
"3629",43,3,3,18,17182750,17188182,5432,"0","mask"
"3830",43,3,33,19,17194627,17198405,3778,"0","mask"
"4031",43,6,78,20,17205138,17210255,5117,"20","mask"
"4136",43,5,101,21,17213452,17219079,5627,"20","orth"
"4229",43,5,35,22,17222380,17225995,3615,"20","orth"
"4433",43,2,86,23,17233100,17238689,5589,"0","orth"
"4524",43,4,130,24,17242094,17247558,5464,"20","valid"
"4631",43,3,39,25,17250592,17254239,3647,"0","mask"
"4832",43,2,44,26,17261991,17265991,4000,"0","orth"
"5034",43,5,131,27,17272051,17276194,4143,"20","orth"
"5130",43,2,38,28,17279862,17283790,3928,"0","orth"
"5330",43,1,79,29,17289797,17293280,3483,"0","valid"
"5433",43,3,129,30,17296333,17299647,3314,"0","mask"
"5532",43,5,59,31,17303216,17309014,5798,"20","orth"
"5630",43,4,76,32,17312243,17317890,5647,"20","valid"
"5730",43,4,10,33,17320982,17324485,3503,"20","valid"
"5933",43,6,84,34,17331688,17336303,4615,"20","mask"
"6030",43,6,132,35,17339513,17343905,4392,"20","mask"
"6132",43,6,12,36,17347500,17351101,3601,"20","mask"
"6328",43,1,115,37,17357396,17361069,3673,"0","valid"
"6431",43,3,105,38,17363939,17368220,4281,"0","mask"
"6536",43,4,70,39,17371587,17375744,4157,"20","valid"
"6630",43,1,1,40,17379241,17382241,3000,"0","valid"
"6830",43,2,104,41,17388509,17394732,6223,"0","orth"
"6932",43,1,133,42,17397791,17401268,3477,"0","valid"
"7031",43,3,21,43,17404099,17407922,3823,"0","mask"
"7226",43,5,125,44,17414713,17418694,3981,"20","orth"
"7327",43,2,98,45,17421760,17425675,3915,"0","orth"
"7433",43,4,88,46,17429002,17432211,3209,"20","valid"
"7531",43,1,103,47,17435859,17439859,4000,"0","valid"
"7634",43,4,64,48,17443375,17447480,4105,"20","valid"
"7728",43,2,32,49,17450670,17455553,4883,"0","orth"
"7934",43,1,37,50,17461671,17465547,3876,"0","valid"
"8132",43,5,17,51,17471763,17475567,3804,"20","orth"
"8333",43,5,77,52,17481195,17486698,5503,"20","orth"
"8424",43,6,18,53,17490117,17493633,3516,"20","mask"
"8637",43,1,31,54,17500810,17504504,3694,"0","valid"
"8832",43,4,118,55,17510452,17515491,5039,"20","valid"
"8929",43,3,69,56,17518583,17522106,3523,"0","mask"
"9027",43,2,2,57,17525172,17529041,3869,"0","orth"
"9234",43,4,46,58,17535375,17538748,3373,"20","valid"
"9425",43,1,19,59,17544820,17547395,2575,"0","valid"
"9624",43,1,85,60,17555723,17560971,5248,"0","valid"
"9729",43,5,65,61,17563978,17567978,4000,"20","orth"
"9830",43,2,74,62,17571325,17574809,3484,"0","orth"
"9931",43,4,94,63,17577986,17582195,4209,"20","valid"
"10035",43,5,107,64,17585378,17590195,4817,"20","orth"
"10144",43,6,114,65,17593941,17597268,3327,"20","mask"
"10231",43,2,122,66,17655599,17658043,2444,"0","orth"
"10331",43,1,25,67,17661743,17665730,3987,"0","valid"
"10526",43,2,68,68,17671737,17675770,4033,"0","orth"
"10633",43,2,8,69,17678979,17682385,3406,"0","orth"
"10829",43,1,97,70,17688620,17692751,4131,"0","valid"
"10931",43,6,102,71,17695732,17698824,3092,"20","mask"
"11024",43,4,82,72,17701785,17705458,3673,"20","valid"
"11136",43,3,9,73,17708628,17712654,4026,"0","mask"
"11326",43,1,67,74,17719557,17723329,3772,"0","valid"
"11434",43,4,124,75,17726440,17729669,3229,"20","valid"
"11525",43,1,109,76,17732774,17736963,4189,"0","valid"
"11634",43,2,20,77,17739950,17742598,2648,"0","orth"
"11831",43,4,58,78,17749552,17754193,4641,"20","valid"
"11928",43,6,120,79,17757279,17760311,3032,"20","mask"
"12032",43,1,7,80,17764482,17769684,5202,"0","valid"
"12234",43,2,26,81,17778679,17783626,4947,"0","orth"
"12431",43,5,5,82,17791339,17796464,5125,"20","orth"
"12629",43,3,63,83,17803125,17806314,3189,"0","mask"
"12728",43,3,75,84,17809269,17813158,3889,"0","mask"
"12831",43,5,119,85,17816394,17819557,3163,"20","orth"
"12932",43,3,15,86,17822538,17825623,3085,"0","mask"
"13140",43,2,50,87,17831813,17836434,4621,"0","orth"
"13328",43,5,83,88,17843788,17848016,4228,"20","orth"
"13432",43,4,136,89,17850945,17855076,4131,"20","valid"
"13525",43,2,128,90,17858331,17863357,5026,"0","orth"
"13630",43,4,112,91,17866436,17870070,3634,"20","valid"
"13730",43,6,108,92,17873077,17876365,3288,"20","mask"
"13826",43,3,117,93,17879424,17882966,3542,"0","mask"
"13929",43,5,71,94,17886058,17889065,3007,"20","orth"
"14032",43,4,100,95,17892288,17895235,2947,"20","valid"
"14134",43,5,95,96,17898288,17902549,4261,"20","orth"
"14233",43,1,121,97,17905354,17908374,3020,"0","valid"
"14334",43,5,113,98,17912387,17916315,3928,"20","orth"
"14430",43,1,127,99,17919407,17922093,2686,"0","valid"
"14527",43,2,110,100,17925107,17928133,3026,"0","orth"
"14632",43,4,34,101,17931381,17935316,3935,"20","valid"
"14825",43,3,87,102,17941866,17945800,3934,"0","mask"
"14933",43,6,138,103,17948977,17952461,3484,"20","mask"
"15033",43,2,116,104,17955318,17958573,3255,"0","orth"
"15137",43,5,89,105,17962155,17967168,5013,"20","orth"
"15234",43,2,80,106,17970077,17974011,3934,"0","orth"
"15329",43,1,73,107,17976986,17980652,3666,"0","valid"
"15431",43,6,30,108,17983607,17987509,3902,"20","mask"
"15627",43,1,13,109,17993601,17996974,3373,"0","valid"
"15832",43,6,36,110,18002844,18006570,3726,"20","mask"
"16035",43,3,93,111,18013001,18016420,3419,"0","mask"
"16131",43,6,60,112,18019845,18024485,4640,"20","mask"
"16230",43,5,47,113,18027433,18031172,3739,"20","orth"
"16432",43,6,126,114,18037924,18042127,4203,"20","mask"
"16531",43,5,137,115,18045284,18049115,3831,"20","orth"
"16626",43,2,56,116,18052605,18056965,4360,"0","orth"
"16735",43,4,40,117,18060344,18064213,3869,"20","valid"
"16933",43,6,24,118,18070521,18074802,4281,"20","mask"
"17136",43,3,27,119,18081836,18086241,4405,"0","mask"
"17328",43,5,23,120,18092078,18095209,3131,"20","orth"
"17530",43,6,42,121,18100745,18104765,4020,"20","mask"
"17729",43,3,111,122,18115550,18119171,3621,"0","mask"
"17833",43,1,43,123,18122185,18125388,3203,"0","valid"
"18031",43,3,123,124,18132492,18137218,4726,"0","mask"
"18144",43,3,51,125,18140585,18145729,5144,"0","mask"
"18328",43,4,28,126,18151821,18155690,3869,"20","valid"
"18529",43,6,54,127,18161671,18167358,5687,"20","mask"
"18729",43,1,61,128,18176012,18180195,4183,"0","valid"
"18830",43,5,41,129,18183313,18187490,4177,"20","orth"
"19030",43,1,55,130,18195451,18199157,3706,"0","valid"
"19135",43,3,81,131,18202040,18205105,3065,"0","mask"
"19237",43,2,134,132,18208478,18213027,4549,"0","orth"
"19329",43,2,62,133,18216185,18220145,3960,"0","orth"
"19429",43,1,49,134,18224015,18227048,3033,"0","valid"
"19632",43,3,57,135,18232904,18236951,4047,"0","mask"
"19730",43,2,14,136,18240010,18245258,5248,"0","orth"
"19936",43,3,45,137,18251344,18254664,3320,"0","mask"
"20130",43,4,106,138,18260384,18265789,5405,"20","valid"
"10145",44,2,67,1,20221354,20224615,3261,"0","orth"
"11109",44,2,19,2,20227982,20232537,4555,"0","orth"
"13141",44,6,125,3,20241590,20246950,5360,"20","mask"
"14135",44,2,127,4,20250101,20256022,5921,"0","orth"
"15138",44,3,26,5,20259618,20265899,6281,"0","mask"
"17137",44,5,124,6,20273775,20277677,3902,"20","orth"
"18145",44,2,115,7,20280874,20284502,3628,"0","orth"
"19136",44,6,35,8,20288260,20292352,4092,"20","mask"
"2136",44,3,86,9,20301522,20304477,2955,"0","mask"
"2233",44,4,99,10,20308157,20313621,5464,"20","valid"
"2330",44,2,109,11,20317634,20321517,3883,"0","orth"
"2431",44,1,12,12,20325341,20330119,4778,"0","valid"
"2638",44,2,79,13,20336172,20342244,6072,"0","orth"
"2728",44,6,23,14,20345440,20349748,4308,"20","mask"
"2933",44,2,43,15,20356238,20361762,5524,"0","orth"
"3130",44,5,16,16,20368115,20372200,4085,"20","orth"
"3330",44,1,96,17,20378345,20383090,4745,"0","valid"
"3432",44,1,18,18,20386456,20393228,6772,"0","valid"
"3630",44,1,108,19,20400692,20407595,6903,"0","valid"
"3728",44,4,15,20,20410902,20415700,4798,"20","valid"
"3930",44,6,53,21,20422805,20426740,3935,"20","mask"
"4137",44,5,130,22,20433165,20438825,5660,"20","orth"
"4230",44,2,1,23,20441963,20446153,4190,"0","orth"
"4434",44,3,68,24,20452304,20457657,5353,"0","mask"
"4525",44,4,135,25,20461226,20466899,5673,"20","valid"
"4632",44,2,7,26,20469632,20475834,6202,"0","orth"
"4833",44,4,21,27,20483639,20490417,6778,"20","valid"
"5035",44,3,20,28,20497614,20506869,9255,"0","mask"
"5232",44,6,83,29,20514491,20521589,7098,"20","mask"
"5331",44,5,22,30,20524635,20531276,6641,"20","orth"
"5533",44,2,55,31,20536917,20540107,3190,"0","orth"
"5631",44,5,136,32,20543225,20547003,3778,"20","orth"
"5731",44,6,95,33,20551199,20555500,4301,"20","mask"
"5828",44,4,105,34,20558258,20562631,4373,"20","valid"
"5934",44,4,93,35,20566017,20569364,3347,"20","valid"
"6031",44,4,51,36,20572593,20576776,4183,"20","valid"
"6233",44,3,122,37,20583031,20585933,2902,"0","mask"
"6329",44,2,31,38,20588882,20595620,6738,"0","orth"
"6537",44,4,123,39,20601366,20605961,4595,"20","valid"
"6631",44,1,102,40,20608805,20616897,8092,"0","valid"
"6727",44,6,107,41,20621321,20624975,3654,"20","mask"
"6831",44,5,118,42,20629721,20634002,4281,"20","orth"
"6933",44,1,42,43,20637015,20641447,4432,"0","valid"
"7131",44,4,75,44,20649068,20653683,4615,"20","valid"
"7227",44,1,132,45,20656860,20661233,4373,"0","valid"
"7328",44,1,114,46,20664579,20668057,3478,"0","valid"
"7434",44,5,82,47,20671449,20675724,4275,"20","orth"
"7532",44,3,80,48,20678985,20685554,6569,"0","mask"
"7635",44,5,46,49,20689058,20692150,3092,"20","orth"
"7834",44,5,10,50,20698569,20702523,3954,"20","orth"
"8027",44,2,97,51,20708406,20711458,3052,"0","orth"
"8133",44,6,119,52,20714805,20718674,3869,"20","mask"
"8232",44,3,116,53,20721995,20726472,4477,"0","mask"
"8334",44,5,40,54,20730009,20734407,4398,"20","orth"
"8528",44,6,59,55,20742519,20746193,3674,"20","mask"
"8638",44,5,58,56,20749507,20754154,4647,"20","orth"
"8725",44,5,112,57,20757193,20760083,2890,"20","orth"
"8833",44,1,30,58,20762802,20766109,3307,"0","valid"
"9028",44,6,101,59,20771979,20777450,5471,"20","mask"
"9131",44,3,14,60,20781182,20785672,4490,"0","mask"
"9332",44,3,8,61,20793758,20797791,4033,"0","mask"
"9533",44,6,41,62,20803928,20808066,4138,"20","mask"
"9730",44,1,54,63,20813603,20816361,2758,"0","valid"
"9932",44,5,34,64,20823551,20827335,3784,"20","orth"
"10146",44,3,44,65,20834042,20837232,3190,"0","mask"
"10332",44,5,28,66,21050128,21053396,3268,"20","orth"
"10527",44,4,39,67,21059462,21063462,4000,"20","valid"
"10730",44,5,4,68,21069423,21073202,3779,"20","orth"
"10932",44,3,62,69,21078477,21081823,3346,"0","mask"
"11025",44,4,63,70,21084882,21088255,3373,"20","valid"
"11137",44,3,38,71,21091536,21095393,3857,"0","mask"
"11327",44,1,90,72,21101622,21106053,4431,"0","valid"
"11435",44,4,69,73,21109289,21112283,2994,"20","valid"
"11526",44,3,32,74,21115387,21118832,3445,"0","mask"
"11734",44,3,92,75,21126297,21129741,3444,"0","mask"
"11832",44,5,64,76,21133480,21136297,2817,"20","orth"
"11929",44,5,52,77,21139592,21143213,3621,"20","orth"
"12135",44,2,91,78,21150449,21154749,4300,"0","orth"
"12235",44,2,37,79,21158057,21162855,4798,"0","orth"
"12432",44,5,88,80,21169345,21173672,4327,"20","orth"
"12528",44,4,57,81,21176940,21181163,4223,"20","valid"
"12630",44,5,94,82,21184294,21188719,4425,"20","orth"
"12729",44,4,27,83,21191863,21195282,3419,"20","valid"
"12933",44,2,49,84,21200975,21204524,3549,"0","orth"
"13142",44,1,48,85,21210505,21213583,3078,"0","valid"
"13329",44,6,47,86,21221702,21225297,3595,"20","mask"
"13526",44,5,100,87,21231592,21236343,4751,"20","orth"
"13631",44,4,111,88,21240062,21244167,4105,"20","valid"
"13731",44,5,70,89,21247834,21253174,5340,"20","orth"
"13827",44,1,84,90,21257155,21260665,3510,"0","valid"
"13930",44,1,36,91,21263829,21266365,2536,"0","valid"
"14136",44,2,103,92,21273516,21278536,5020,"0","orth"
"14234",44,1,72,93,21281680,21285425,3745,"0","valid"
"14335",44,5,76,94,21289072,21293046,3974,"20","orth"
"14431",44,2,121,95,21296217,21299400,3183,"0","orth"
"14528",44,6,71,96,21302930,21306381,3451,"20","mask"
"14633",44,1,78,97,21310237,21313015,2778,"0","valid"
"14729",44,6,131,98,21316179,21319525,3346,"20","mask"
"14826",44,3,74,99,21322898,21325722,2824,"0","mask"
"14934",44,6,17,100,21328807,21331899,3092,"20","mask"
"15139",44,6,77,101,21338769,21342344,3575,"20","mask"
"15235",44,6,137,102,21345246,21348129,2883,"20","mask"
"15330",44,3,2,103,21352148,21355940,3792,"0","mask"
"15531",44,3,50,104,21363384,21367032,3648,"0","mask"
"15735",44,2,85,105,21373850,21378869,5019,"0","orth"
"15833",44,3,134,106,21381902,21385354,3452,"0","mask"
"15927",44,2,61,107,21388739,21392060,3321,"0","orth"
"16036",44,5,106,108,21395040,21398263,3223,"20","orth"
"16132",44,3,128,109,21401544,21406289,4745,"0","mask"
"16231",44,3,104,110,21409950,21413309,3359,"0","mask"
"16333",44,4,117,111,21416891,21419964,3073,"20","valid"
"16433",44,6,65,112,21423539,21427029,3490,"20","mask"
"16532",44,4,129,113,21430128,21433520,3392,"20","valid"
"16627",44,6,29,114,21437102,21441540,4438,"20","mask"
"16832",44,3,98,115,21449076,21453547,4471,"0","mask"
"16934",44,3,56,116,21457045,21460835,3790,"0","mask"
"17032",44,2,13,117,21464516,21467875,3359,"0","orth"
"17231",44,1,126,118,21474686,21477837,3151,"0","valid"
"17329",44,4,9,119,21481144,21485726,4582,"20","valid"
"17531",44,2,73,120,21491668,21495040,3372,"0","orth"
"17633",44,6,5,121,21499740,21503315,3575,"20","mask"
"17834",44,4,81,122,21510107,21513904,3797,"20","valid"
"17928",44,6,11,123,21517290,21519787,2497,"20","mask"
"18146",44,4,87,124,21525919,21530069,4150,"20","valid"
"18228",44,6,89,125,21533220,21541514,8294,"20","mask"
"18329",44,1,138,126,21544743,21547685,2942,"0","valid"
"18430",44,2,133,127,21551097,21553757,2660,"0","orth"
"18530",44,1,120,128,21556835,21561411,4576,"0","valid"
"18629",44,1,24,129,21564718,21568607,3889,"0","valid"
"18831",44,6,113,130,21574680,21578210,3530,"20","mask"
"18930",44,4,45,131,21581249,21584478,3229,"20","valid"
"19137",44,1,6,132,21591328,21596171,4843,"0","valid"
"19330",44,2,25,133,21602969,21606649,3680,"0","orth"
"19527",44,4,33,134,21613009,21617304,4295,"20","valid"
"19731",44,4,3,135,21623409,21626481,3072,"20","valid"
"19937",44,1,66,136,21632494,21635292,2798,"0","valid"
"20030",44,1,60,137,21638194,21641279,3085,"0","valid"
"20131",44,3,110,138,21644763,21648293,3530,"0","mask"
"10147",45,2,48,1,12311567,12313959,2392,"0","orth"
"12136",45,5,135,2,12320659,12325300,4641,"20","orth"
"13143",45,2,60,3,12328431,12332535,4104,"0","orth"
"14137",45,3,73,4,12335601,12339255,3654,"0","mask"
"15140",45,6,28,5,12342549,12347144,4595,"20","mask"
"17138",45,4,44,6,12353903,12356171,2268,"20","valid"
"19138",45,1,5,7,12361714,12364564,2850,"0","valid"
"2137",45,1,29,8,12370910,12374087,3177,"0","valid"
"2331",45,5,51,9,12381499,12384964,3465,"20","orth"
"2530",45,3,43,10,12390775,12393454,2679,"0","mask"
"2729",45,2,132,11,12399226,12402390,3164,"0","orth"
"2832",45,5,9,12,12405985,12409828,3843,"20","orth"
"3033",45,1,137,13,12416567,12420463,3896,"0","valid"
"3131",45,4,20,14,12423711,12426091,2380,"20","valid"
"3331",45,3,1,15,12432666,12435497,2831,"0","mask"
"3530",45,4,122,16,12440556,12442686,2130,"20","valid"
"3631",45,5,93,17,12445667,12448053,2386,"20","orth"
"3729",45,3,127,18,12450981,12453151,2170,"0","mask"
"3831",45,6,46,19,12455988,12458956,2968,"20","mask"
"4032",45,3,85,20,12464753,12468368,3615,"0","mask"
"4138",45,4,116,21,12471381,12473976,2595,"20","valid"
"4231",45,5,15,22,12476931,12479388,2457,"20","orth"
"4435",45,5,99,23,12485447,12489271,3824,"20","orth"
"4526",45,1,119,24,12492435,12495409,2974,"0","valid"
"4633",45,1,71,25,12499057,12501338,2281,"0","valid"
"4729",45,5,105,26,12504279,12506318,2039,"20","orth"
"4834",45,1,131,27,12509292,12511318,2026,"0","valid"
"4924",45,3,109,28,12514188,12518110,3922,"0","mask"
"5036",45,1,59,29,12521299,12524051,2752,"0","valid"
"5131",45,3,49,30,12527633,12530039,2406,"0","mask"
"5332",45,3,7,31,12536105,12538876,2771,"0","mask"
"5534",45,1,95,32,12547040,12550765,3725,"0","valid"
"5632",45,3,25,33,12554125,12556733,2608,"0","mask"
"5829",45,5,39,34,12562087,12565388,3301,"20","orth"
"6032",45,4,32,35,12571257,12574989,3732,"20","valid"
"6234",45,6,34,36,12580964,12584506,3542,"20","mask"
"6432",45,2,18,37,12590644,12593827,3183,"0","orth"
"6632",45,4,8,38,12600789,12604390,3601,"20","valid"
"6832",45,2,54,39,12609946,12611926,1980,"0","orth"
"7032",45,2,42,40,12621862,12625280,3418,"0","orth"
"7228",45,5,111,41,12631333,12635117,3784,"20","orth"
"7329",45,4,134,42,12638536,12641360,2824,"20","valid"
"7435",45,1,101,43,12644412,12647295,2883,"0","valid"
"7533",45,2,72,44,12650530,12652753,2223,"0","orth"
"7636",45,3,37,45,12655596,12658747,3151,"0","mask"
"7835",45,2,12,46,12664296,12667035,2739,"0","orth"
"8028",45,2,78,47,12672532,12674414,1882,"0","orth"
"8134",45,3,61,48,12677473,12679950,2477,"0","mask"
"8233",45,4,74,49,12683722,12686886,3164,"20","valid"
"8335",45,5,57,50,12690043,12692906,2863,"20","orth"
"8425",45,6,64,51,12695860,12698658,2798,"20","mask"
"8529",45,3,31,52,12701593,12704155,2562,"0","mask"
"8726",45,5,3,53,12710280,12713325,3045,"20","orth"
"8930",45,6,94,54,12719359,12722574,3215,"20","mask"
"9029",45,5,33,55,12726176,12729052,2876,"20","orth"
"9235",45,6,16,56,12735614,12738523,2909,"20","mask"
"9426",45,3,91,57,12745752,12748766,3014,"0","mask"
"9534",45,3,97,58,12752177,12754570,2393,"0","mask"
"9625",45,1,17,59,12758100,12761538,3438,"0","valid"
"9831",45,6,76,60,12767832,12771793,3961,"20","mask"
"9933",45,4,80,61,12775244,12778330,3086,"20","valid"
"10036",45,4,104,62,12781421,12785180,3759,"20","valid"
"10148",45,3,13,63,12788350,12791102,2752,"0","mask"
"10333",45,1,23,64,12796730,12799141,2411,"0","valid"
"10528",45,3,115,65,12804586,12807305,2719,"0","mask"
"10634",45,5,117,66,12837366,12839608,2242,"20","orth"
"10731",45,2,108,67,12842608,12845072,2464,"0","orth"
"10830",45,6,112,68,12847968,12850471,2503,"20","mask"
"10933",45,5,87,69,12853760,12857400,3640,"20","orth"
"11026",45,1,107,70,12860740,12864727,3987,"0","valid"
"11138",45,5,21,71,12868153,12871460,3307,"20","orth"
"11328",45,6,130,72,12877179,12881578,4399,"20","mask"
"11436",45,5,27,73,12885075,12888585,3510,"20","orth"
"11635",45,1,65,74,12893834,12896631,2797,"0","valid"
"11735",45,4,92,75,12899658,12902972,3314,"20","valid"
"11833",45,1,47,76,12906678,12908410,1732,"0","valid"
"12033",45,2,96,77,12913836,12917241,3405,"0","orth"
"12137",45,6,58,78,12920084,12922993,2909,"20","mask"
"12236",45,6,10,79,12926104,12929013,2909,"20","mask"
"12433",45,6,70,80,12935444,12938608,3164,"20","mask"
"12529",45,6,52,81,12941510,12943916,2406,"20","mask"
"12730",45,4,26,82,12950171,12953263,3092,"20","valid"
"12934",45,4,56,83,12959401,12963531,4130,"20","valid"
"13027",45,6,22,84,12974029,12977297,3268,"20","mask"
"13233",45,2,90,85,12983160,12986239,3079,"0","orth"
"13330",45,3,79,86,12989677,12992945,3268,"0","mask"
"13433",45,4,62,87,12996488,12999449,2961,"20","valid"
"13527",45,3,121,88,13002854,13004665,1811,"0","mask"
"13632",45,6,82,89,13007717,13010221,2504,"20","mask"
"13732",45,1,41,90,13013848,13016319,2471,"0","valid"
"13931",45,4,50,91,13021666,13025222,3556,"20","valid"
"14138",45,3,133,92,13030876,13033568,2692,"0","mask"
"14235",45,2,84,93,13036504,13038955,2451,"0","orth"
"14336",45,2,102,94,13046759,13048687,1928,"0","orth"
"14432",45,1,113,95,13051485,13054106,2621,"0","valid"
"14529",45,4,2,96,13057113,13059472,2359,"20","valid"
"14730",45,1,83,97,13070467,13073088,2621,"0","valid"
"14827",45,1,53,98,13075807,13078330,2523,"0","valid"
"15034",45,1,125,99,13083886,13086559,2673,"0","valid"
"15141",45,5,69,100,13089632,13092566,2934,"20","orth"
"15236",45,5,63,101,13096051,13098893,2842,"20","orth"
"15331",45,4,68,102,13101678,13104181,2503,"20","valid"
"15432",45,4,38,103,13106927,13109142,2215,"20","valid"
"15628",45,5,129,104,13114528,13116398,1870,"20","orth"
"15736",45,6,88,105,13119182,13121868,2686,"20","mask"
"15834",45,2,126,106,13124928,13127503,2575,"0","orth"
"15928",45,5,75,107,13130281,13132719,2438,"20","orth"
"16037",45,2,30,108,13135804,13137876,2072,"0","orth"
"16232",45,2,24,109,13143328,13146007,2679,"0","orth"
"16434",45,5,123,110,13152014,13154720,2706,"20","orth"
"16533",45,3,19,111,13157623,13159949,2326,"0","mask"
"16736",45,4,128,112,13168597,13172120,3523,"20","valid"
"16833",45,6,118,113,13175441,13178742,3301,"20","mask"
"16935",45,6,136,114,13182030,13184997,2967,"20","mask"
"17033",45,3,67,115,13187500,13189932,2432,"0","mask"
"17139",45,1,35,116,13192658,13194403,1745,"0","valid"
"17330",45,2,114,117,13204567,13207469,2902,"0","orth"
"17428",45,2,120,118,13210508,13212973,2465,"0","orth"
"17532",45,5,81,119,13215960,13219339,3379,"20","orth"
"17634",45,1,89,120,13222470,13224960,2490,"0","valid"
"17730",45,2,6,121,13228183,13230444,2261,"0","orth"
"17929",45,4,110,122,13235856,13238916,3060,"20","valid"
"18032",45,2,66,123,13241641,13243595,1954,"0","orth"
"18147",45,4,14,124,13246485,13249420,2935,"20","valid"
"18330",45,3,103,125,13255727,13258093,2366,"0","mask"
"18431",45,6,40,126,13261159,13264035,2876,"20","mask"
"18630",45,4,86,127,13269597,13272094,2497,"20","valid"
"18730",45,6,4,128,13274885,13277271,2386,"20","mask"
"18931",45,2,138,129,13282337,13284539,2202,"0","orth"
"19031",45,1,77,130,13287847,13290370,2523,"0","valid"
"19139",45,6,106,131,13293135,13295821,2686,"20","mask"
"19238",45,3,55,132,13299194,13300508,1314,"0","mask"
"19331",45,6,100,133,13303201,13305933,2732,"20","mask"
"19430",45,5,45,134,13308679,13310927,2248,"20","orth"
"19633",45,1,11,135,13316712,13318411,1699,"0","valid"
"19829",45,2,36,136,13324091,13325882,1791,"0","orth"
"20031",45,4,98,137,13334608,13337308,2700,"20","valid"
"20132",45,6,124,138,13340197,13342765,2568,"20","mask"
"10149",46,6,111,1,24875274,24880908,5634,"20","mask"
"11139",46,6,117,2,24884334,24887235,2901,"20","mask"
"12138",46,3,72,3,24889876,24892517,2641,"0","mask"
"13144",46,2,89,4,24895824,24905537,9713,"0","orth"
"14139",46,6,33,5,24908668,24911636,2968,"20","mask"
"16109",46,3,126,6,24917924,24931970,14046,"0","mask"
"17140",46,2,77,7,24935598,24940964,5366,"0","orth"
"18148",46,1,106,8,24944056,24949331,5275,"0","valid"
"19140",46,1,4,9,24953430,24956253,2823,"0","valid"
"2138",46,2,11,10,24962332,24966018,3686,"0","orth"
"2332",46,2,5,11,24973078,24979065,5987,"0","orth"
"2531",46,6,39,12,24986039,24989987,3948,"20","mask"
"2730",46,3,60,13,24996080,25000831,4751,"0","mask"
"2833",46,6,87,14,25004067,25010557,6490,"20","mask"
"2934",46,3,48,15,25013584,25016342,2758,"0","mask"
"3132",46,5,44,16,25022905,25025395,2490,"20","orth"
"3332",46,1,70,17,25031925,25040592,8667,"0","valid"
"3433",46,4,13,18,25043939,25053462,9523,"20","valid"
"3632",46,1,112,19,25059874,25062195,2321,"0","valid"
"3730",46,2,119,20,25065404,25070973,5569,"0","orth"
"3832",46,6,3,21,25074268,25077876,3608,"20","mask"
"4033",46,5,38,22,25083432,25086268,2836,"20","orth"
"4232",46,2,113,23,25091909,25094543,2634,"0","orth"
"4329",46,5,2,24,25097844,25106289,8445,"20","orth"
"4527",46,4,85,25,25112551,25116277,3726,"20","valid"
"4634",46,1,28,26,25119624,25122774,3150,"0","valid"
"4835",46,5,128,27,25128585,25133644,5059,"20","orth"
"4925",46,4,67,28,25137010,25141749,4739,"20","valid"
"5037",46,3,66,29,25144972,25150253,5281,"0","mask"
"5132",46,1,130,30,25153286,25159299,6013,"0","valid"
"5233",46,1,40,31,25162940,25167339,4399,"0","valid"
"5434",46,5,20,32,25173451,25178993,5542,"20","orth"
"5633",46,5,26,33,25185053,25190079,5026,"20","orth"
"5830",46,5,32,34,25196491,25205041,8550,"20","orth"
"6033",46,2,101,35,25210904,25219075,8171,"0","orth"
"6133",46,4,19,36,25222297,25227454,5157,"20","valid"
"6330",46,1,34,37,25235272,25241350,6078,"0","valid"
"6538",46,3,96,38,25247541,25255208,7667,"0","mask"
"6633",46,5,104,39,25258456,25262509,4053,"20","orth"
"6728",46,5,134,40,25265875,25273960,8085,"20","orth"
"6833",46,3,12,41,25276980,25283098,6118,"0","mask"
"7033",46,1,46,42,25289752,25295772,6020,"0","valid"
"7229",46,6,69,43,25302551,25305825,3274,"20","mask"
"7330",46,1,10,44,25309787,25316761,6974,"0","valid"
"7534",46,4,61,45,25324945,25328650,3705,"20","valid"
"7637",46,2,29,46,25331840,25338618,6778,"0","orth"
"7836",46,5,68,47,25344540,25347959,3419,"20","orth"
"7935",46,1,94,48,25351286,25358071,6785,"0","valid"
"8029",46,3,6,49,25361816,25368019,6203,"0","mask"
"8234",46,3,114,50,25373503,25377575,4072,"0","mask"
"8336",46,4,37,51,25381242,25387680,6438,"20","valid"
"8530",46,1,16,52,25393642,25396381,2739,"0","valid"
"8727",46,5,98,53,25402466,25417441,14975,"20","orth"
"8834",46,3,108,54,25420768,25424729,3961,"0","mask"
"8931",46,2,71,55,25427605,25430069,2464,"0","orth"
"9030",46,2,95,56,25433050,25441612,8562,"0","orth"
"9132",46,1,76,57,25444678,25449815,5137,"0","valid"
"9236",46,6,129,58,25453182,25456437,3255,"20","mask"
"9333",46,4,55,59,25459613,25461888,2275,"20","valid"
"9427",46,6,9,60,25465268,25469026,3758,"20","mask"
"9626",46,1,64,61,25474660,25477941,3281,"0","valid"
"9731",46,3,132,62,25480804,25487700,6896,"0","mask"
"9832",46,1,58,63,25490831,25496250,5419,"0","valid"
"9934",46,4,115,64,25499414,25503682,4268,"20","valid"
"10037",46,2,137,65,25506695,25510368,3673,"0","orth"
"10150",46,1,52,66,25564326,25570242,5916,"0","valid"
"10334",46,4,79,67,25576249,25580085,3836,"20","valid"
"10430",46,6,57,68,25583386,25585988,2602,"20","mask"
"10529",46,6,75,69,25589080,25594720,5640,"20","mask"
"10635",46,5,74,70,25597910,25604911,7001,"20","orth"
"10732",46,5,110,71,25608172,25616598,8426,"20","orth"
"10831",46,5,56,72,25619872,25624657,4785,"20","orth"
"10934",46,4,133,73,25628056,25630566,2510,"20","valid"
"11027",46,3,84,74,25633272,25639455,6183,"0","mask"
"11140",46,6,27,75,25642952,25655404,12452,"20","mask"
"11329",46,6,123,76,25661797,25675432,13635,"20","mask"
"11437",46,4,97,77,25678608,25682164,3556,"20","valid"
"11527",46,3,102,78,25685060,25687733,2673,"0","mask"
"11636",46,1,88,79,25696342,25701453,5111,"0","valid"
"11736",46,6,81,80,25704466,25708434,3968,"20","mask"
"11834",46,1,118,81,25711669,25717611,5942,"0","valid"
"11930",46,2,125,82,25720729,25725925,5196,"0","orth"
"12034",46,5,92,83,25728913,25736070,7157,"20","orth"
"12139",46,4,103,84,25739364,25743110,3746,"20","valid"
"12237",46,3,138,85,25746365,25748914,2549,"0","mask"
"12328",46,4,31,86,25753156,25759431,6275,"20","valid"
"12530",46,6,21,87,25765242,25772700,7458,"20","mask"
"12731",46,3,24,88,25778707,25784485,5778,"0","mask"
"12935",46,1,82,89,25789877,25792158,2281,"0","valid"
"13028",46,4,25,90,25795015,25797963,2948,"20","valid"
"13234",46,6,51,91,25803676,25806996,3320,"20","mask"
"13434",46,5,8,92,25812186,25814656,2470,"20","orth"
"13633",46,3,90,93,25820206,25822474,2268,"0","mask"
"13733",46,6,63,94,25825455,25828716,3261,"20","mask"
"13828",46,2,47,95,25831494,25834612,3118,"0","orth"
"14033",46,6,135,96,25840181,25849515,9334,"20","mask"
"14140",46,5,86,97,25852581,25859346,6765,"20","orth"
"14236",46,3,36,98,25862078,25865843,3765,"0","mask"
"14433",46,5,122,99,25871981,25875464,3483,"20","orth"
"14530",46,1,136,100,25878877,25882190,3313,"0","valid"
"14634",46,4,43,101,25885341,25896087,10746,"20","valid"
"14828",46,2,35,102,25901316,25904290,2974,"0","orth"
"15035",46,5,80,103,25911755,25917304,5549,"20","orth"
"15142",46,2,59,104,25921043,25924697,3654,"0","orth"
"15237",46,4,49,105,25928161,25931017,2856,"20","valid"
"15433",46,5,50,106,25936247,25944005,7758,"20","orth"
"15629",46,1,124,107,25949718,25955117,5399,"0","valid"
"15737",46,4,1,108,25958470,25964196,5726,"20","valid"
"15929",46,6,45,109,25969896,25972987,3091,"20","mask"
"16133",46,2,107,110,25978275,25983138,4863,"0","orth"
"16233",46,4,109,111,25986564,25995780,9216,"20","valid"
"16334",46,5,116,112,25998577,26003565,4988,"20","orth"
"16435",46,6,105,113,26006591,26011212,4621,"20","mask"
"16534",46,6,93,114,26014121,26018199,4078,"20","mask"
"16628",46,3,42,115,26021030,26025501,4471,"0","mask"
"16834",46,3,54,116,26031612,26036730,5118,"0","mask"
"17034",46,3,78,117,26043201,26047214,4013,"0","mask"
"17141",46,1,100,118,26050189,26053718,3529,"0","valid"
"17232",46,3,120,119,26056810,26059693,2883,"0","mask"
"17331",46,4,7,120,26062353,26072118,9765,"20","valid"
"17533",46,2,83,121,26078851,26085210,6359,"0","orth"
"17635",46,4,73,122,26088401,26091897,3496,"20","valid"
"17731",46,6,99,123,26095309,26098506,3197,"20","mask"
"17835",46,2,131,124,26101839,26104075,2236,"0","orth"
"17930",46,3,18,125,26106794,26110990,4196,"0","mask"
"18149",46,4,127,126,26116834,26121324,4490,"20","valid"
"18229",46,3,30,127,26124409,26126684,2275,"0","mask"
"18432",46,5,14,128,26131874,26136632,4758,"20","orth"
"18631",46,5,62,129,26150581,26158732,8151,"20","orth"
"18731",46,2,41,130,26161961,26167615,5654,"0","orth"
"18932",46,2,23,131,26172798,26177504,4706,"0","orth"
"19141",46,2,17,132,26182989,26186806,3817,"0","orth"
"19332",46,4,91,133,26192499,26196420,3921,"20","valid"
"19431",46,4,121,134,26199610,26204408,4798,"20","valid"
"19528",46,2,53,135,26207611,26213141,5530,"0","orth"
"19732",46,2,65,136,26218651,26224233,5582,"0","orth"
"19830",46,1,22,137,26227632,26234057,6425,"0","valid"
"20032",46,6,15,138,26240927,26247019,6092,"20","mask"
"10151",47,4,96,1,27221763,27225286,3523,"20","valid"
"11141",47,1,123,2,27228509,27231875,3366,"0","valid"
"12140",47,5,55,3,27235117,27238150,3033,"20","orth"
"13145",47,6,80,4,27241294,27244850,3556,"20","mask"
"14141",47,1,15,5,27248438,27251406,2968,"0","valid"
"16134",47,1,3,6,27257413,27259857,2444,"0","valid"
"18150",47,6,56,7,27267577,27271505,3928,"20","mask"
"19142",47,2,112,8,27274610,27277747,3137,"0","orth"
"2040",47,2,34,9,27280610,27283414,2804,"0","orth"
"2234",47,5,91,10,27292114,27295448,3334,"20","orth"
"2333",47,3,5,11,27298840,27301788,2948,"0","mask"
"2532",47,1,135,12,27308906,27311455,2549,"0","valid"
"2639",47,4,18,13,27314534,27317181,2647,"20","valid"
"2834",47,2,82,14,27324404,27326881,2477,"0","orth"
"2935",47,2,46,15,27330084,27332731,2647,"0","orth"
"3133",47,4,12,16,27340098,27343320,3222,"20","valid"
"3333",47,6,134,17,27351066,27354327,3261,"20","mask"
"3434",47,3,65,18,27357766,27360713,2947,"0","mask"
"3531",47,5,61,19,27364139,27367322,3183,"20","orth"
"3633",47,4,6,20,27371165,27374950,3785,"20","valid"
"3833",47,3,137,21,27385022,27387683,2661,"0","mask"
"3931",47,3,131,22,27391016,27393676,2660,"0","mask"
"4034",47,3,89,23,27396749,27399638,2889,"0","mask"
"4139",47,2,22,24,27403762,27406207,2445,"0","orth"
"4330",47,4,138,25,27416280,27420358,4078,"20","valid"
"4436",47,5,115,26,27423692,27426457,2765,"20","orth"
"4528",47,6,32,27,27433568,27436581,3013,"20","mask"
"4730",47,5,13,28,27443007,27446131,3124,"20","orth"
"4926",47,4,132,29,27452223,27455275,3052,"20","valid"
"5038",47,3,11,30,27458779,27461662,2883,"0","mask"
"5234",47,2,52,31,27468335,27471950,3615,"0","orth"
"5435",47,5,127,32,27478865,27482186,3321,"20","orth"
"5535",47,3,83,33,27485310,27488977,3667,"0","mask"
"5634",47,1,87,34,27493206,27497546,4340,"0","valid"
"5732",47,5,37,35,27501128,27504553,3425,"20","orth"
"5935",47,3,119,36,27511861,27515110,3249,"0","mask"
"6034",47,4,84,37,27519718,27523587,3869,"20","valid"
"6134",47,2,10,38,27528568,27531797,3229,"0","orth"
"6331",47,2,40,39,27562825,27565982,3157,"0","orth"
"6539",47,5,133,40,27573865,27576702,2837,"20","orth"
"6634",47,5,85,41,27580565,27584186,3621,"20","orth"
"6729",47,3,113,42,27587539,27590003,2464,"0","mask"
"6834",47,1,57,43,27593128,27595428,2300,"0","valid"
"6934",47,4,126,44,27599520,27602677,3157,"20","valid"
"7034",47,3,47,45,27605638,27607691,2053,"0","mask"
"7230",47,5,25,46,27614037,27618698,4661,"20","orth"
"7436",47,2,76,47,27624953,27627535,2582,"0","orth"
"7535",47,2,16,48,27643294,27646883,3589,"0","orth"
"7729",47,3,77,49,27658524,27661524,3000,"0","mask"
"7837",47,6,20,50,27664786,27667498,2712,"20","mask"
"8030",47,2,136,51,27674859,27677643,2784,"0","orth"
"8135",47,6,122,52,27680611,27683886,3275,"20","mask"
"8235",47,3,101,53,27687134,27690553,3419,"0","mask"
"8337",47,6,128,54,27693696,27697141,3445,"20","mask"
"8426",47,4,30,55,27700070,27702985,2915,"20","valid"
"8639",47,4,102,56,27708377,27711312,2935,"20","valid"
"8728",47,5,103,57,27715168,27718652,3484,"20","orth"
"8835",47,2,88,58,27722633,27726163,3530,"0","orth"
"8932",47,3,41,59,27731124,27733738,2614,"0","mask"
"9133",47,6,50,60,27740248,27743366,3118,"20","mask"
"9334",47,1,33,61,27750890,27754753,3863,"0","valid"
"9535",47,2,64,62,27760551,27763910,3359,"0","orth"
"9627",47,1,93,63,27767198,27770688,3490,"0","valid"
"9732",47,2,94,64,27774100,27777500,3400,"0","orth"
"9833",47,6,116,65,27781108,27784206,3098,"20","mask"
"9935",47,5,1,66,27821260,27824692,3432,"20","orth"
"10152",47,1,45,67,27831307,27834477,3170,"0","valid"
"10335",47,1,51,68,27841465,27844726,3261,"0","valid"
"10530",47,4,120,69,27852884,27855335,2451,"20","valid"
"10636",47,3,125,70,27860204,27863289,3085,"0","mask"
"10733",47,4,108,71,27866910,27870296,3386,"20","valid"
"10832",47,1,117,72,27873754,27875911,2157,"0","valid"
"10935",47,6,14,73,27880709,27884526,3817,"20","mask"
"11142",47,4,54,74,27892965,27895834,2869,"20","valid"
"11330",47,5,79,75,27902514,27906051,3537,"20","orth"
"11438",47,1,39,76,27909632,27912704,3072,"0","valid"
"11637",47,4,72,77,27919809,27922777,2968,"20","valid"
"11737",47,5,121,78,27926516,27929849,3333,"20","orth"
"11835",47,5,7,79,27932869,27935778,2909,"20","orth"
"12035",47,3,17,80,27942844,27945746,2902,"0","mask"
"12238",47,1,9,81,27952864,27955871,3007,"0","valid"
"12434",47,6,98,82,27962825,27966420,3595,"20","mask"
"12531",47,2,28,83,27969473,27971989,2516,"0","orth"
"12732",47,3,95,84,27977519,27980539,3020,"0","mask"
"12832",47,1,111,85,27983872,27986225,2353,"0","valid"
"12936",47,6,74,86,27989337,27992193,2856,"20","mask"
"13029",47,3,59,87,27996533,27999089,2556,"0","mask"
"13146",47,6,104,88,28003364,28007240,3876,"20","mask"
"13235",47,1,99,89,28011286,28013567,2281,"0","valid"
"13331",47,3,53,90,28016711,28019692,2981,"0","mask"
"13528",47,4,42,91,28025451,28028660,3209,"20","valid"
"13734",47,5,49,92,28035000,28038027,3027,"20","orth"
"13932",47,4,60,93,28044086,28047642,3556,"20","valid"
"14034",47,6,86,94,28050668,28053407,2739,"20","mask"
"14142",47,1,105,95,28058394,28062328,3934,"0","valid"
"14237",47,5,67,96,28065211,28067813,2602,"20","orth"
"14337",47,2,124,97,28070754,28073061,2307,"0","orth"
"14434",47,3,35,98,28077376,28080068,2692,"0","mask"
"14635",47,1,129,99,28086748,28088539,1791,"0","valid"
"14731",47,5,73,100,28093174,28095971,2797,"20","orth"
"14829",47,2,118,101,28099115,28101828,2713,"0","orth"
"14935",47,1,81,102,28104593,28107220,2627,"0","valid"
"15036",47,5,19,103,28110266,28113358,3092,"20","orth"
"15238",47,4,48,104,28121568,28123306,1738,"20","valid"
"15434",47,2,100,105,28130758,28133104,2346,"0","orth"
"15532",47,2,106,106,28135869,28138294,2425,"0","orth"
"15630",47,6,26,107,28143877,28146236,2359,"20","mask"
"15835",47,1,27,108,28153890,28156243,2353,"0","valid"
"16038",47,3,29,109,28161943,28165250,3307,"0","mask"
"16234",47,4,24,110,28173630,28176480,2850,"20","valid"
"16436",47,1,63,111,28182042,28184774,2732,"0","valid"
"16535",47,6,68,112,28188749,28192291,3542,"20","mask"
"16629",47,5,97,113,28195259,28197468,2209,"20","orth"
"16737",47,5,31,114,28202867,28205835,2968,"20","orth"
"16936",47,5,43,115,28211815,28214332,2517,"20","orth"
"17142",47,3,107,116,28221228,28223516,2288,"0","mask"
"17233",47,2,4,117,28227261,28229536,2275,"0","orth"
"17429",47,6,110,118,28235981,28239197,3216,"20","mask"
"17534",47,3,23,119,28242419,28244942,2523,"0","mask"
"17732",47,2,58,120,28250668,28254289,3621,"0","orth"
"17836",47,6,2,121,28258028,28260930,2902,"20","mask"
"18033",47,1,75,122,28270316,28273147,2831,"0","valid"
"18151",47,3,71,123,28276447,28278663,2216,"0","mask"
"18230",47,2,70,124,28281971,28284677,2706,"0","orth"
"18331",47,4,90,125,28288330,28291938,3608,"20","valid"
"18433",47,5,109,126,28296691,28299684,2993,"20","orth"
"18531",47,4,36,127,28303279,28306044,2765,"20","valid"
"18732",47,6,8,128,28312554,28315235,2681,"20","mask"
"18933",47,6,38,129,28324261,28327634,3373,"20","mask"
"19143",47,1,69,130,28334942,28337210,2268,"0","valid"
"19239",47,6,92,131,28340197,28345740,5543,"20","mask"
"19333",47,6,62,132,28349537,28352073,2536,"20","mask"
"19432",47,4,78,133,28355812,28358930,3118,"20","valid"
"19529",47,1,21,134,28362924,28365146,2222,"0","valid"
"19733",47,4,114,135,28371199,28374448,3249,"20","valid"
"19831",47,4,66,136,28378016,28380749,2733,"20","valid"
"19938",47,6,44,137,28386206,28388553,2347,"20","mask"
"20133",47,2,130,138,28395226,28397821,2595,"0","orth"
"10153",48,3,4,1,29600744,29604810,4066,"0","mask"
"12141",48,5,84,2,29611157,29615693,4536,"20","orth"
"13147",48,6,31,3,29618680,29623183,4503,"20","mask"
"15143",48,1,50,4,29629348,29633622,4274,"0","valid"
"17143",48,4,107,5,29639583,29643793,4210,"20","valid"
"18152",48,6,97,6,29646362,29649460,3098,"20","mask"
"19144",48,6,103,7,29656872,29659487,2615,"20","mask"
"2041",48,6,127,8,29662748,29665239,2491,"20","mask"
"2139",48,3,46,9,29668043,29671383,3340,"0","mask"
"2334",48,2,57,10,29679612,29683652,4040,"0","orth"
"2432",48,2,117,11,29687155,29689743,2588,"0","orth"
"2533",48,1,104,12,29693803,29697731,3928,"0","valid"
"2640",48,1,74,13,29700646,29704411,3765,"0","valid"
"2731",48,3,100,14,29708431,29712863,4432,"0","mask"
"2835",48,3,64,15,29716503,29720876,4373,"0","mask"
"2936",48,2,21,16,29724733,29727648,2915,"0","orth"
"3134",48,6,109,17,29733995,29737832,3837,"20","mask"
"3233",48,5,78,18,29741289,29744263,2974,"20","orth"
"3334",48,5,48,19,29748663,29750401,1738,"20","orth"
"3532",48,3,112,20,29758957,29761493,2536,"0","mask"
"3634",48,5,126,21,29764820,29769448,4628,"20","orth"
"3731",48,5,24,22,29773187,29776965,3778,"20","orth"
"3932",48,1,32,23,29783893,29788142,4249,"0","valid"
"4140",48,5,66,24,29795594,29799104,3510,"20","orth"
"4233",48,2,111,25,29802607,29805751,3144,"0","orth"
"4331",48,4,95,26,29809216,29813667,4451,"20","valid"
"4437",48,3,130,27,29817445,29821615,4170,"0","mask"
"4529",48,5,6,28,29824373,29827642,3269,"20","orth"
"4731",48,2,105,29,29835276,29838727,3451,"0","orth"
"4836",48,5,60,30,29842401,29845283,2882,"20","orth"
"4927",48,5,36,31,29848179,29850643,2464,"20","orth"
"5133",48,6,79,32,29857167,29861814,4647,"20","mask"
"5235",48,6,133,33,29866409,29869906,3497,"20","mask"
"5333",48,1,20,34,29873586,29877050,3464,"0","valid"
"5536",48,5,108,35,29886005,29889730,3725,"20","orth"
"5635",48,3,52,36,29893051,29896947,3896,"0","mask"
"5831",48,3,34,37,29904575,29908019,3444,"0","mask"
"6035",48,3,22,38,29914915,29919014,4099,"0","mask"
"6235",48,1,80,39,29924550,29927308,2758,"0","valid"
"6332",48,2,123,40,29932237,29936100,3863,"0","orth"
"6433",48,5,138,41,29939401,29944257,4856,"20","orth"
"6540",48,2,51,42,29947408,29950597,3189,"0","orth"
"6730",48,2,87,43,29957925,29961062,3137,"0","orth"
"6835",48,6,73,44,29964160,29967389,3229,"20","mask"
"6935",48,3,40,45,29972167,29975998,3831,"0","mask"
"7132",48,1,98,46,29982449,29985913,3464,"0","valid"
"7231",48,5,102,47,29989652,29992659,3007,"20","orth"
"7331",48,6,61,48,29997601,30001411,3810,"20","mask"
"7437",48,4,29,49,30004712,30009366,4654,"20","valid"
"7638",48,1,68,50,30016831,30021824,4993,"0","valid"
"7730",48,6,67,51,30024955,30027936,2981,"20","mask"
"7838",48,3,124,52,30031315,30034864,3549,"0","mask"
"7936",48,6,115,53,30038760,30042139,3379,"20","mask"
"8031",48,1,2,54,30045963,30048774,2811,"0","valid"
"8236",48,2,33,55,30059311,30064088,4777,"0","orth"
"8427",48,4,83,56,30072102,30076606,4504,"20","valid"
"8531",48,1,8,57,30080194,30084488,4294,"0","valid"
"8729",48,1,86,58,30091103,30094711,3608,"0","valid"
"8836",48,3,76,59,30099836,30104522,4686,"0","mask"
"8933",48,5,132,60,30107359,30111196,3837,"20","orth"
"9031",48,2,15,61,30114523,30117085,2562,"0","orth"
"9237",48,1,122,62,30124537,30128210,3673,"0","valid"
"9335",48,1,44,63,30131747,30133779,2032,"0","valid"
"9536",48,1,116,64,30141989,30145636,3647,"0","valid"
"9628",48,1,92,65,30149702,30153748,4046,"0","valid"
"9733",48,1,62,66,30165997,30171409,5412,"0","valid"
"9834",48,5,90,67,30174795,30177645,2850,"20","orth"
"9936",48,4,47,68,30180953,30184482,3529,"20","valid"
"10154",48,4,41,69,30190424,30193476,3052,"20","valid"
"10336",48,3,10,70,30199326,30202823,3497,"0","mask"
"10531",48,3,70,71,30210758,30217210,6452,"0","mask"
"10637",48,2,63,72,30222485,30225785,3300,"0","orth"
"10734",48,4,77,73,30228949,30233322,4373,"20","valid"
"10833",48,4,17,74,30236675,30239983,3308,"20","valid"
"11028",48,3,82,75,30246781,30249787,3006,"0","mask"
"11143",48,4,101,76,30252872,30256461,3589,"20","valid"
"11233",48,4,35,77,30259873,30262513,2640,"20","valid"
"11439",48,4,125,78,30270220,30273481,3261,"20","valid"
"11528",48,3,94,79,30276802,30282626,5824,"0","mask"
"11638",48,6,121,80,30285992,30289875,3883,"20","mask"
"11738",48,2,129,81,30293352,30298601,5249,"0","orth"
"11836",48,6,91,82,30302163,30304849,2686,"20","mask"
"11931",48,5,120,83,30308405,30312347,3942,"20","orth"
"12036",48,6,49,84,30315837,30319249,3412,"20","mask"
"12239",48,5,42,85,30325681,30329093,3412,"20","orth"
"12435",48,5,30,86,30336211,30339447,3236,"20","orth"
"12631",48,2,81,87,30345990,30349271,3281,"0","orth"
"12733",48,1,38,88,30352565,30356088,3523,"0","valid"
"12937",48,4,11,89,30364422,30367298,2876,"20","valid"
"13148",48,2,27,90,30373723,30377893,4170,"0","orth"
"13332",48,2,3,91,30384750,30387692,2942,"0","orth"
"13529",48,4,59,92,30394797,30398398,3601,"20","valid"
"13634",48,2,39,93,30401340,30404235,2895,"0","orth"
"13829",48,3,28,94,30411066,30414648,3582,"0","mask"
"14035",48,1,110,95,30423393,30427505,4112,"0","valid"
"14143",48,3,16,96,30431727,30434793,3066,"0","mask"
"14338",48,2,45,97,30441244,30445434,4190,"0","orth"
"14531",48,5,114,98,30452376,30456127,3751,"20","orth"
"14636",48,2,75,99,30459783,30465324,5541,"0","orth"
"14732",48,4,113,100,30468775,30472240,3465,"20","valid"
"14830",48,4,89,101,30476273,30480475,4202,"20","valid"
"14936",48,6,1,102,30484352,30487208,2856,"20","mask"
"15144",48,4,119,103,30493587,30497313,3726,"20","valid"
"15239",48,6,7,104,30500771,30503810,3039,"20","mask"
"15435",48,2,99,105,30513550,30517230,3680,"0","orth"
"15533",48,6,55,106,30520478,30522995,2517,"20","mask"
"15631",48,1,14,107,30526315,30529917,3602,"0","valid"
"15836",48,6,43,108,30537107,30541218,4111,"20","mask"
"16039",48,5,12,109,30549402,30551670,2268,"20","orth"
"16235",48,4,71,110,30558598,30562677,4079,"20","valid"
"16335",48,4,23,111,30566396,30568592,2196,"20","valid"
"16536",48,3,136,112,30574658,30578214,3556,"0","mask"
"16630",48,3,118,113,30581338,30585214,3876,"0","mask"
"16738",48,5,72,114,30588725,30591378,2653,"20","orth"
"16835",48,2,9,115,30595013,30597575,2562,"0","orth"
"17035",48,4,65,116,30604765,30606922,2157,"20","valid"
"17144",48,5,96,117,30610393,30614046,3653,"20","orth"
"17234",48,6,13,118,30617576,30621308,3732,"20","mask"
"17430",48,6,25,119,30627988,30630910,2922,"20","mask"
"17636",48,4,53,120,30637107,30640303,3196,"20","valid"
"17837",48,3,58,121,30646166,30649637,3471,"0","mask"
"17931",48,6,37,122,30652475,30656056,3581,"20","mask"
"18153",48,1,56,123,30664390,30668422,4032,"0","valid"
"18231",48,5,54,124,30672338,30675077,2739,"20","orth"
"18434",48,6,19,125,30682587,30686398,3811,"20","mask"
"18632",48,4,131,126,30695117,30699189,4072,"20","valid"
"18733",48,3,88,127,30702791,30707033,4242,"0","mask"
"18832",48,6,85,128,30710334,30714046,3712,"20","mask"
"18934",48,2,135,129,30717707,30721191,3484,"0","orth"
"19032",48,5,18,130,30724355,30728021,3666,"20","orth"
"19240",48,2,69,131,30734774,30737257,2483,"0","orth"
"19334",48,4,137,132,30741428,30744833,3405,"20","valid"
"19433",48,1,26,133,30747833,30751389,3556,"0","valid"
"19634",48,2,93,134,30760318,30763285,2967,"0","orth"
"19734",48,3,106,135,30766495,30769566,3071,"0","mask"
"19832",48,4,5,136,30773175,30777338,4163,"20","valid"
"20033",48,1,128,137,30785960,30791986,6026,"0","valid"
"20134",48,1,134,138,30796549,30799549,3000,"0","valid"
"10155",49,6,12,1,744872,747414,2542,"20","mask"
"12142",49,5,137,2,753212,755833,2621,"20","orth"
"13149",49,2,104,3,759454,763003,3549,"0","orth"
"14144",49,2,8,4,767102,769867,2765,"0","orth"
"16135",49,1,79,5,776253,778076,1823,"0","valid"
"17145",49,4,4,6,781109,784371,3262,"20","valid"
"19145",49,6,66,7,790469,792672,2203,"20","mask"
"2042",49,2,68,8,795816,798816,3000,"0","orth"
"2140",49,5,59,9,802660,805497,2837,"20","orth"
"2235",49,1,13,10,808922,812150,3228,"0","valid"
"2433",49,3,39,11,818726,822700,3974,"0","mask"
"2641",49,1,31,12,829406,831609,2203,"0","valid"
"2836",49,6,72,13,837315,839851,2536,"20","mask"
"2937",49,4,136,14,842904,846545,3641,"20","valid"
"3034",49,1,85,15,849859,852721,2862,"0","valid"
"3135",49,3,45,16,855754,858500,2746,"0","mask"
"3335",49,4,76,17,863964,867696,3732,"20","valid"
"3435",49,1,115,18,870696,872991,2295,"0","valid"
"3533",49,3,69,19,875821,879089,3268,"0","mask"
"3635",49,2,98,20,882115,885743,3628,"0","orth"
"3732",49,6,132,21,888534,891011,2477,"20","mask"
"3834",49,4,10,22,894234,897149,2915,"20","valid"
"4035",49,1,37,23,903941,909532,5591,"0","valid"
"4234",49,5,125,24,932707,936184,3477,"20","orth"
"4332",49,2,44,25,939708,941819,2111,"0","orth"
"4530",49,6,102,26,947518,949996,2478,"20","mask"
"4635",49,2,92,27,953048,956643,3595,"0","orth"
"4732",49,6,138,28,959898,962879,2981,"20","mask"
"4837",49,1,127,29,967285,969526,2241,"0","valid"
"4928",49,2,32,30,972801,975010,2209,"0","orth"
"5134",49,3,99,31,981024,983377,2353,"0","mask"
"5236",49,6,120,32,986462,989149,2687,"20","mask"
"5334",49,3,75,33,992443,995783,3340,"0","mask"
"5436",49,5,41,34,999104,1001868,2764,"20","orth"
"5636",49,3,9,35,1008071,1011653,3582,"0","mask"
"5832",49,1,43,36,1018275,1022314,4039,"0","valid"
"6036",49,5,89,37,1028353,1032079,3726,"20","orth"
"6135",49,6,18,38,1035759,1039871,4112,"20","mask"
"6333",49,4,58,39,1045518,1048989,3471,"20","valid"
"6434",49,3,87,40,1052669,1055911,3242,"0","mask"
"6541",49,1,91,41,1059140,1062062,2922,"0","valid"
"6635",49,1,49,42,1065022,1068069,3047,"0","valid"
"6836",49,4,70,43,1073690,1077919,4229,"20","valid"
"6936",49,1,19,44,1080939,1082984,2045,"0","valid"
"7133",49,6,126,45,1089325,1094384,5059,"20","mask"
"7232",49,6,114,46,1098430,1102182,3752,"20","mask"
"7332",49,2,128,47,1104777,1108326,3549,"0","orth"
"7438",49,4,88,48,1112058,1115294,3236,"20","valid"
"7536",49,4,100,49,1118634,1122484,3850,"20","valid"
"7639",49,5,131,50,1125850,1128955,3105,"20","orth"
"7731",49,4,118,51,1132354,1136197,3843,"20","valid"
"7839",49,5,107,52,1139753,1142387,2634,"20","orth"
"7937",49,2,134,53,1145949,1147832,1883,"0","orth"
"8032",49,5,29,54,1150701,1153590,2889,"20","orth"
"8237",49,3,135,55,1159669,1162552,2883,"0","mask"
"8338",49,3,21,56,1165885,1168500,2615,"0","mask"
"8532",49,5,5,57,1174958,1178579,3621,"20","orth"
"8730",49,1,103,58,1184357,1188410,4053,"0","valid"
"8837",49,4,22,59,1192135,1194809,2674,"20","valid"
"9032",49,3,93,60,1200352,1202678,2326,"0","mask"
"9134",49,1,1,61,1205607,1208215,2608,"0","valid"
"9336",49,3,63,62,1214320,1218830,4510,"0","mask"
"9428",49,5,53,63,1221850,1224523,2673,"20","orth"
"9629",49,6,30,64,1229667,1231556,1889,"20","mask"
"9835",49,1,61,65,1237302,1239576,2274,"0","valid"
"9937",49,4,82,66,1268460,1272363,3903,"20","valid"
"10038",49,6,54,67,1275415,1278814,3399,"20","mask"
"10232",49,4,16,68,1287592,1289965,2373,"20","valid"
"10431",49,2,122,69,1295632,1296965,1333,"0","orth"
"10532",49,3,33,70,1300358,1304012,3654,"0","mask"
"10735",49,2,50,71,1309639,1312738,3099,"0","orth"
"10936",49,4,106,72,1318339,1321595,3256,"20","valid"
"11029",49,1,55,73,1325601,1327471,1870,"0","valid"
"11144",49,3,129,74,1330255,1333942,3687,"0","mask"
"11234",49,2,56,75,1337092,1339988,2896,"0","orth"
"11331",49,3,123,76,1343472,1345975,2503,"0","mask"
"11440",49,4,28,77,1349407,1352132,2725,"20","valid"
"11639",49,3,81,78,1358460,1361061,2601,"0","mask"
"11739",49,2,62,79,1364049,1367147,3098,"0","orth"
"11837",49,6,84,80,1370343,1375866,5523,"20","mask"
"11932",49,4,64,81,1379141,1382246,3105,"20","valid"
"12037",49,4,52,82,1385056,1387651,2595,"20","valid"
"12240",49,1,73,83,1393815,1396037,2222,"0","valid"
"12329",49,5,95,84,1399613,1403940,4327,"20","orth"
"12436",49,2,86,85,1408176,1410234,2058,"0","orth"
"12532",49,6,36,86,1413725,1415921,2196,"20","mask"
"12734",49,5,83,87,1421719,1425209,3490,"20","orth"
"12833",49,1,121,88,1428353,1429967,1614,"0","valid"
"12938",49,1,7,89,1433406,1436125,2719,"0","valid"
"13150",49,1,67,90,1443008,1445132,2124,"0","valid"
"13236",49,4,46,91,1448243,1451008,2765,"20","valid"
"13435",49,6,48,92,1457747,1459322,1575,"20","mask"
"13635",49,4,112,93,1465303,1467388,2085,"20","valid"
"13735",49,3,51,94,1470826,1473323,2497,"0","mask"
"13933",49,6,90,95,1478618,1482794,4176,"20","mask"
"14036",49,5,11,96,1486043,1489056,3013,"20","orth"
"14238",49,5,35,97,1495272,1497645,2373,"20","orth"
"14435",49,5,71,98,1503443,1505685,2242,"20","orth"
"14532",49,2,38,99,1509914,1511646,1732,"0","orth"
"14733",49,5,113,100,1516882,1519150,2268,"20","orth"
"14831",49,2,116,101,1521954,1526000,4046,"0","orth"
"14937",49,4,124,102,1529765,1532144,2379,"20","valid"
"15037",49,4,40,103,1535393,1538053,2660,"20","valid"
"15240",49,6,42,104,1543609,1546138,2529,"20","mask"
"15436",49,6,96,105,1552329,1555623,3294,"20","mask"
"15534",49,2,2,106,1558780,1561329,2549,"0","orth"
"15738",49,5,77,107,1571598,1574866,3268,"20","orth"
"15837",49,4,34,108,1577716,1581199,3483,"20","valid"
"16040",49,5,65,109,1587664,1590311,2647,"20","orth"
"16136",49,4,94,110,1593318,1597488,4170,"20","valid"
"16236",49,3,3,111,1600521,1602377,1856,"0","mask"
"16437",49,3,117,112,1607776,1609626,1850,"0","mask"
"16537",49,5,101,113,1612868,1615823,2955,"20","orth"
"16631",49,1,109,114,1618784,1622548,3764,"0","valid"
"16739",49,2,80,115,1625836,1627568,1732,"0","orth"
"16836",49,3,111,116,1630634,1633118,2484,"0","mask"
"16937",49,4,130,117,1636406,1639308,2902,"20","valid"
"17036",49,6,78,118,1642314,1645275,2961,"20","mask"
"17146",49,5,47,119,1648060,1650165,2105,"20","orth"
"17332",49,1,133,120,1656185,1658453,2268,"0","valid"
"17431",49,3,15,121,1661688,1664120,2432,"0","mask"
"17637",49,1,25,122,1669924,1671780,1856,"0","valid"
"17838",49,3,105,123,1679173,1680977,1804,"0","mask"
"17932",49,2,110,124,1685827,1687488,1661,"0","orth"
"18034",49,2,26,125,1691344,1694187,2843,"0","orth"
"18232",49,3,27,126,1701645,1704051,2406,"0","mask"
"18435",49,5,119,127,1710404,1714391,3987,"20","orth"
"18532",49,3,57,128,1717339,1719548,2209,"0","mask"
"18633",49,6,108,129,1723202,1725830,2628,"20","mask"
"18734",49,6,6,130,1729255,1732131,2876,"20","mask"
"18935",49,6,24,131,1739452,1743086,3634,"20","mask"
"19146",49,2,14,132,1748563,1752511,3948,"0","orth"
"19335",49,5,17,133,1758753,1761342,2589,"20","orth"
"19530",49,2,20,134,1766414,1768048,1634,"0","orth"
"19735",49,5,23,135,1774114,1776120,2006,"20","orth"
"19939",49,6,60,136,1782585,1785082,2497,"20","mask"
"20034",49,1,97,137,1787919,1791762,3843,"0","valid"
"20135",49,2,74,138,1794743,1798723,3980,"0","orth"
"10156",50,6,131,1,1355688,1358590,2902,"20","mask"
"11145",50,4,117,2,1361689,1364950,3261,"20","valid"
"12143",50,5,22,3,1368297,1372290,3993,"20","orth"
"14145",50,2,31,4,1378173,1382736,4563,"0","orth"
"16137",50,5,124,5,1389121,1391579,2458,"20","orth"
"17147",50,6,119,6,1394691,1402554,7863,"20","mask"
"18154",50,4,129,7,1406011,1408829,2818,"20","valid"
"19147",50,6,95,8,1412012,1417025,5013,"20","mask"
"2043",50,5,40,9,1420307,1424052,3745,"20","orth"
"2236",50,2,79,10,1431536,1433797,2261,"0","orth"
"2335",50,4,27,11,1436634,1441726,5092,"20","valid"
"2534",50,5,28,12,1447138,1450576,3438,"20","orth"
"2732",50,2,13,13,1457218,1460871,3653,"0","orth"
"2938",50,6,125,14,1466192,1470774,4582,"20","mask"
"3035",50,5,100,15,1474068,1477611,3543,"20","orth"
"3136",50,1,12,16,1480735,1483363,2628,"0","valid"
"3336",50,1,96,17,1489010,1491324,2314,"0","valid"
"3436",50,5,10,18,1494481,1498946,4465,"20","orth"
"3636",50,4,135,19,1505312,1508358,3046,"20","valid"
"3733",50,2,109,20,1511907,1515653,3746,"0","orth"
"3835",50,2,1,21,1519006,1520731,1725,"0","orth"
"4036",50,2,85,22,1526784,1529444,2660,"0","orth"
"4141",50,6,101,23,1532549,1538105,5556,"20","mask"
"4235",50,1,18,24,1540968,1544380,3412,"0","valid"
"4438",50,2,43,25,1550759,1552857,2098,"0","orth"
"4636",50,2,115,26,1559642,1562499,2857,"0","orth"
"4733",50,1,54,27,1565264,1567081,1817,"0","valid"
"4929",50,5,46,28,1575330,1582670,7340,"20","orth"
"5135",50,1,6,29,1588677,1591749,3072,"0","valid"
"5335",50,1,126,30,1597586,1600397,2811,"0","valid"
"5437",50,5,94,31,1603711,1608750,5039,"20","orth"
"5537",50,5,106,32,1611652,1615280,3628,"20","orth"
"5637",50,3,74,33,1618829,1622954,4125,"0","mask"
"5733",50,6,107,34,1626150,1629131,2981,"20","mask"
"5833",50,3,38,35,1632124,1635196,3072,"0","mask"
"6037",50,3,2,36,1641432,1643255,1823,"0","mask"
"6236",50,4,111,37,1650714,1653125,2411,"20","valid"
"6334",50,3,104,38,1656766,1659158,2392,"0","mask"
"6435",50,1,84,39,1662388,1665996,3608,"0","valid"
"6542",50,2,103,40,1668924,1672179,3255,"0","orth"
"6636",50,2,49,41,1675134,1677754,2620,"0","orth"
"6837",50,4,9,42,1683892,1686925,3033,"20","valid"
"7035",50,4,33,43,1692958,1695749,2791,"20","valid"
"7233",50,2,127,44,1701678,1706188,4510,"0","orth"
"7333",50,2,133,45,1709476,1711881,2405,"0","orth"
"7439",50,2,7,46,1714737,1718809,4072,"0","orth"
"7640",50,2,55,47,1725960,1727575,1615,"0","orth"
"7732",50,6,17,48,1730673,1735654,4981,"20","mask"
"7938",50,3,32,49,1741066,1743837,2771,"0","mask"
"8136",50,2,37,50,1749628,1756812,7184,"0","orth"
"8339",50,3,68,51,1763244,1765231,1987,"0","mask"
"8428",50,5,118,52,1768074,1770675,2601,"20","orth"
"8533",50,3,110,53,1773571,1775453,1882,"0","mask"
"8640",50,3,26,54,1778617,1780840,2223,"0","mask"
"8838",50,3,14,55,1787703,1790468,2765,"0","mask"
"9033",50,3,56,56,1796625,1799867,3242,"0","mask"
"9135",50,1,132,57,1802848,1804887,2039,"0","valid"
"9238",50,4,69,58,1807665,1809240,1575,"20","valid"
"9337",50,5,130,59,1812711,1816652,3941,"20","orth"
"9429",50,1,36,60,1820104,1821790,1686,"0","valid"
"9630",50,3,80,61,1827653,1829973,2320,"0","mask"
"9734",50,6,5,62,1833562,1837144,3582,"20","mask"
"9938",50,6,71,63,1843190,1845922,2732,"20","mask"
"10039",50,2,67,64,1848909,1850661,1752,"0","orth"
"10157",50,1,60,65,1853851,1856557,2706,"0","valid"
"10233",50,5,58,66,1899854,1903338,3484,"20","orth"
"10337",50,1,114,67,1906736,1909658,2922,"0","valid"
"10432",50,3,116,68,1914018,1917567,3549,"0","mask"
"10533",50,3,44,69,1923025,1926574,3549,"0","mask"
"10736",50,4,51,70,1932451,1934562,2111,"20","valid"
"10937",50,1,78,71,1940275,1941765,1490,"0","valid"
"11030",50,6,35,72,1944863,1947001,2138,"20","mask"
"11235",50,2,25,73,1954041,1956655,2614,"0","orth"
"11441",50,3,62,74,1962459,1964270,1811,"0","mask"
"11529",50,1,72,75,1967263,1968741,1478,"0","valid"
"11640",50,1,108,76,1972048,1973983,1935,"0","valid"
"11740",50,5,82,77,1977238,1979395,2157,"20","orth"
"11838",50,5,34,78,1982670,1985186,2516,"20","orth"
"12038",50,4,87,79,1991003,1993304,2301,"20","valid"
"12144",50,6,137,80,1997174,1998847,1673,"20","mask"
"12241",50,1,138,81,2002338,2004913,2575,"0","valid"
"12330",50,3,128,82,2009057,2012835,3778,"0","mask"
"12437",50,4,39,83,2017071,2019077,2006,"20","valid"
"12632",50,6,89,84,2026392,2028764,2372,"20","mask"
"12735",50,6,23,85,2032196,2033915,1719,"20","mask"
"12939",50,2,121,86,2039418,2041464,2046,"0","orth"
"13030",50,3,92,87,2044589,2046837,2248,"0","mask"
"13151",50,4,63,88,2051811,2053746,1935,"20","valid"
"13237",50,5,88,89,2057831,2060113,2282,"20","orth"
"13333",50,5,136,90,2063329,2065420,2091,"20","orth"
"13436",50,6,113,91,2068427,2070244,1817,"20","mask"
"13530",50,4,123,92,2073800,2076728,2928,"20","valid"
"13636",50,6,59,93,2080434,2082630,2196,"20","mask"
"13736",50,4,15,94,2085748,2087317,1569,"20","valid"
"13934",50,1,102,95,2093030,2094997,1967,"0","valid"
"14037",50,5,76,96,2098102,2101076,2974,"20","orth"
"14146",50,2,19,97,2104017,2105573,1556,"0","orth"
"14339",50,1,42,98,2112018,2114266,2248,"0","valid"
"14533",50,6,65,99,2121117,2122737,1620,"20","mask"
"14637",50,6,47,100,2125731,2127065,1334,"20","mask"
"14832",50,1,48,101,2132006,2133202,1196,"0","valid"
"15038",50,2,73,102,2139418,2144804,5386,"0","orth"
"15145",50,3,86,103,2147968,2151020,3052,"0","mask"
"15241",50,6,11,104,2154471,2157073,2602,"20","mask"
"15437",50,6,53,105,2162871,2165086,2215,"20","mask"
"15632",50,6,41,106,2170571,2172283,1712,"20","mask"
"15838",50,1,120,107,2178441,2180160,1719,"0","valid"
"15930",50,4,105,108,2182879,2184748,1869,"20","valid"
"16041",50,4,93,109,2187892,2189964,2072,"20","valid"
"16138",50,5,112,110,2194611,2196468,1857,"20","orth"
"16237",50,5,16,111,2199697,2201631,1934,"20","orth"
"16438",50,4,21,112,2208161,2213090,4929,"20","valid"
"16632",50,2,97,113,2218848,2220940,2092,"0","orth"
"16740",50,5,52,114,2223888,2225731,1843,"20","orth"
"16938",50,5,70,115,2234810,2237353,2543,"20","orth"
"17037",50,4,81,116,2240896,2242438,1542,"20","valid"
"17148",50,4,99,117,2245543,2247308,1765,"20","valid"
"17235",50,2,61,118,2251752,2253727,1975,"0","orth"
"17333",50,6,77,119,2257249,2259217,1968,"20","mask"
"17432",50,6,29,120,2264021,2266250,2229,"20","mask"
"17638",50,3,20,121,2272492,2275473,2981,"0","mask"
"17839",50,5,4,122,2282467,2284205,1738,"20","orth"
"18035",50,1,30,123,2290912,2292546,1634,"0","valid"
"18233",50,3,8,124,2298037,2299710,1673,"0","mask"
"18436",50,4,45,125,2305815,2307658,1843,"20","valid"
"18634",50,5,64,126,2314090,2317227,3137,"20","orth"
"18735",50,1,66,127,2320280,2322044,1764,"0","valid"
"18833",50,4,3,128,2325711,2327339,1628,"20","valid"
"19033",50,2,91,129,2336542,2338274,1732,"0","orth"
"19148",50,4,75,130,2341824,2344830,3006,"20","valid"
"19241",50,3,98,131,2347517,2349576,2059,"0","mask"
"19336",50,1,24,132,2352373,2354321,1948,"0","valid"
"19531",50,4,57,133,2360139,2362040,1901,"20","valid"
"19635",50,3,134,134,2365120,2367806,2686,"0","mask"
"19736",50,1,90,135,2370793,2372263,1470,"0","valid"
"19833",50,3,122,136,2375447,2377015,1568,"0","mask"
"19940",50,6,83,137,2380297,2382493,2196,"20","mask"
"20035",50,3,50,138,2386578,2388872,2294,"0","mask"
"10158",51,1,113,1,3961413,3964256,2843,"0","valid"
"11146",51,4,110,2,3967355,3970754,3399,"20","valid"
"12145",51,5,33,3,3973741,3977101,3360,"20","orth"
"14147",51,1,89,4,3983709,3987683,3974,"0","valid"
"15146",51,4,44,5,3991095,3994265,3170,"20","valid"
"17149",51,3,31,6,4000109,4003416,3307,"0","mask"
"19149",51,3,67,7,4008749,4011534,2785,"0","mask"
"2044",51,2,42,8,4014783,4018319,3536,"0","orth"
"2237",51,3,109,9,4024293,4028025,3732,"0","mask"
"2336",51,6,118,10,4031189,4033921,2732,"20","mask"
"2434",51,3,13,11,4040248,4043732,3484,"0","mask"
"2642",51,5,81,12,4049726,4052524,2798,"20","orth"
"2733",51,6,16,13,4055746,4059217,3471,"20","mask"
"2939",51,5,21,14,4065296,4068283,2987,"20","orth"
"3137",51,6,28,15,4075375,4078369,2994,"20","mask"
"3337",51,6,4,16,4108174,4111939,3765,"20","mask"
"3534",51,3,1,17,4117822,4120371,2549,"0","mask"
"3734",51,5,63,18,4125980,4128293,2313,"20","orth"
"3836",51,3,103,19,4131091,4134947,3856,"0","mask"
"3933",51,1,137,20,4138732,4141222,2490,"0","valid"
"4037",51,5,45,21,4144314,4147046,2732,"20","orth"
"4236",51,5,75,22,4153079,4157066,3987,"20","orth"
"4333",51,4,2,23,4160296,4162950,2654,"20","valid"
"4531",51,5,3,24,4168871,4171283,2412,"20","orth"
"4734",51,2,54,25,4176885,4178983,2098,"0","orth"
"4930",51,2,120,26,4185748,4187977,2229,"0","orth"
"5039",51,4,92,27,4191036,4194415,3379,"20","valid"
"5136",51,2,78,28,4197194,4199291,2097,"0","orth"
"5237",51,6,22,29,4203239,4206475,3236,"20","mask"
"5438",51,6,46,30,4212991,4216188,3197,"20","mask"
"5638",51,2,132,31,4221953,4224692,2739,"0","orth"
"5734",51,1,119,32,4227751,4231039,3288,"0","valid"
"5834",51,4,116,33,4233921,4237033,3112,"20","valid"
"5936",51,4,74,34,4240137,4243366,3229,"20","valid"
"6038",51,3,91,35,4246621,4249935,3314,"0","mask"
"6136",51,3,79,36,4253622,4256433,2811,"0","mask"
"6237",51,5,87,37,4259818,4262819,3001,"20","orth"
"6335",51,6,40,38,4265793,4268884,3091,"20","mask"
"6543",51,2,48,39,4274434,4276636,2202,"0","orth"
"6731",51,1,83,40,4283009,4285899,2890,"0","valid"
"6838",51,4,38,41,4288859,4292003,3144,"20","valid"
"7036",51,2,126,42,4298154,4300612,2458,"0","orth"
"7134",51,6,124,43,4303743,4306874,3131,"20","mask"
"7234",51,4,122,44,4310004,4312769,2765,"20","valid"
"7334",51,6,100,45,4315528,4318809,3281,"20","mask"
"7440",51,1,77,46,4321973,4324947,2974,"0","valid"
"7537",51,5,129,47,4327797,4331333,3536,"20","orth"
"7641",51,3,133,48,4334902,4338098,3196,"0","mask"
"7733",51,3,127,49,4340974,4343484,2510,"0","mask"
"7840",51,2,18,50,4346099,4349046,2947,"0","orth"
"8033",51,6,88,51,4355322,4358335,3013,"20","mask"
"8137",51,5,93,52,4361361,4364146,2785,"20","orth"
"8238",51,2,84,53,4367695,4371636,3941,"0","orth"
"8340",51,5,57,54,4375349,4378519,3170,"20","orth"
"8429",51,2,30,55,4386363,4389944,3581,"0","orth"
"8641",51,1,101,56,4395415,4398540,3125,"0","valid"
"8731",51,4,56,57,4401533,4405704,4171,"20","valid"
"8839",51,2,72,58,4408704,4410907,2203,"0","orth"
"8934",51,6,82,59,4413874,4416580,2706,"20","mask"
"9034",51,2,138,60,4420130,4422881,2751,"0","orth"
"9136",51,5,111,61,4426019,4429157,3138,"20","orth"
"9239",51,1,47,62,4432405,4434869,2464,"0","valid"
"9430",51,2,12,63,4440732,4443327,2595,"0","orth"
"9631",51,4,80,64,4449341,4452295,2954,"20","valid"
"9735",51,1,125,65,4455498,4457263,1765,"0","valid"
"9836",51,6,94,66,4484964,4488206,3242,"20","mask"
"9939",51,5,39,67,4491271,4494403,3132,"20","orth"
"10159",51,1,35,68,4499775,4501919,2144,"0","valid"
"10338",51,2,36,69,4508096,4510645,2549,"0","orth"
"10534",51,5,51,70,4517848,4520568,2720,"20","orth"
"10737",51,2,114,71,4525947,4529765,3818,"0","orth"
"10834",51,1,17,72,4533058,4535712,2654,"0","valid"
"11031",51,6,130,73,4541111,4545177,4066,"20","mask"
"11147",51,1,29,74,4548628,4552197,3569,"0","valid"
"11332",51,4,104,75,4559348,4561956,2608,"20","valid"
"11442",51,1,65,76,4565335,4568205,2870,"0","valid"
"11530",51,2,66,77,4571114,4574251,3137,"0","orth"
"11641",51,4,32,78,4577205,4580324,3119,"20","valid"
"11839",51,5,9,79,4587140,4590017,2877,"20","orth"
"12039",51,3,97,80,4595958,4598344,2386,"0","mask"
"12146",51,5,105,81,4601305,4603442,2137,"20","orth"
"12242",51,1,53,82,4606442,4609573,3131,"0","valid"
"12438",51,1,11,83,4615312,4617966,2654,"0","valid"
"12633",51,1,5,84,4625156,4627987,2831,"0","valid"
"12834",51,1,71,85,4634019,4636248,2229,"0","valid"
"12940",51,6,106,86,4639040,4641942,2902,"20","mask"
"13031",51,5,27,87,4645007,4648576,3569,"20","orth"
"13238",51,1,131,88,4654426,4656517,2091,"0","valid"
"13334",51,2,90,89,4659348,4662374,3026,"0","orth"
"13437",51,1,95,90,4665499,4668414,2915,"0","valid"
"13531",51,6,136,91,4671205,4673832,2627,"20","mask"
"13637",51,5,99,92,4677127,4680094,2967,"20","orth"
"13737",51,6,70,93,4683278,4688323,5045,"20","mask"
"13830",51,5,135,94,4691716,4697207,5491,"20","orth"
"13935",51,5,123,95,4700808,4703763,2955,"20","orth"
"14038",51,6,112,96,4706606,4709430,2824,"20","mask"
"14148",51,4,14,97,4712783,4716384,3601,"20","valid"
"14340",51,4,134,98,4723581,4727692,4111,"20","valid"
"14436",51,4,50,99,4730719,4733850,3131,"20","valid"
"14638",51,6,76,100,4739909,4742994,3085,"20","mask"
"14734",51,2,102,101,4746027,4748380,2353,"0","orth"
"14833",51,2,96,102,4751452,4754073,2621,"0","orth"
"14938",51,6,34,103,4757478,4763943,6465,"20","mask"
"15147",51,3,121,104,4770231,4772558,2327,"0","mask"
"15242",51,2,24,105,4775395,4778003,2608,"0","orth"
"15438",51,4,20,106,4784467,4786964,2497,"20","valid"
"15633",51,6,64,107,4793141,4796507,3366,"20","mask"
"15739",51,3,73,108,4799370,4803462,4092,"0","mask"
"15839",51,4,8,109,4807678,4811155,3477,"20","valid"
"16042",51,4,26,110,4817391,4820339,2948,"20","valid"
"16238",51,1,41,111,4826195,4829411,3216,"0","valid"
"16439",51,6,10,112,4834706,4838818,4112,"20","mask"
"16633",51,2,60,113,4844556,4847589,3033,"0","orth"
"16741",51,3,49,114,4850478,4854197,3719,"0","mask"
"16939",51,2,108,115,4860224,4862982,2758,"0","orth"
"17038",51,3,37,116,4866126,4870133,4007,"0","mask"
"17236",51,3,7,117,4875833,4878513,2680,"0","mask"
"17433",51,3,43,118,4884219,4886820,2601,"0","mask"
"17639",51,4,98,119,4892121,4895416,3295,"20","valid"
"17733",51,5,69,120,4898266,4900350,2084,"20","orth"
"17840",51,3,115,121,4903161,4906985,3824,"0","mask"
"17933",51,4,62,122,4909881,4913234,3353,"20","valid"
"18036",51,6,58,123,4915999,4918731,2732,"20","mask"
"18155",51,2,6,124,4921457,4924928,3471,"0","orth"
"18332",51,3,61,125,4931418,4933529,2111,"0","mask"
"18437",51,4,128,126,4936353,4940883,4530,"20","valid"
"18533",51,6,52,127,4943987,4946654,2667,"20","mask"
"18736",51,5,117,128,4952504,4955027,2523,"20","orth"
"18834",51,1,59,129,4958021,4960858,2837,"0","valid"
"18936",51,1,23,130,4963806,4967067,3261,"0","valid"
"19150",51,1,107,131,4972904,4976029,3125,"0","valid"
"19242",51,3,85,132,4979088,4982108,3020,"0","mask"
"19337",51,4,68,133,4985186,4989004,3818,"20","valid"
"19434",51,4,86,134,4992141,4995455,3314,"20","valid"
"19532",51,5,15,135,4998226,5000592,2366,"20","orth"
"19737",51,3,19,136,5006763,5008560,1797,"0","mask"
"19941",51,3,55,137,5016404,5018411,2007,"0","mask"
"20036",51,3,25,138,5021561,5023757,2196,"0","mask"
"10160",52,2,125,1,6151322,6155787,4465,"0","orth"
"11148",52,6,117,2,6158525,6163630,5105,"20","mask"
"12147",52,4,121,3,6167886,6172010,4124,"20","valid"
"13152",52,4,31,4,6176971,6183403,6432,"20","valid"
"15148",52,4,67,5,6191946,6195789,3843,"20","valid"
"16139",52,6,51,6,6200652,6205130,4478,"20","mask"
"18156",52,4,37,7,6211163,6216843,5680,"20","valid"
"2045",52,3,42,8,6225014,6228766,3752,"0","mask"
"2238",52,4,43,9,6235557,6239661,4104,"20","valid"
"2435",52,1,88,10,6247858,6252656,4798,"0","valid"
"2535",52,1,16,11,6255963,6260094,4131,"0","valid"
"2734",52,3,24,12,6266016,6270357,4341,"0","mask"
"2940",52,3,96,13,6283168,6291233,8065,"0","mask"
"3036",52,5,62,14,6294240,6299587,5347,"20","orth"
"3138",52,1,76,15,6302398,6306548,4150,"0","valid"
"3234",52,5,122,16,6309790,6313490,3700,"20","orth"
"3338",52,4,55,17,6316379,6319445,3066,"20","valid"
"3437",52,4,103,18,6323308,6327164,3856,"20","valid"
"3535",52,1,46,19,6330543,6333962,3419,"0","valid"
"3735",52,4,19,20,6339452,6343433,3981,"20","valid"
"3934",52,5,86,21,6349708,6354342,4634,"20","orth"
"4038",52,2,59,22,6358107,6361677,3570,"0","orth"
"4142",52,2,131,23,6366056,6369801,3745,"0","orth"
"4237",52,1,82,24,6372781,6376723,3942,"0","valid"
"4334",52,3,30,25,6382488,6386083,3595,"0","mask"
"4532",52,1,64,26,6392024,6396136,4112,"0","valid"
"4637",52,1,40,27,6399587,6403136,3549,"0","valid"
"4838",52,6,111,28,6408693,6417039,8346,"20","mask"
"4931",52,5,2,29,6420249,6426020,5771,"20","orth"
"5137",52,1,130,30,6432576,6436355,3779,"0","valid"
"5238",52,6,15,31,6439962,6443230,3268,"20","mask"
"5439",52,3,12,32,6449041,6451911,2870,"0","mask"
"5639",52,1,22,33,6458604,6462317,3713,"0","valid"
"5835",52,2,47,34,6469566,6472311,2745,"0","orth"
"6039",52,2,17,35,6477834,6481697,3863,"0","orth"
"6238",52,1,118,36,6488671,6493142,4471,"0","valid"
"6336",52,6,75,37,6497071,6503332,6261,"20","mask"
"6436",52,3,138,38,6506555,6516288,9733,"0","mask"
"6544",52,4,1,39,6519353,6522615,3262,"20","valid"
"6732",52,3,48,40,6529713,6532073,2360,"0","mask"
"6937",52,3,18,41,6537877,6540819,2942,"0","mask"
"7135",52,5,14,42,6546656,6550564,3908,"20","orth"
"7335",52,4,109,43,6558480,6562494,4014,"20","valid"
"7441",52,6,105,44,6566461,6571206,4745,"20","mask"
"7538",52,1,34,45,6574442,6577377,2935,"0","valid"
"7734",52,6,123,46,6585874,6589096,3222,"20","mask"
"7841",52,3,66,47,6591914,6595731,3817,"0","mask"
"7939",52,2,137,48,6598587,6601529,2942,"0","orth"
"8034",52,3,60,49,6604470,6612385,7915,"0","mask"
"8138",52,5,68,50,6616615,6620569,3954,"20","orth"
"8239",52,3,36,51,6623726,6630347,6621,"0","mask"
"8430",52,6,9,52,6637511,6640819,3308,"20","mask"
"8642",52,2,107,53,6647460,6650454,2994,"0","orth"
"8732",52,4,133,54,6653787,6656951,3164,"20","valid"
"8840",52,2,11,55,6659735,6662566,2831,"0","orth"
"9035",52,3,72,56,6670494,6675808,5314,"0","mask"
"9137",52,4,127,57,6678985,6681665,2680,"20","valid"
"9240",52,4,13,58,6684684,6687619,2935,"20","valid"
"9431",52,2,77,59,6693502,6696319,2817,"0","orth"
"9537",52,3,84,60,6699071,6703601,4530,"0","mask"
"9632",52,6,93,61,6706705,6709928,3223,"20","mask"
"9736",52,3,114,62,6713647,6718353,4706,"0","mask"
"9837",52,2,113,63,6721413,6724825,3412,"0","orth"
"9940",52,4,61,64,6728034,6731296,3262,"20","valid"
"10040",52,3,54,65,6734302,6737819,3517,"0","mask"
"10234",52,5,116,66,6815020,6818929,3909,"20","orth"
"10339",52,5,104,67,6822079,6825472,3393,"20","orth"
"10433",52,6,63,68,6828322,6831198,2876,"20","mask"
"10535",52,6,39,69,6834002,6836806,2804,"20","mask"
"10738",52,3,126,70,6842100,6849983,7883,"0","mask"
"10835",52,5,110,71,6852951,6856304,3353,"20","orth"
"10938",52,5,26,72,6859310,6861840,2530,"20","orth"
"11149",52,6,129,73,6867448,6871887,4439,"20","mask"
"11236",52,3,132,74,6874919,6880671,5752,"0","mask"
"11333",52,2,101,75,6883704,6886744,3040,"0","orth"
"11443",52,2,95,76,6889718,6894104,4386,"0","orth"
"11531",52,5,38,77,6897947,6900843,2896,"20","orth"
"11741",52,1,28,78,6906596,6910039,3443,"0","valid"
"11933",52,5,50,79,6915817,6919112,3295,"20","orth"
"12148",52,2,23,80,6924302,6926465,2163,"0","orth"
"12331",52,6,21,81,6931642,6934649,3007,"20","mask"
"12533",52,1,10,82,6940793,6943577,2784,"0","valid"
"12736",52,4,85,83,6949617,6952330,2713,"20","valid"
"12835",52,5,134,84,6955925,6961651,5726,"20","orth"
"12941",52,5,20,85,6964984,6968200,3216,"20","orth"
"13153",52,6,99,86,6975573,6978828,3255,"20","mask"
"13239",52,6,57,87,6982338,6985914,3576,"20","mask"
"13335",52,5,56,88,6989012,6993496,4484,"20","orth"
"13438",52,2,89,89,6996888,7000889,4001,"0","orth"
"13532",52,4,7,90,7005889,7009758,3869,"20","valid"
"13738",52,5,74,91,7015792,7018811,3019,"20","orth"
"13831",52,4,91,92,7021713,7025126,3413,"20","valid"
"13936",52,3,102,93,7028753,7031368,2615,"0","mask"
"14039",52,6,45,94,7034133,7037957,3824,"20","mask"
"14239",52,1,136,95,7043519,7045983,2464,"0","valid"
"14341",52,1,106,96,7048650,7051238,2588,"0","valid"
"14437",52,3,108,97,7054114,7057409,3295,"0","mask"
"14534",52,1,58,98,7060736,7064390,3654,"0","valid"
"14639",52,2,119,99,7067547,7076357,8810,"0","orth"
"14735",52,6,81,100,7079397,7083129,3732,"20","mask"
"14834",52,3,120,101,7087411,7091097,3686,"0","mask"
"14939",52,4,115,102,7095130,7098542,3412,"20","valid"
"15039",52,6,27,103,7101863,7105196,3333,"20","mask"
"15243",52,5,32,104,7112001,7115210,3209,"20","orth"
"15439",52,2,35,105,7123040,7125472,2432,"0","orth"
"15634",52,5,92,106,7131923,7134623,2700,"20","orth"
"15740",52,6,33,107,7137662,7141826,4164,"20","mask"
"15931",52,5,98,108,7148330,7152343,4013,"20","orth"
"16043",52,6,3,109,7155579,7158997,3418,"20","mask"
"16239",52,1,4,110,7164501,7167240,2739,"0","valid"
"16440",52,2,5,111,7172671,7176064,3393,"0","orth"
"16634",52,5,8,112,7182149,7185038,2889,"20","orth"
"16837",52,3,90,113,7190849,7195973,5124,"0","mask"
"16940",52,2,41,114,7199033,7202013,2980,"0","orth"
"17150",52,1,94,115,7207497,7210719,3222,"0","valid"
"17237",52,5,80,116,7213608,7216380,2772,"20","orth"
"17334",52,3,78,117,7220223,7222668,2445,"0","mask"
"17434",52,5,44,118,7226191,7229649,3458,"20","orth"
"17640",52,3,6,119,7235760,7239519,3759,"0","mask"
"17841",52,6,69,120,7245898,7248375,2477,"20","mask"
"17934",52,4,25,121,7251814,7255187,3373,"20","valid"
"18157",52,6,135,122,7260442,7263802,3360,"20","mask"
"18234",52,1,124,123,7268331,7270632,2301,"0","valid"
"18333",52,2,29,124,7273619,7276011,2392,"0","orth"
"18534",52,1,70,125,7281829,7284947,3118,"0","valid"
"18635",52,5,128,126,7287960,7293176,5216,"20","orth"
"18737",52,1,100,127,7296477,7299301,2824,"0","valid"
"18835",52,4,79,128,7302503,7305798,3295,"20","valid"
"18937",52,4,97,129,7309282,7311779,2497,"20","valid"
"19034",52,6,87,130,7314746,7318073,3327,"20","mask"
"19151",52,1,112,131,7322426,7326263,3837,"0","valid"
"19243",52,1,52,132,7329387,7333394,4007,"0","valid"
"19435",52,4,73,133,7339107,7343657,4550,"20","valid"
"19533",52,4,49,134,7347082,7350467,3385,"20","valid"
"19738",52,2,65,135,7355729,7360213,4484,"0","orth"
"19834",52,2,83,136,7363050,7366482,3432,"0","orth"
"19942",52,2,53,137,7369881,7373907,4026,"0","orth"
"20136",52,2,71,138,7381274,7384731,3457,"0","orth"
"10161",53,2,40,1,8546645,8552299,5654,"0","orth"
"12149",53,1,105,2,8558430,8563078,4648,"0","valid"
"13154",53,6,74,3,8566150,8573523,7373,"20","mask"
"14149",53,1,129,4,8576791,8584059,7268,"0","valid"
"15149",53,4,30,5,8587027,8591909,4882,"20","valid"
"17151",53,5,49,6,8597368,8602538,5170,"20","orth"
"19152",53,5,115,7,8607976,8612336,4360,"20","orth"
"2046",53,6,134,8,8615748,8619696,3948,"20","mask"
"2141",53,4,66,9,8622880,8626925,4045,"20","valid"
"2239",53,6,56,10,8630219,8639436,9217,"20","mask"
"2337",53,2,100,11,8642750,8648273,5523,"0","orth"
"2436",53,4,132,12,8651214,8657424,6210,"20","valid"
"2536",53,6,62,13,8660646,8666666,6020,"20","mask"
"2643",53,3,131,14,8669627,8673902,4275,"0","mask"
"2735",53,6,128,15,8677477,8681354,3877,"20","mask"
"2837",53,3,119,16,8684576,8691197,6621,"0","mask"
"2941",53,6,14,17,8694073,8699420,5347,"20","mask"
"3139",53,6,2,18,8709636,8714597,4961,"20","mask"
"3339",53,4,24,19,8720402,8726187,5785,"20","valid"
"3536",53,1,45,20,8731899,8735854,3955,"0","valid"
"3736",53,5,97,21,8741514,8746097,4583,"20","orth"
"3837",53,4,126,22,8749325,8753940,4615,"20","valid"
"3935",53,3,71,23,8756855,8761326,4471,"0","mask"
"4039",53,5,103,24,8764464,8773817,9353,"20","orth"
"4143",53,1,51,25,8778799,8807205,28406,"0","valid"
"4335",53,1,99,26,8813068,8816742,3674,"0","valid"
"4439",53,5,13,27,8820010,8825455,5445,"20","orth"
"4638",53,1,33,28,8830828,8836861,6033,"0","valid"
"4839",53,1,81,29,8843051,8846482,3431,"0","valid"
"4932",53,4,78,30,8849718,8852842,3124,"20","valid"
"5040",53,2,4,31,8855999,8860862,4863,"0","orth"
"5239",53,5,37,32,8867052,8873118,6066,"20","orth"
"5440",53,2,28,33,8879406,8883896,4490,"0","orth"
"5640",53,3,41,34,8889518,8894910,5392,"0","mask"
"5836",53,1,63,35,8900257,8904826,4569,"0","valid"
"5937",53,6,26,36,8908146,8913421,5275,"20","mask"
"6137",53,6,8,37,8920481,8925795,5314,"20","mask"
"6337",53,1,3,38,8932566,8937527,4961,"0","valid"
"6545",53,6,98,39,8943214,8954463,11249,"20","mask"
"6637",53,2,82,40,8957673,8961680,4007,"0","orth"
"6733",53,5,109,41,8965013,8971177,6164,"20","orth"
"6839",53,3,11,42,8974445,8978811,4366,"0","mask"
"7037",53,2,130,43,8984452,8989793,5341,"0","orth"
"7136",53,5,91,44,8992721,8996545,3824,"20","orth"
"7235",53,5,133,45,8999558,9003912,4354,"20","orth"
"7336",53,2,34,46,9007297,9011787,4490,"0","orth"
"7539",53,4,114,47,9017657,9023520,5863,"20","valid"
"7642",53,5,127,48,9026527,9033063,6536,"20","orth"
"7735",53,4,108,49,9036495,9041423,4928,"20","valid"
"7842",53,4,42,50,9044528,9049411,4883,"20","valid"
"8035",53,3,5,51,9055561,9062679,7118,"0","mask"
"8240",53,2,112,52,9068405,9073563,5158,"0","orth"
"8341",53,4,120,53,9076707,9081700,4993,"20","valid"
"8431",53,2,94,54,9084903,9093669,8766,"0","orth"
"8534",53,2,106,55,9096662,9101656,4994,"0","orth"
"8643",53,5,67,56,9104754,9108193,3439,"20","orth"
"8733",53,1,39,57,9111128,9116951,5823,"0","valid"
"8935",53,4,72,58,9122625,9125605,2980,"20","valid"
"9036",53,5,25,59,9128514,9132031,3517,"20","orth"
"9241",53,1,87,60,9137338,9141835,4497,"0","valid"
"9338",53,2,52,61,9144437,9149208,4771,"0","orth"
"9538",53,3,47,62,9155130,9158745,3615,"0","mask"
"9737",53,5,85,63,9164497,9168595,4098,"20","orth"
"9838",53,2,58,64,9171792,9177060,5268,"0","orth"
"9941",53,4,36,65,9179812,9184041,4229,"20","valid"
"10162",53,4,6,66,9237417,9241816,4399,"20","valid"
"10340",53,6,38,67,9247136,9250771,3635,"20","mask"
"10536",53,1,117,68,9256052,9259967,3915,"0","valid"
"10638",53,6,68,69,9263222,9268510,5288,"20","mask"
"10739",53,2,16,70,9271994,9275936,3942,"0","orth"
"10939",53,3,95,71,9282263,9286832,4569,"0","mask"
"11032",53,6,92,72,9289656,9294826,5170,"20","mask"
"11150",53,4,54,73,9298238,9302199,3961,"20","valid"
"11334",53,2,70,74,9308814,9314978,6164,"0","orth"
"11444",53,1,27,75,9318416,9322985,4569,"0","valid"
"11642",53,4,84,76,9328717,9335574,6857,"20","valid"
"11742",53,3,107,77,9338763,9342966,4203,"0","mask"
"11840",53,5,19,78,9345868,9350013,4145,"20","orth"
"12040",53,2,64,79,9360784,9366798,6014,"0","orth"
"12150",53,3,65,80,9369563,9373681,4118,"0","mask"
"12243",53,2,118,81,9376590,9381681,5091,"0","orth"
"12332",53,6,32,82,9384930,9389695,4765,"20","mask"
"12534",53,4,96,83,9395970,9400643,4673,"20","valid"
"12634",53,5,7,84,9403644,9410533,6889,"20","orth"
"12836",53,3,89,85,9417331,9422115,4784,"0","mask"
"12942",53,3,83,86,9425639,9430175,4536,"0","mask"
"13032",53,1,111,87,9433234,9439116,5882,"0","valid"
"13155",53,1,57,88,9442202,9446490,4288,"0","valid"
"13240",53,4,60,89,9449268,9452660,3392,"20","valid"
"13336",53,3,137,90,9455294,9460066,4772,"0","mask"
"13439",53,2,124,91,9463327,9466641,3314,"0","orth"
"13533",53,5,73,92,9469151,9473942,4791,"20","orth"
"13638",53,6,86,93,9476916,9480662,3746,"20","mask"
"13739",53,6,122,94,9483512,9487368,3856,"20","mask"
"13832",53,2,10,95,9490656,9495552,4896,"0","orth"
"14040",53,4,18,96,9501990,9506219,4229,"20","valid"
"14240",53,6,104,97,9512141,9515919,3778,"20","mask"
"14342",53,1,69,98,9519043,9522148,3105,"0","valid"
"14438",53,5,61,99,9524946,9527953,3007,"20","orth"
"14535",53,5,31,100,9530574,9535999,5425,"20","orth"
"14736",53,5,43,101,9541529,9547398,5869,"20","orth"
"14940",53,4,138,102,9552752,9556621,3869,"20","valid"
"15040",53,3,29,103,9559549,9564282,4733,"0","mask"
"15244",53,6,44,104,9570119,9573276,3157,"20","mask"
"15440",53,6,116,105,9579361,9585283,5922,"20","mask"
"15535",53,5,55,106,9588225,9592597,4372,"20","orth"
"15635",53,1,9,107,9595885,9601709,5824,"0","valid"
"15840",53,4,102,108,9608043,9614985,6942,"20","valid"
"15932",53,2,22,109,9618240,9621508,3268,"0","orth"
"16140",53,3,23,110,9627207,9632456,5249,"0","mask"
"16336",53,1,135,111,9638790,9642875,4085,"0","valid"
"16441",53,6,20,112,9645522,9650484,4962,"20","mask"
"16635",53,5,1,113,9657334,9661216,3882,"20","orth"
"16838",53,3,113,114,9666772,9670786,4014,"0","mask"
"16941",53,5,121,115,9673936,9678995,5059,"20","orth"
"17039",53,3,17,116,9682355,9686309,3954,"0","mask"
"17238",53,6,110,117,9692186,9696153,3967,"20","mask"
"17335",53,1,75,118,9699180,9703860,4680,"0","valid"
"17435",53,6,50,119,9707036,9711096,4060,"20","mask"
"17641",53,3,77,120,9716848,9722979,6131,"0","mask"
"17734",53,4,48,121,9725547,9728103,2556,"20","valid"
"17935",53,1,123,122,9733646,9738150,4504,"0","valid"
"18037",53,3,125,123,9740777,9746274,5497,"0","mask"
"18158",53,2,76,124,9749667,9755112,5445,"0","orth"
"18235",53,2,136,125,9758145,9762615,4470,"0","orth"
"18334",53,3,59,126,9765603,9774590,8987,"0","mask"
"18438",53,6,80,127,9777838,9784126,6288,"20","mask"
"18535",53,1,15,128,9787127,9793258,6131,"0","valid"
"18738",53,1,93,129,9799918,9805311,5393,"0","valid"
"18836",53,2,46,130,9808167,9812443,4276,"0","orth"
"19035",53,3,101,131,9819116,9825273,6157,"0","mask"
"19153",53,3,35,132,9828358,9834868,6510,"0","mask"
"19338",53,4,90,133,9840764,9847203,6439,"20","valid"
"19436",53,3,53,134,9850138,9859164,9026,"0","mask"
"19636",53,4,12,135,9865184,9870635,5451,"20","valid"
"19835",53,5,79,136,9876126,9880578,4452,"20","orth"
"19943",53,1,21,137,9883499,9887637,4138,"0","valid"
"20137",53,2,88,138,9893997,9898219,4222,"0","orth"
"10163",54,2,99,1,11010470,11013163,2693,"0","orth"
"11151",54,4,41,2,11016529,11019484,2955,"20","valid"
"13156",54,6,91,3,11025137,11027595,2458,"20","mask"
"14150",54,6,115,4,11030543,11032765,2222,"20","mask"
"15150",54,3,94,5,11035726,11038289,2563,"0","mask"
"16141",54,1,116,6,11041308,11043629,2321,"0","valid"
"17152",54,4,23,7,11046492,11048891,2399,"20","valid"
"19154",54,2,45,8,11054636,11056675,2039,"0","orth"
"2142",54,5,66,9,11062388,11065016,2628,"20","orth"
"2240",54,6,37,10,11068121,11071069,2948,"20","mask"
"2437",54,2,21,11,11077075,11078932,1857,"0","orth"
"2644",54,3,112,12,11086011,11088253,2242,"0","mask"
"2736",54,2,105,13,11091286,11093312,2026,"0","orth"
"2838",54,2,9,14,11097155,11099594,2439,"0","orth"
"3037",54,2,51,15,11105653,11108195,2542,"0","orth"
"3235",54,6,13,16,11114052,11117020,2968,"20","mask"
"3438",54,6,121,17,11122275,11124778,2503,"20","mask"
"3537",54,2,57,18,11127792,11130340,2548,"0","orth"
"3637",54,3,64,19,11133197,11136374,3177,"0","mask"
"3737",54,4,137,20,11139282,11142616,3334,"20","valid"
"3838",54,2,69,21,11145662,11147766,2104,"0","orth"
"3936",54,2,87,22,11150924,11153407,2483,"0","orth"
"4040",54,6,61,23,11156499,11159957,3458,"20","mask"
"4144",54,6,73,24,11163349,11166003,2654,"20","mask"
"4238",54,6,97,25,11168918,11171415,2497,"20","mask"
"4336",54,6,43,26,11174481,11176500,2019,"20","mask"
"4533",54,3,130,27,11182364,11184723,2359,"0","mask"
"4639",54,5,30,28,11187671,11189710,2039,"20","orth"
"4840",54,4,119,29,11194927,11200221,5294,"20","valid"
"4933",54,2,39,30,11203692,11206071,2379,"0","orth"
"5138",54,3,4,31,11212431,11214490,2059,"0","mask"
"5336",54,5,42,32,11220373,11222680,2307,"20","orth"
"5538",54,1,68,33,11228680,11230622,1942,"0","valid"
"5641",54,2,33,34,11234322,11236590,2268,"0","orth"
"5837",54,1,32,35,11242656,11245054,2398,"0","valid"
"6040",54,2,117,36,11250970,11252630,1660,"0","orth"
"6138",54,6,85,37,11256199,11258277,2078,"20","mask"
"6239",54,1,86,38,11261153,11262643,1490,"0","valid"
"6338",54,5,48,39,11265591,11267670,2079,"20","orth"
"6546",54,4,101,40,11274461,11276520,2059,"20","valid"
"6638",54,6,127,41,11280011,11282429,2418,"20","mask"
"6734",54,4,17,42,11285743,11288286,2543,"20","valid"
"6938",54,1,20,43,11293940,11295770,1830,"0","valid"
"7137",54,6,103,44,11301581,11304646,3065,"20","mask"
"7236",54,1,128,45,11307634,11309810,2176,"0","valid"
"7337",54,4,83,46,11312980,11315333,2353,"20","valid"
"7442",54,5,78,47,11318307,11320033,1726,"20","orth"
"7540",54,3,58,48,11323125,11325046,1921,"0","mask"
"7643",54,1,38,49,11328020,11329890,1870,"0","valid"
"7843",54,3,118,50,11335818,11337733,1915,"0","mask"
"7940",54,5,84,51,11340910,11343217,2307,"20","orth"
"8036",54,1,122,52,11346081,11347773,1692,"0","valid"
"8139",54,4,35,53,11350898,11352662,1764,"20","valid"
"8342",54,1,92,54,11358846,11361186,2340,"0","valid"
"8432",54,2,27,55,11364336,11366696,2360,"0","orth"
"8644",54,1,8,56,11372703,11374919,2216,"0","valid"
"8841",54,3,100,57,11380540,11382625,2085,"0","mask"
"8936",54,5,36,58,11385573,11388136,2563,"20","orth"
"9138",54,1,2,59,11393770,11395593,1823,"0","valid"
"9339",54,4,53,60,11401339,11403254,1915,"20","valid"
"9539",54,3,16,61,11408804,11411575,2771,"0","mask"
"9738",54,6,133,62,11417288,11419968,2680,"20","mask"
"9839",54,3,46,63,11422870,11425733,2863,"0","mask"
"10041",54,5,72,64,11432015,11434472,2457,"20","orth"
"10164",54,2,15,65,11437309,11438858,1549,"0","orth"
"10341",54,3,88,66,11470912,11473017,2105,"0","mask"
"10434",54,3,40,67,11476416,11479442,3026,"0","mask"
"10639",54,4,59,68,11486083,11488587,2504,"20","valid"
"10740",54,3,22,69,11491927,11495090,3163,"0","mask"
"10940",54,6,7,70,11500601,11502568,1967,"20","mask"
"11152",54,3,10,71,11508993,11510935,1942,"0","mask"
"11335",54,4,11,72,11516915,11518693,1778,"20","valid"
"11532",54,5,6,73,11524387,11527374,2987,"20","orth"
"11743",54,3,70,74,11532858,11536165,3307,"0","mask"
"11841",54,4,131,75,11539146,11541348,2202,"20","valid"
"11934",54,3,34,76,11544656,11546617,1961,"0","mask"
"12151",54,1,74,77,11552467,11554225,1758,"0","valid"
"12244",54,2,3,78,11557376,11559827,2451,"0","orth"
"12439",54,2,123,79,11565494,11568102,2608,"0","orth"
"12535",54,4,47,80,11570991,11573037,2046,"20","valid"
"12737",54,3,28,81,11578338,11581273,2935,"0","mask"
"12943",54,1,110,82,11587208,11589299,2091,"0","valid"
"13033",54,3,106,83,11592313,11593757,1444,"0","mask"
"13157",54,2,81,84,11596986,11598725,1739,"0","orth"
"13241",54,5,90,85,11601647,11604366,2719,"20","orth"
"13337",54,2,93,86,11607608,11610000,2392,"0","orth"
"13440",54,1,98,87,11612824,11615268,2444,"0","valid"
"13534",54,4,95,88,11618674,11620994,2320,"20","valid"
"13639",54,5,132,89,11623968,11626262,2294,"20","orth"
"13740",54,4,113,90,11629021,11631603,2582,"20","valid"
"13833",54,4,29,91,11634303,11636492,2189,"20","valid"
"14041",54,5,18,92,11642153,11644584,2431,"20","orth"
"14241",54,1,80,93,11650323,11652735,2412,"0","valid"
"14343",54,6,31,94,11655696,11658657,2961,"20","mask"
"14536",54,5,114,95,11664187,11666559,2372,"20","orth"
"14640",54,6,55,96,11669645,11672004,2359,"20","mask"
"14737",54,5,96,97,11675017,11677142,2125,"20","orth"
"14835",54,5,102,98,11679907,11681815,1908,"20","orth"
"14941",54,6,1,99,11684502,11686652,2150,"20","mask"
"15151",54,5,24,100,11692568,11694391,1823,"20","orth"
"15332",54,5,120,101,11700601,11703143,2542,"20","orth"
"15441",54,1,134,102,11706484,11708418,1934,"0","valid"
"15536",54,4,89,103,11711471,11714935,3464,"20","valid"
"15636",54,3,136,104,11718158,11720386,2228,"0","mask"
"15741",54,3,124,105,11723380,11725387,2007,"0","mask"
"15841",54,4,107,106,11728518,11730524,2006,"20","valid"
"15933",54,5,54,107,11733499,11735041,1542,"20","orth"
"16142",54,1,26,108,11744074,11746035,1961,"0","valid"
"16337",54,5,138,109,11752023,11754238,2215,"20","orth"
"16442",54,1,56,110,11757448,11759709,2261,"0","valid"
"16538",54,6,49,111,11762553,11764625,2072,"20","mask"
"16742",54,1,50,112,11770083,11771932,1849,"0","valid"
"16942",54,2,135,113,11777436,11780208,2772,"0","orth"
"17040",54,3,82,114,11784077,11785946,1869,"0","mask"
"17153",54,1,44,115,11788894,11790581,1687,"0","valid"
"17336",54,6,67,116,11795921,11798189,2268,"20","mask"
"17436",54,6,109,117,11801222,11804889,3667,"20","mask"
"17535",54,6,79,118,11808321,11810929,2608,"20","mask"
"17642",54,1,104,119,11814046,11816484,2438,"0","valid"
"17735",54,1,62,120,11819341,11821308,1967,"0","valid"
"17842",54,2,63,121,11824158,11826093,1935,"0","orth"
"17936",54,4,125,122,11829557,11831963,2406,"20","valid"
"18038",54,6,19,123,11834956,11836917,1961,"20","mask"
"18236",54,4,71,124,11842656,11845029,2373,"20","valid"
"18335",54,2,129,125,11847977,11849715,1738,"0","orth"
"18439",54,5,12,126,11852703,11854716,2013,"20","orth"
"18636",54,5,108,127,11860743,11862801,2058,"20","orth"
"18739",54,5,60,128,11865854,11868337,2483,"20","orth"
"18837",54,4,77,129,11871560,11873554,1994,"20","valid"
"18938",54,2,75,130,11876567,11878547,1980,"0","orth"
"19036",54,4,65,131,11881424,11883384,1960,"20","valid"
"19155",54,4,5,132,11886365,11889307,2942,"20","valid"
"19339",54,3,76,133,11895457,11897634,2177,"0","mask"
"19437",54,5,126,134,11900771,11903209,2438,"20","orth"
"19534",54,2,111,135,11906896,11908530,1634,"0","orth"
"19637",54,6,25,136,11911229,11913321,2092,"20","mask"
"19836",54,3,52,137,11918831,11920714,1883,"0","mask"
"20037",54,1,14,138,11927192,11929433,2241,"0","valid"
"10165",55,3,123,1,15539400,15542171,2771,"0","mask"
"11153",55,5,137,2,15545303,15547518,2215,"20","orth"
"12152",55,6,48,3,15550924,15552682,1758,"20","mask"
"14151",55,5,125,4,15559081,15563134,4053,"20","orth"
"15152",55,1,115,5,15566631,15568317,1686,"0","valid"
"16143",55,2,86,6,15572638,15574363,1725,"0","orth"
"17154",55,5,59,7,15577481,15579370,1889,"20","orth"
"18159",55,6,126,8,15582325,15584932,2607,"20","mask"
"19156",55,1,55,9,15587809,15589508,1699,"0","valid"
"2047",55,6,114,10,15592600,15595371,2771,"20","mask"
"2143",55,4,88,11,15598594,15601116,2522,"20","valid"
"2241",55,3,45,12,15603934,15606065,2131,"0","mask"
"2438",55,6,66,13,15612183,15614961,2778,"20","mask"
"2537",55,5,113,14,15618817,15621634,2817,"20","orth"
"2645",55,1,103,15,15624785,15627131,2346,"0","valid"
"2737",55,3,27,16,15630001,15633746,3745,"0","mask"
"2942",55,3,99,17,15639989,15641838,1849,"0","mask"
"3038",55,2,68,18,15645329,15647192,1863,"0","orth"
"3140",55,1,13,19,15650584,15652944,2360,"0","valid"
"3340",55,3,87,20,15659003,15662127,3124,"0","mask"
"3439",55,4,112,21,15666004,15668069,2065,"20","valid"
"3538",55,1,61,22,15670997,15672932,1935,"0","valid"
"3638",55,2,80,23,15676743,15678717,1974,"0","orth"
"3738",55,2,56,24,15681540,15684155,2615,"0","orth"
"3839",55,4,106,25,15687554,15689934,2380,"20","valid"
"3937",55,4,34,26,15692848,15694907,2059,"20","valid"
"4145",55,3,135,27,15701476,15703156,1680,"0","mask"
"4239",55,4,58,28,15705934,15708294,2360,"20","valid"
"4337",55,1,25,29,15711091,15712882,1791,"0","valid"
"4534",55,2,50,30,15718974,15720595,1621,"0","orth"
"4735",55,6,138,31,15726602,15728890,2288,"20","mask"
"4841",55,1,79,32,15732125,15733733,1608,"0","valid"
"4934",55,6,30,33,15737224,15739093,1869,"20","mask"
"5139",55,5,119,34,15744754,15747506,2752,"20","orth"
"5240",55,5,65,35,15750695,15752748,2053,"20","orth"
"5337",55,5,77,36,15756722,15759434,2712,"20","orth"
"5441",55,4,76,37,15763520,15766807,3287,"20","valid"
"5539",55,6,78,38,15769729,15772069,2340,"20","mask"
"5642",55,3,63,39,15775167,15776998,1831,"0","mask"
"5735",55,5,47,40,15780018,15782272,2254,"20","orth"
"5938",55,2,98,41,15787456,15789338,1882,"0","orth"
"6041",55,4,52,42,15792214,15794424,2210,"20","valid"
"6240",55,4,22,43,15801235,15803849,2614,"20","valid"
"6437",55,3,21,44,15814288,15817236,2948,"0","mask"
"6639",55,1,43,45,15822295,15824105,1810,"0","valid"
"6840",55,6,72,46,15830936,15832910,1974,"20","mask"
"6939",55,5,89,47,15836034,15838793,2759,"20","orth"
"7038",55,1,91,48,15841937,15843767,1830,"0","valid"
"7138",55,2,62,49,15846656,15848492,1836,"0","orth"
"7237",55,1,109,50,15851578,15854048,2470,"0","valid"
"7338",55,4,40,51,15857036,15860311,3275,"20","valid"
"7541",55,3,93,52,15866984,15868906,1922,"0","mask"
"7644",55,5,107,53,15872063,15874873,2810,"20","orth"
"7736",55,2,110,54,15877554,15879638,2084,"0","orth"
"7844",55,1,31,55,15882338,15885266,2928,"0","valid"
"8037",55,3,9,56,15893698,15897927,4229,"0","mask"
"8241",55,6,42,57,15907320,15910529,3209,"20","mask"
"8433",55,1,67,58,15917340,15920112,2772,"0","valid"
"8535",55,5,5,59,15924929,15927406,2477,"20","orth"
"8734",55,3,117,60,15933420,15934975,1555,"0","mask"
"8842",55,5,35,61,15937878,15940113,2235,"20","orth"
"9037",55,4,70,62,15947094,15950114,3020,"20","valid"
"9139",55,2,134,63,15953206,15955493,2287,"0","orth"
"9242",55,4,28,64,15958801,15962552,3751,"20","valid"
"9432",55,5,131,65,15968174,15970318,2144,"20","orth"
"9540",55,4,46,66,16008569,16011020,2451,"20","valid"
"9739",55,6,60,67,16017210,16019589,2379,"20","mask"
"9840",55,1,85,68,16022491,16025204,2713,"0","valid"
"9942",55,2,14,69,16028054,16030590,2536,"0","orth"
"10166",55,2,92,70,16037427,16039858,2431,"0","orth"
"10235",55,1,133,71,16043159,16045310,2151,"0","valid"
"10342",55,3,57,72,16048048,16050859,2811,"0","mask"
"10435",55,2,104,73,16053539,16055421,1882,"0","orth"
"10537",55,6,84,74,16058363,16061010,2647,"20","mask"
"10640",55,1,127,75,16063651,16065461,1810,"0","valid"
"10741",55,4,64,76,16068625,16071115,2490,"20","valid"
"10836",55,1,73,77,16073795,16076809,3014,"0","valid"
"10941",55,2,122,78,16079606,16081109,1503,"0","orth"
"11033",55,3,69,79,16083842,16085613,1771,"0","mask"
"11154",55,6,90,80,16089646,16091979,2333,"20","mask"
"11237",55,2,38,81,16095431,16097568,2137,"0","orth"
"11445",55,4,136,82,16102797,16105333,2536,"20","valid"
"11533",55,3,39,83,16108013,16109837,1824,"0","mask"
"11744",55,3,129,84,16116478,16118981,2503,"0","mask"
"11842",55,1,37,85,16121962,16125080,3118,"0","valid"
"12041",55,2,116,86,16132525,16134610,2085,"0","orth"
"12153",55,4,118,87,16137656,16139793,2137,"20","valid"
"12245",55,2,2,88,16142663,16144362,1699,"0","orth"
"12440",55,2,20,89,16149683,16151206,1523,"0","orth"
"12635",55,6,6,90,16156638,16159311,2673,"20","mask"
"12837",55,4,100,91,16164762,16167181,2419,"20","valid"
"12944",55,4,130,92,16170678,16172841,2163,"20","valid"
"13034",55,5,29,93,16175521,16178462,2941,"20","orth"
"13242",55,6,36,94,16184064,16186417,2353,"20","mask"
"13441",55,3,15,95,16191685,16193078,1393,"0","mask"
"13640",55,4,124,96,16198882,16200895,2013,"20","valid"
"13741",55,4,16,97,16203863,16205830,1967,"20","valid"
"13937",55,1,121,98,16211092,16212700,1608,"0","valid"
"14042",55,4,94,99,16215583,16218269,2686,"20","valid"
"14152",55,3,33,100,16222119,16224943,2824,"0","mask"
"14344",55,2,32,101,16230780,16232610,1830,"0","orth"
"14537",55,2,128,102,16239061,16241878,2817,"0","orth"
"14641",55,6,54,103,16246029,16247755,1726,"20","mask"
"14836",55,1,1,104,16254794,16257187,2393,"0","valid"
"15041",55,1,97,105,16262965,16265089,2124,"0","valid"
"15153",55,4,4,106,16267946,16269952,2006,"20","valid"
"15333",55,5,53,107,16274998,16277135,2137,"20","orth"
"15537",55,6,102,108,16282450,16285502,3052,"20","mask"
"15637",55,4,82,109,16289365,16291104,1739,"20","valid"
"15742",55,1,49,110,16293745,16295771,2026,"0","valid"
"15934",55,3,3,111,16301131,16303209,2078,"0","mask"
"16144",55,1,19,112,16309157,16311105,1948,"0","valid"
"16338",55,1,7,113,16320145,16322452,2307,"0","valid"
"16539",55,2,74,114,16329740,16331930,2190,"0","orth"
"16636",55,5,23,115,16334656,16337251,2595,"20","orth"
"16839",55,2,44,116,16342781,16344473,1692,"0","orth"
"17041",55,3,75,117,16350533,16353624,3091,"0","mask"
"17155",55,3,111,118,16356690,16358625,1935,"0","mask"
"17239",55,5,11,119,16361546,16363409,1863,"20","orth"
"17437",55,6,12,120,16369874,16372547,2673,"20","mask"
"17643",55,6,120,121,16377985,16381822,3837,"20","mask"
"17736",55,5,17,122,16384999,16387195,2196,"20","orth"
"17937",55,5,83,123,16393300,16395908,2608,"20","orth"
"18039",55,3,51,124,16399039,16400843,1804,"0","mask"
"18237",55,5,101,125,16406249,16408177,1928,"20","orth"
"18336",55,6,24,126,16411491,16413988,2497,"20","mask"
"18536",55,6,108,127,16419936,16422524,2588,"20","mask"
"18637",55,3,105,128,16425204,16426636,1432,"0","mask"
"18740",55,6,18,129,16429244,16431662,2418,"20","mask"
"18939",55,2,26,130,16438121,16439872,1751,"0","orth"
"19157",55,2,8,131,16445872,16448153,2281,"0","orth"
"19340",55,5,41,132,16454729,16456860,2131,"20","orth"
"19535",55,6,132,133,16461533,16463867,2334,"20","mask"
"19638",55,5,95,134,16467880,16469933,2053,"20","orth"
"19739",55,5,71,135,16472900,16474587,1687,"20","orth"
"19837",55,6,96,136,16477489,16479502,2013,"20","mask"
"19944",55,4,10,137,16482273,16484090,1817,"20","valid"
"20138",55,3,81,138,16489307,16491562,2255,"0","mask"
"10167",56,4,63,1,5471402,5476906,5504,"20","valid"
"11155",56,5,124,2,5480605,5488932,8327,"20","orth"
"12154",56,1,90,3,5494194,5499083,4889,"0","valid"
"13158",56,5,16,4,5503169,5508195,5026,"20","orth"
"15154",56,5,136,5,5516457,5521732,5275,"20","orth"
"16145",56,1,54,6,5524857,5527942,3085,"0","valid"
"18160",56,6,41,7,5537524,5542040,4516,"20","mask"
"2048",56,1,72,8,5548995,5553479,4484,"0","valid"
"2144",56,6,83,9,5557218,5564297,7079,"20","mask"
"2242",56,1,42,10,5568069,5574611,6542,"0","valid"
"2439",56,3,110,11,5583396,5587566,4170,"0","mask"
"2538",56,6,71,12,5591011,5595874,4863,"20","mask"
"2646",56,3,26,13,5599404,5604156,4752,"0","mask"
"2839",56,4,87,14,5612673,5617614,4941,"20","valid"
"2943",56,4,135,15,5621275,5629040,7765,"20","valid"
"3039",56,5,64,16,5631955,5637792,5837,"20","orth"
"3141",56,6,137,17,5641322,5645649,4327,"20","mask"
"3236",56,2,127,18,5649781,5654264,4483,"0","orth"
"3341",56,1,126,19,5657597,5663918,6321,"0","valid"
"3440",56,2,37,20,5667147,5671578,4431,"0","orth"
"3639",56,4,105,21,5679089,5682625,3536,"20","valid"
"3739",56,5,40,22,5686246,5693547,7301,"20","orth"
"3938",56,1,18,23,5699973,5704718,4745,"0","valid"
"4146",56,2,61,24,5714150,5718313,4163,"0","orth"
"4240",56,3,50,25,5721706,5726451,4745,"0","mask"
"4440",56,5,118,26,5733184,5738334,5150,"20","orth"
"4535",56,2,19,27,5742394,5746904,4510,"0","orth"
"4736",56,1,96,28,5755179,5761578,6399,"0","valid"
"4842",56,1,102,29,5764924,5769676,4752,"0","valid"
"4935",56,3,14,30,5772978,5778161,5183,"0","mask"
"5140",56,4,75,31,5788697,5793684,4987,"20","valid"
"5241",56,6,65,32,5797201,5801770,4569,"20","mask"
"5338",56,1,60,33,5805509,5812078,6569,"0","valid"
"5442",56,2,121,34,5816542,5822353,5811,"0","orth"
"5540",56,3,116,35,5825968,5829916,3948,"0","mask"
"5643",56,2,13,36,5838302,5842524,4222,"0","orth"
"5838",56,4,99,37,5848976,5853767,4791,"20","valid"
"5939",56,6,95,38,5857741,5863800,6059,"20","mask"
"6042",56,2,73,39,5871363,5877285,5922,"0","orth"
"6139",56,3,8,40,5880749,5884769,4020,"0","mask"
"6339",56,4,9,41,5893711,5899227,5516,"20","valid"
"6547",56,6,113,42,5906947,5911568,4621,"20","mask"
"6640",56,4,69,43,5914706,5918889,4183,"20","valid"
"6735",56,1,78,44,5922183,5925445,3262,"0","valid"
"6841",56,5,100,45,5928824,5932765,3941,"20","orth"
"6940",56,3,86,46,5935635,5939916,4281,"0","mask"
"7039",56,4,111,47,5945335,5949629,4294,"20","valid"
"7139",56,5,28,48,5952996,5958192,5196,"20","orth"
"7339",56,2,85,49,5965559,5970265,4706,"0","orth"
"7443",56,4,123,50,5973834,5980272,6438,"20","valid"
"7542",56,4,117,51,5983952,5987109,3157,"20","valid"
"7645",56,2,97,52,5990443,5993920,3477,"0","orth"
"7737",56,3,38,53,6001685,6005607,3922,"0","mask"
"7941",56,4,15,54,6013196,6016823,3627,"20","valid"
"8140",56,5,112,55,6023785,6027981,4196,"20","orth"
"8242",56,3,32,56,6031256,6035877,4621,"0","mask"
"8434",56,5,88,57,6043531,6047747,4216,"20","orth"
"8536",56,2,115,58,6051074,6055917,4843,"0","orth"
"8645",56,6,59,59,6059035,6063251,4216,"20","mask"
"8735",56,6,125,60,6066356,6071043,4687,"20","mask"
"8843",56,3,44,61,6074226,6077050,2824,"0","mask"
"9038",56,3,128,62,6085553,6091828,6275,"0","mask"
"9140",56,4,45,63,6095861,6099515,3654,"20","valid"
"9340",56,2,91,64,6106045,6109947,3902,"0","orth"
"9433",56,4,3,65,6113400,6118150,4750,"20","valid"
"9633",56,2,103,66,6157800,6161526,3726,"0","orth"
"9740",56,5,22,67,6164807,6169395,4588,"20","orth"
"9943",56,3,92,68,6175468,6182664,7196,"0","mask"
"10042",56,3,56,69,6185881,6191286,5405,"0","mask"
"10168",56,6,23,70,6194397,6197489,3092,"20","mask"
"10343",56,6,89,71,6203764,6210548,6784,"20","mask"
"10436",56,2,109,72,6214679,6219706,5027,"0","orth"
"10538",56,5,4,73,6223216,6228380,5164,"20","orth"
"10742",56,1,12,74,6234746,6239328,4582,"0","valid"
"10942",56,4,129,75,6246838,6251924,5086,"20","valid"
"11034",56,5,10,76,6255375,6260225,4850,"20","orth"
"11238",56,2,67,77,6268304,6271422,3118,"0","orth"
"11336",56,2,79,78,6274932,6279697,4765,"0","orth"
"11446",56,5,58,79,6283181,6288508,5327,"20","orth"
"11534",56,6,29,80,6291475,6296541,5066,"20","mask"
"11745",56,2,43,81,6303195,6308052,4857,"0","orth"
"11935",56,3,134,82,6314124,6317608,3484,"0","mask"
"12042",56,1,108,83,6320817,6325236,4419,"0","valid"
"12155",56,5,70,84,6328439,6334138,5699,"20","orth"
"12246",56,4,39,85,6337766,6342511,4745,"20","valid"
"12441",56,1,120,86,6350401,6355401,5000,"0","valid"
"12536",56,6,77,87,6358421,6362447,4026,"20","mask"
"12636",56,4,93,88,6365997,6369324,3327,"20","valid"
"12738",56,2,7,89,6372324,6376984,4660,"0","orth"
"12945",56,6,47,90,6387822,6391887,4065,"20","mask"
"13159",56,2,31,91,6397959,6404019,6060,"0","orth"
"13338",56,1,30,92,6410712,6415366,4654,"0","valid"
"13535",56,2,133,93,6425772,6429615,3843,"0","orth"
"13641",56,6,5,94,6432942,6437263,4321,"20","mask"
"13834",56,5,106,95,6445309,6448943,3634,"20","orth"
"13938",56,1,24,96,6452323,6458362,6039,"0","valid"
"14153",56,6,35,97,6465506,6471292,5786,"20","mask"
"14345",56,6,53,98,6478403,6483272,4869,"20","mask"
"14538",56,6,131,99,6489299,6493567,4268,"20","mask"
"14642",56,1,66,100,6496822,6501267,4445,"0","valid"
"14738",56,3,104,101,6504378,6510954,6576,"0","mask"
"14837",56,6,17,102,6516667,6521687,5020,"20","mask"
"15042",56,1,132,103,6529877,6534478,4601,"0","valid"
"15155",56,5,94,104,6538616,6543041,4425,"20","orth"
"15245",56,3,20,105,6546924,6551682,4758,"0","mask"
"15442",56,5,46,106,6559212,6564630,5418,"20","orth"
"15638",56,5,130,107,6572330,6578997,6667,"20","orth"
"15743",56,1,114,108,6582325,6587625,5300,"0","valid"
"15842",56,2,49,109,6590953,6596450,5497,"0","orth"
"16044",56,3,80,110,6603084,6608784,5700,"0","mask"
"16146",56,6,11,111,6612523,6616797,4274,"20","mask"
"16339",56,3,122,112,6623171,6627255,4084,"0","mask"
"16443",56,4,27,113,6630289,6634406,4117,"20","valid"
"16637",56,1,48,114,6642093,6644760,2667,"0","valid"
"16840",56,3,68,115,6654493,6659565,5072,"0","mask"
"16943",56,3,2,116,6663467,6670115,6648,"0","mask"
"17156",56,5,34,117,6678625,6683089,4464,"20","orth"
"17337",56,3,62,118,6690096,6694351,4255,"0","mask"
"17438",56,6,101,119,6697548,6702358,4810,"20","mask"
"17536",56,3,98,120,6705856,6710340,4484,"0","mask"
"17644",56,4,51,121,6713784,6719615,5831,"20","valid"
"17843",56,5,82,122,6725753,6729694,3941,"20","orth"
"17938",56,5,52,123,6733040,6736746,3706,"20","orth"
"18161",56,4,81,124,6743839,6748629,4790,"20","valid"
"18238",56,3,74,125,6752277,6755872,3595,"0","mask"
"18337",56,6,119,126,6759715,6765853,6138,"20","mask"
"18440",56,1,6,127,6769494,6773468,3974,"0","valid"
"18638",56,4,33,128,6781246,6785828,4582,"20","valid"
"18838",56,2,1,129,6791927,6796116,4189,"0","orth"
"19037",56,5,76,130,6802614,6806620,4006,"20","orth"
"19158",56,2,25,131,6813922,6818268,4346,"0","orth"
"19341",56,1,84,132,6825707,6829792,4085,"0","valid"
"19438",56,6,107,133,6833027,6838897,5870,"20","mask"
"19536",56,4,21,134,6841786,6847427,5641,"20","valid"
"19740",56,1,138,135,6867742,6872801,5059,"0","valid"
"19838",56,2,55,136,6876605,6879501,2896,"0","orth"
"19945",56,4,57,137,6882978,6887782,4804,"20","valid"
"20038",56,1,36,138,6891711,6896397,4686,"0","valid"
"10169",57,6,28,1,20554904,20562205,7301,"20","mask"
"12156",57,5,123,2,20569695,20577676,7981,"20","orth"
"13160",57,2,60,3,20580866,20584383,3517,"0","orth"
"14154",57,1,77,4,20587422,20591076,3654,"0","valid"
"15156",57,1,83,5,20595390,20600063,4673,"0","valid"
"16147",57,4,116,6,20603267,20608365,5098,"20","valid"
"17157",57,2,102,7,20611319,20614385,3066,"0","orth"
"18162",57,1,17,8,20617476,20622941,5465,"0","valid"
"2049",57,3,43,9,20631791,20635183,3392,"0","mask"
"2243",57,6,76,10,20645008,20650799,5791,"20","mask"
"2338",57,2,78,11,20654041,20657002,2961,"0","orth"
"2440",57,6,10,12,20660068,20663767,3699,"20","mask"
"2647",57,3,13,13,20671120,20676049,4929,"0","mask"
"2840",57,4,122,14,20682337,20685187,2850,"20","valid"
"2944",57,4,44,15,20691867,20697456,5589,"20","valid"
"3142",57,6,64,16,20704541,20707934,3393,"20","mask"
"3237",57,1,53,17,20710803,20714104,3301,"0","valid"
"3441",57,3,109,18,20721287,20726098,4811,"0","mask"
"3539",57,3,85,19,20729562,20734857,5295,"0","mask"
"3640",57,2,36,20,20737837,20741197,3360,"0","orth"
"3840",57,3,127,21,20747708,20750655,2947,"0","mask"
"3939",57,2,42,22,20754760,20758250,3490,"0","orth"
"4147",57,2,66,23,20764977,20767349,2372,"0","orth"
"4241",57,5,39,24,20770271,20774350,4079,"20","orth"
"4441",57,1,95,25,20780834,20784056,3222,"0","valid"
"4536",57,5,33,26,20787128,20791652,4524,"20","orth"
"4737",57,5,3,27,20798704,20803397,4693,"20","orth"
"4936",57,4,62,28,20809012,20815640,6628,"20","valid"
"5041",57,5,87,29,20819294,20824164,4870,"20","orth"
"5141",57,6,136,30,20827477,20833994,6517,"20","mask"
"5242",57,6,124,31,20837380,20843766,6386,"20","mask"
"5339",57,5,9,32,20847263,20853551,6288,"20","orth"
"5541",57,1,11,33,20864035,20867755,3720,"0","valid"
"5736",57,6,22,34,20879624,20883821,4197,"20","mask"
"5940",57,1,89,35,20890972,20896077,5105,"0","valid"
"6043",57,6,112,36,20899449,20910117,10668,"20","mask"
"6140",57,4,104,37,20913418,20918032,4614,"20","valid"
"6241",57,1,107,38,20921360,20924033,2673,"0","valid"
"6340",57,6,106,39,20927138,20931255,4117,"20","mask"
"6438",57,4,8,40,20935125,20938269,3144,"20","valid"
"6641",57,5,75,41,20945668,20950701,5033,"20","orth"
"6736",57,5,45,42,20954231,20957741,3510,"20","orth"
"6941",57,3,55,43,20963480,20965591,2111,"0","mask"
"7040",57,3,133,44,20971866,20974781,2915,"0","mask"
"7140",57,5,99,45,20977866,20981533,3667,"20","orth"
"7238",57,2,48,46,20984880,20987573,2693,"0","orth"
"7444",57,3,31,47,20995090,20999293,4203,"0","mask"
"7646",57,1,113,48,21005548,21009045,3497,"0","valid"
"7738",57,2,132,49,21012169,21016137,3968,"0","orth"
"7845",57,2,54,50,21019915,21022118,2203,"0","orth"
"8038",57,3,97,51,21033302,21035465,2163,"0","mask"
"8141",57,2,126,52,21038642,21042518,3876,"0","orth"
"8243",57,4,38,53,21045505,21049061,3556,"20","valid"
"8435",57,3,25,54,21054708,21057441,2733,"0","mask"
"8646",57,1,47,55,21063362,21065343,1981,"0","valid"
"8844",57,2,12,56,21071736,21074271,2535,"0","orth"
"9039",57,3,121,57,21079952,21082148,2196,"0","mask"
"9141",57,4,32,58,21085749,21092220,6471,"20","valid"
"9341",57,2,30,59,21099280,21101829,2549,"0","orth"
"9541",57,4,20,60,21107359,21110771,3412,"20","valid"
"9741",57,2,114,61,21121844,21126092,4248,"0","orth"
"9841",57,2,96,62,21129589,21132387,2798,"0","orth"
"9944",57,4,68,63,21135812,21140113,4301,"20","valid"
"10043",57,4,86,64,21143041,21146388,3347,"20","valid"
"10170",57,6,46,65,21149642,21152963,3321,"20","mask"
"10344",57,1,29,66,21206836,21211509,4673,"0","valid"
"10539",57,1,131,67,21219772,21222013,2241,"0","valid"
"10641",57,1,119,68,21225543,21231347,5804,"0","valid"
"10743",57,6,4,69,21234923,21238864,3941,"20","mask"
"10943",57,2,120,70,21244832,21247780,2948,"0","orth"
"11035",57,5,93,71,21251479,21255729,4250,"20","orth"
"11156",57,5,129,72,21258761,21263265,4504,"20","orth"
"11239",57,4,110,73,21266846,21270193,3347,"20","valid"
"11337",57,4,134,74,21273840,21276972,3132,"20","valid"
"11447",57,4,74,75,21281129,21283867,2738,"20","valid"
"11535",57,2,138,76,21287319,21289547,2228,"0","orth"
"11643",57,1,41,77,21292620,21295097,2477,"0","valid"
"11843",57,5,105,78,21302222,21305222,3000,"20","orth"
"11936",57,3,73,79,21308392,21311667,3275,"0","mask"
"12043",57,5,15,80,21315131,21318497,3366,"20","orth"
"12247",57,3,103,81,21329733,21333838,4105,"0","mask"
"12333",57,1,71,82,21337792,21340459,2667,"0","valid"
"12442",57,5,51,83,21343714,21348218,4504,"20","orth"
"12637",57,3,61,84,21355755,21359369,3614,"0","mask"
"12739",57,4,80,85,21362278,21365500,3222,"20","valid"
"12838",57,4,2,86,21368390,21371416,3026,"20","valid"
"13035",57,4,128,87,21377795,21383384,5589,"20","valid"
"13161",57,4,56,88,21386489,21391868,5379,"20","valid"
"13243",57,5,57,89,21395051,21398339,3288,"20","orth"
"13339",57,6,16,90,21401633,21404176,2543,"20","mask"
"13536",57,4,92,91,21410850,21415902,5052,"20","valid"
"13642",57,6,118,92,21420876,21423890,3014,"20","mask"
"13742",57,3,67,93,21426910,21429387,2477,"0","mask"
"13835",57,3,115,94,21432812,21435100,2288,"0","mask"
"13939",57,2,18,95,21438270,21441244,2974,"0","orth"
"14155",57,6,88,96,21448414,21452572,4158,"20","mask"
"14242",57,4,98,97,21455722,21461369,5647,"20","valid"
"14346",57,6,58,98,21465285,21468383,3098,"20","mask"
"14439",57,4,50,99,21476710,21480521,3811,"20","valid"
"14643",57,1,35,100,21488417,21490352,1935,"0","valid"
"14838",57,3,49,101,21497699,21499940,2241,"0","mask"
"15043",57,4,14,102,21505679,21509902,4223,"20","valid"
"15246",57,1,5,103,21517550,21521256,3706,"0","valid"
"15443",57,5,111,104,21527707,21530675,2968,"20","orth"
"15538",57,2,24,105,21534041,21536505,2464,"0","orth"
"15744",57,3,1,106,21544538,21548656,4118,"0","mask"
"15935",57,2,90,107,21556166,21559383,3217,"0","orth"
"16045",57,2,6,108,21562755,21566102,3347,"0","orth"
"16240",57,5,63,109,21591829,21595542,3713,"20","orth"
"16340",57,6,130,110,21598954,21602575,3621,"20","mask"
"16444",57,5,21,111,21605869,21609137,3268,"20","orth"
"16638",57,2,72,112,21615242,21619667,4425,"0","orth"
"16743",57,3,79,113,21623361,21625968,2607,"0","mask"
"16841",57,6,70,114,21629459,21634551,5092,"20","mask"
"16944",57,1,23,115,21637407,21640394,2987,"0","valid"
"17158",57,4,26,116,21646708,21650447,3739,"20","valid"
"17338",57,6,94,117,21658317,21662245,3928,"20","mask"
"17439",57,2,84,118,21665664,21672344,6680,"0","orth"
"17537",57,5,27,119,21675554,21678508,2954,"20","orth"
"17737",57,5,81,120,21685018,21689757,4739,"20","orth"
"17844",57,2,108,121,21693450,21697732,4282,"0","orth"
"17939",57,1,101,122,21700921,21704896,3975,"0","valid"
"18040",57,5,117,123,21708432,21711471,3039,"20","orth"
"18163",57,1,137,124,21714510,21716975,2465,"0","valid"
"18239",57,3,37,125,21719916,21724197,4281,"0","mask"
"18441",57,6,100,126,21731054,21735551,4497,"20","mask"
"18537",57,5,69,127,21738983,21743173,4190,"20","orth"
"18639",57,5,135,128,21752095,21756879,4784,"20","orth"
"18741",57,6,82,129,21759808,21763069,3261,"20","mask"
"18839",57,3,19,130,21766096,21769351,3255,"0","mask"
"19038",57,6,40,131,21781142,21784718,3576,"20","mask"
"19244",57,6,52,132,21791895,21794810,2915,"20","mask"
"19439",57,3,7,133,21800823,21804830,4007,"0","mask"
"19639",57,1,59,134,21811903,21817321,5418,"0","valid"
"19741",57,6,34,135,21821112,21826597,5485,"20","mask"
"19946",57,1,65,136,21833518,21836081,2563,"0","valid"
"20039",57,3,91,137,21839042,21841414,2372,"0","mask"
"20139",57,1,125,138,21844408,21847206,2798,"0","valid"
"10171",58,6,69,1,27682321,27684334,2013,"20","mask"
"11157",58,3,78,2,27687419,27689302,1883,"0","mask"
"12157",58,4,25,3,27693694,27695831,2137,"20","valid"
"14156",58,6,9,4,27702002,27706283,4281,"20","mask"
"16148",58,3,6,5,27711591,27714251,2660,"0","mask"
"18164",58,4,127,6,27726344,27727945,1601,"20","valid"
"19159",58,5,32,7,27733174,27735494,2320,"20","orth"
"2145",58,2,113,8,27740959,27743390,2431,"0","orth"
"2244",58,3,114,9,27746711,27749064,2353,"0","mask"
"2339",58,3,90,10,27752084,27753992,1908,"0","mask"
"2441",58,6,129,11,27757346,27761633,4287,"20","mask"
"2539",58,4,43,12,27764705,27766248,1543,"20","valid"
"2738",58,5,68,13,27775197,27777432,2235,"20","orth"
"2841",58,4,97,14,27781752,27783556,1804,"20","valid"
"2945",58,1,124,15,27786491,27789753,3262,"0","valid"
"3040",58,4,85,16,27793302,27795583,2281,"20","valid"
"3143",58,6,33,17,27799139,27800878,1739,"20","mask"
"3342",58,4,67,18,27813512,27816598,3086,"20","valid"
"3442",58,1,34,19,27821389,27823317,1928,"0","valid"
"3641",58,2,23,20,27828991,27831128,2137,"0","orth"
"3841",58,3,108,21,27836429,27839161,2732,"0","mask"
"3940",58,2,137,22,27845246,27847672,2426,"0","orth"
"4041",58,6,87,23,27852175,27854541,2366,"20","mask"
"4148",58,1,112,24,27861601,27863137,1536,"0","valid"
"4242",58,3,12,25,27866281,27867601,1320,"0","mask"
"4442",58,4,133,26,27875294,27877464,2170,"20","valid"
"4537",58,2,95,27,27880373,27882628,2255,"0","orth"
"4640",58,5,50,28,27885556,27887249,1693,"20","orth"
"4843",58,4,37,29,27892851,27895041,2190,"20","valid"
"5042",58,6,27,30,27901349,27903734,2385,"20","mask"
"5243",58,2,17,31,27911179,27913604,2425,"0","orth"
"5443",58,3,102,32,27920925,27922846,1921,"0","mask"
"5542",58,2,53,33,27926572,27928755,2183,"0","orth"
"5737",58,3,138,34,27935083,27938240,3157,"0","mask"
"5839",58,5,98,35,27941573,27944672,3099,"20","orth"
"5941",58,2,131,36,27947940,27950214,2274,"0","orth"
"6044",58,2,11,37,27953188,27956600,3412,"0","orth"
"6242",58,4,49,38,27962621,27965019,2398,"20","valid"
"6439",58,4,103,39,27970739,27973013,2274,"20","valid"
"6548",58,6,99,40,27976347,27978870,2523,"20","mask"
"6642",58,4,31,41,27985164,27987432,2268,"20","valid"
"6842",58,5,2,42,27998740,28001106,2366,"20","orth"
"7041",58,6,39,43,28007695,28009427,1732,"20","mask"
"7239",58,1,100,44,28015794,28017271,1477,"0","valid"
"7340",58,4,61,45,28023265,28026383,3118,"20","valid"
"7445",58,6,15,46,28032625,28034475,1850,"20","mask"
"7647",58,1,70,47,28042011,28044240,2229,"0","valid"
"7739",58,4,121,48,28048254,28050698,2444,"20","valid"
"7846",58,3,36,49,28054065,28055646,1581,"0","mask"
"8039",58,5,8,50,28062529,28065007,2478,"20","orth"
"8244",58,1,88,51,28070843,28072503,1660,"0","valid"
"8343",58,3,60,52,28076942,28079262,2320,"0","mask"
"8436",58,4,7,53,28082301,28084164,1863,"20","valid"
"8647",58,4,109,54,28089851,28091622,1771,"20","valid"
"8736",58,3,18,55,28095100,28096747,1647,"0","mask"
"8937",58,5,62,56,28103237,28105251,2014,"20","orth"
"9040",58,6,105,57,28108761,28110284,1523,"20","mask"
"9142",58,1,16,58,28114153,28116284,2131,"0","valid"
"9342",58,3,96,59,28122533,28123932,1399,"0","mask"
"9434",58,6,93,60,28126815,28128919,2104,"20","mask"
"9542",58,5,74,61,28132089,28134625,2536,"20","orth"
"9634",58,6,135,62,28137619,28140070,2451,"20","mask"
"9742",58,4,55,63,28149443,28151188,1745,"20","valid"
"9842",58,2,65,64,28155110,28156633,1523,"0","orth"
"9945",58,5,38,65,28159718,28161450,1732,"20","orth"
"10172",58,5,86,66,28246469,28248266,1797,"20","orth"
"10236",58,1,46,67,28251626,28252986,1360,"0","valid"
"10437",58,3,132,68,28259738,28261307,1569,"0","mask"
"10540",58,1,40,69,28264915,28267189,2274,"0","valid"
"10744",58,6,57,70,28273687,28275726,2039,"20","mask"
"10837",58,2,71,71,28278589,28281144,2555,"0","orth"
"10944",58,6,21,72,28283929,28286465,2536,"20","mask"
"11158",58,6,45,73,28292218,28294878,2660,"20","mask"
"11338",58,5,56,74,28300708,28303793,3085,"20","orth"
"11448",58,4,91,75,28306735,28309009,2274,"20","valid"
"11536",58,1,22,76,28312212,28313728,1516,"0","valid"
"11746",58,2,59,77,28319448,28321193,1745,"0","orth"
"11844",58,5,104,78,28324337,28326429,2092,"20","orth"
"11937",58,2,83,79,28330167,28332730,2563,"0","orth"
"12044",58,2,5,80,28336122,28337848,1726,"0","orth"
"12248",58,6,117,81,28345005,28347044,2039,"20","mask"
"12334",58,1,28,82,28350679,28352973,2294,"0","valid"
"12537",58,6,81,83,28358751,28360627,1876,"20","mask"
"12638",58,1,118,84,28364693,28366562,1869,"0","valid"
"12740",58,4,13,85,28369700,28372033,2333,"20","valid"
"12946",58,4,1,86,28377877,28379628,1751,"20","valid"
"13162",58,5,128,87,28385818,28388844,3026,"20","orth"
"13244",58,4,115,88,28397708,28399146,1438,"20","valid"
"13340",58,6,51,89,28443057,28445489,2432,"20","mask"
"13537",58,1,10,90,28451267,28452751,1484,"0","valid"
"13743",58,2,41,91,28458679,28460980,2301,"0","orth"
"13940",58,6,111,92,28465837,28467451,1614,"20","mask"
"14043",58,4,19,93,28470621,28472275,1654,"20","valid"
"14243",58,6,63,94,28478334,28479890,1556,"20","mask"
"14347",58,3,126,95,28487531,28489923,2392,"0","mask"
"14440",58,1,136,96,28493165,28495551,2386,"0","valid"
"14539",58,6,75,97,28499473,28502388,2915,"20","mask"
"14644",58,5,44,98,28505088,28506551,1463,"20","orth"
"14839",58,1,106,99,28513703,28514931,1228,"0","valid"
"14942",58,5,92,100,28518592,28520507,1915,"20","orth"
"15044",58,3,72,101,28523331,28525174,1843,"0","mask"
"15157",58,3,48,102,28527736,28529488,1752,"0","mask"
"15334",58,5,134,103,28535168,28537325,2157,"20","orth"
"15444",58,2,77,104,28540129,28542999,2870,"0","orth"
"15539",58,5,116,105,28546862,28549123,2261,"20","orth"
"15639",58,2,29,106,28551862,28553496,1634,"0","orth"
"15843",58,5,14,107,28561555,28563496,1941,"20","orth"
"16046",58,1,130,108,28571085,28574373,3288,"0","valid"
"16149",58,5,122,109,28577916,28579269,1353,"20","orth"
"16241",58,5,110,110,28582243,28585675,3432,"20","orth"
"16341",58,2,119,111,28590171,28593760,3589,"0","orth"
"16445",58,2,107,112,28602211,28604342,2131,"0","orth"
"16540",58,2,47,113,28608062,28609944,1882,"0","orth"
"16744",58,5,20,114,28615343,28618232,2889,"20","orth"
"16945",58,1,4,115,28623951,28625135,1184,"0","valid"
"17159",58,2,35,116,28630030,28631756,1726,"0","orth"
"17339",58,1,64,117,28642025,28644600,2575,"0","valid"
"17440",58,3,30,118,28647770,28649835,2065,"0","mask"
"17645",58,1,58,119,28654980,28658830,3850,"0","valid"
"17738",58,3,42,120,28661987,28664150,2163,"0","mask"
"17940",58,2,101,121,28672014,28674772,2758,"0","orth"
"18041",58,3,84,122,28679740,28683151,3411,"0","mask"
"18165",58,6,123,123,28686557,28689335,2778,"20","mask"
"18240",58,2,125,124,28693296,28695695,2399,"0","orth"
"18338",58,1,76,125,28698616,28701329,2713,"0","valid"
"18442",58,5,26,126,28704604,28707709,3105,"20","orth"
"18640",58,3,54,127,28713552,28715343,1791,"0","mask"
"18840",58,6,3,128,28729893,28731815,1922,"20","mask"
"19039",58,2,89,129,28739449,28741064,1615,"0","orth"
"19160",58,1,52,130,28747816,28750711,2895,"0","valid"
"19342",58,3,120,131,28758275,28760281,2006,"0","mask"
"19440",58,5,80,132,28763915,28765392,1477,"20","orth"
"19537",58,1,94,133,28769380,28772955,3575,"0","valid"
"19640",58,3,66,134,28776556,28778511,1955,"0","mask"
"19742",58,4,79,135,28781772,28784125,2353,"20","valid"
"19839",58,1,82,136,28788852,28790485,1633,"0","valid"
"19947",58,4,73,137,28797172,28798976,1804,"20","valid"
"20040",58,3,24,138,28801990,28804244,2254,"0","mask"
"10173",59,4,138,1,30139953,30144987,5034,"20","valid"
"11159",59,6,32,2,30148111,30151771,3660,"20","mask"
"13163",59,3,53,3,30158190,30160693,2503,"0","mask"
"15158",59,2,22,4,30166739,30169413,2674,"0","orth"
"17160",59,6,92,5,30175191,30179629,4438,"20","mask"
"18166",59,4,12,6,30182695,30185734,3039,"20","valid"
"2050",59,3,89,7,30191702,30195970,4268,"0","mask"
"2146",59,6,14,8,30198990,30203761,4771,"20","mask"
"2340",59,5,31,9,30209919,30212978,3059,"20","orth"
"2540",59,5,49,10,30222462,30224887,2425,"20","orth"
"2739",59,3,77,11,30235195,30237927,2732,"0","mask"
"2842",59,2,4,12,30241405,30243790,2385,"0","orth"
"3041",59,5,43,13,30249353,30251176,1823,"20","orth"
"3238",59,1,135,14,30256464,30259360,2896,"0","valid"
"3343",59,2,124,15,30262857,30265295,2438,"0","orth"
"3443",59,3,125,16,30268413,30271661,3248,"0","mask"
"3540",59,2,64,17,30275309,30278420,3111,"0","orth"
"3642",59,1,33,18,30281616,30284597,2981,"0","valid"
"3842",59,5,91,19,30290931,30293996,3065,"20","orth"
"3941",59,3,71,20,30297114,30299918,2804,"0","mask"
"4042",59,2,28,21,30302951,30305932,2981,"0","orth"
"4243",59,4,42,22,30311540,30313599,2059,"20","valid"
"4443",59,4,132,23,30320423,30323639,3216,"20","valid"
"4538",59,2,40,24,30327207,30330012,2805,"0","orth"
"4738",59,2,88,25,30336149,30338783,2634,"0","orth"
"4844",59,6,104,26,30345346,30347869,2523,"20","mask"
"4937",59,4,6,27,30351275,30353667,2392,"20","valid"
"5142",59,1,93,28,30359648,30361491,1843,"0","valid"
"5244",59,2,130,29,30364805,30367413,2608,"0","orth"
"5340",59,4,90,30,30371296,30373518,2222,"20","valid"
"5444",59,1,45,31,30376557,30378531,1974,"0","valid"
"5644",59,5,79,32,30384813,30387722,2909,"20","orth"
"5738",59,5,13,33,30390833,30396696,5863,"20","orth"
"5942",59,4,66,34,30406925,30409527,2602,"20","valid"
"6045",59,5,67,35,30412821,30415030,2209,"20","orth"
"6141",59,5,73,36,30417874,30420004,2130,"20","orth"
"6243",59,5,85,37,30422966,30425037,2071,"20","orth"
"6341",59,1,51,38,30428031,30430404,2373,"0","valid"
"6549",59,5,55,39,30435476,30437104,1628,"20","orth"
"6643",59,2,34,40,30443902,30445869,1967,"0","orth"
"6843",59,4,18,41,30452693,30455405,2712,"20","valid"
"7042",59,3,11,42,30461426,30464668,3242,"0","mask"
"7240",59,1,117,43,30470635,30472518,1883,"0","valid"
"7341",59,6,68,44,30478884,30481394,2510,"20","mask"
"7446",59,5,103,45,30484610,30486519,1909,"20","orth"
"7543",59,1,15,46,30489604,30491290,1686,"0","valid"
"7740",59,6,20,47,30497637,30499957,2320,"20","mask"
"7942",59,3,59,48,30508193,30510906,2713,"0","mask"
"8040",59,4,96,49,30514168,30516998,2830,"20","valid"
"8142",59,5,115,50,30519717,30521482,1765,"20","orth"
"8245",59,3,47,51,30524423,30526057,1634,"0","mask"
"8437",59,5,133,52,30532084,30534234,2150,"20","orth"
"8537",59,2,82,53,30537927,30539816,1889,"0","orth"
"8648",59,5,7,54,30542843,30544960,2117,"20","orth"
"8845",59,1,39,55,30552301,30553909,1608,"0","valid"
"9041",59,2,118,56,30559890,30561883,1993,"0","orth"
"9143",59,2,106,57,30564635,30566086,1451,"0","orth"
"9243",59,3,5,58,30570257,30572420,2163,"0","mask"
"9435",59,1,63,59,30579244,30581466,2222,"0","valid"
"9543",59,1,69,60,30584192,30585793,1601,"0","valid"
"9635",59,5,121,61,30588846,30591133,2287,"20","orth"
"9743",59,3,83,62,30594663,30597324,2661,"0","mask"
"9843",59,4,120,63,30600840,30602533,1693,"20","valid"
"9946",59,1,105,64,30605331,30606893,1562,"0","valid"
"10044",59,4,126,65,30610102,30612122,2020,"20","valid"
"10174",59,1,75,66,30729639,30731914,2275,"0","valid"
"10237",59,3,101,67,30734881,30736777,1896,"0","mask"
"10345",59,6,128,68,30739699,30742372,2673,"20","mask"
"10438",59,3,17,69,30745340,30747536,2196,"0","mask"
"10642",59,6,134,70,30753059,30755491,2432,"20","mask"
"10745",59,1,27,71,30759197,30761020,1823,"0","valid"
"10945",59,1,3,72,30768590,30770099,1509,"0","valid"
"11160",59,4,24,73,30776675,30778845,2170,"20","valid"
"11339",59,5,25,74,30785015,30787604,2589,"20","orth"
"11537",59,3,23,75,30793912,30796382,2470,"0","mask"
"11747",59,4,54,76,30803089,30805089,2000,"20","valid"
"11938",59,2,52,77,30812913,30815050,2137,"0","orth"
"12158",59,4,108,78,30822195,30824809,2614,"20","valid"
"12249",59,5,1,79,30831339,30833359,2020,"20","orth"
"12443",59,2,76,80,30839751,30842026,2275,"0","orth"
"12538",59,1,123,81,30845118,30847340,2222,"0","valid"
"12639",59,6,50,82,30851085,30853144,2059,"20","mask"
"12839",59,6,62,83,30860360,30862354,1994,"20","mask"
"12947",59,2,94,84,30867890,30870557,2667,"0","orth"
"13036",59,3,107,85,30873734,30878871,5137,"0","mask"
"13164",59,5,109,86,30882264,30884820,2556,"20","orth"
"13245",59,2,136,87,30888526,30890957,2431,"0","orth"
"13341",59,1,81,88,30894140,30896003,1863,"0","valid"
"13442",59,5,19,89,30900285,30902245,1960,"20","orth"
"13643",59,4,84,90,30908246,30910919,2673,"20","valid"
"13744",59,2,10,91,30914626,30916599,1973,"0","orth"
"13941",59,3,29,92,30925103,30926809,1706,"0","mask"
"14157",59,6,38,93,30933202,30935202,2000,"20","mask"
"14348",59,3,113,94,30941778,30944281,2503,"0","mask"
"14441",59,4,72,95,30947928,30949536,1608,"20","valid"
"14540",59,3,65,96,30952739,30954491,1752,"0","mask"
"14645",59,6,86,97,30957622,30959726,2104,"20","mask"
"14739",59,6,80,98,30962942,30964805,1863,"20","mask"
"14840",59,1,87,99,30968871,30971322,2451,"0","valid"
"14943",59,1,57,100,30974447,30976080,1633,"0","valid"
"15045",59,1,21,101,30979525,30981035,1510,"0","valid"
"15247",59,6,74,102,30990415,30992558,2143,"20","mask"
"15335",59,6,110,103,30995840,30997925,2085,"20","mask"
"15445",59,6,44,104,31005226,31006703,1477,"20","mask"
"15640",59,6,122,105,31028300,31030182,1882,"20","mask"
"15745",59,2,70,106,31033431,31035568,2137,"0","orth"
"15844",59,3,131,107,31038634,31040647,2013,"0","mask"
"15936",59,6,26,108,31043817,31046000,2183,"20","mask"
"16150",59,4,36,109,31052569,31054216,1647,"20","valid"
"16342",59,5,61,110,31059949,31061772,1823,"20","orth"
"16446",59,3,41,111,31064629,31067413,2784,"0","mask"
"16639",59,4,78,112,31072845,31074760,1915,"20","valid"
"16745",59,6,98,113,31077597,31079473,1876,"20","mask"
"16842",59,2,100,114,31082388,31084244,1856,"0","orth"
"16946",59,4,60,115,31087199,31088983,1784,"20","valid"
"17042",59,1,9,116,31092199,31094415,2216,"0","valid"
"17240",59,4,48,117,31100683,31103246,2563,"20","valid"
"17441",59,6,2,118,31109024,31111240,2216,"20","mask"
"17646",59,3,137,119,31117331,31119168,1837,"0","mask"
"17739",59,1,99,120,31122332,31124044,1712,"0","valid"
"17845",59,1,111,121,31127626,31129038,1412,"0","valid"
"17941",59,4,102,122,31132313,31134006,1693,"20","valid"
"18042",59,2,46,123,31137176,31139764,2588,"0","orth"
"18241",59,3,95,124,31145660,31148517,2857,"0","mask"
"18339",59,5,97,125,31151367,31153510,2143,"20","orth"
"18443",59,4,114,126,31156661,31158720,2059,"20","valid"
"18538",59,5,127,127,31161583,31163348,1765,"20","orth"
"18641",59,3,35,128,31166930,31168884,1954,"0","mask"
"18841",59,3,119,129,31175695,31178407,2712,"0","mask"
"18940",59,6,116,130,31181329,31183885,2556,"20","mask"
"19040",59,2,112,131,31187297,31188918,1621,"0","orth"
"19161",59,1,129,132,31191604,31196559,4955,"0","valid"
"19245",59,2,16,133,31199808,31202278,2470,"0","orth"
"19441",59,6,56,134,31208331,31210560,2229,"20","mask"
"19538",59,6,8,135,31213580,31215429,1849,"20","mask"
"19743",59,4,30,136,31221018,31222724,1706,"20","valid"
"19948",59,2,58,137,31228000,31229855,1855,"0","orth"
"20041",59,5,37,138,31232901,31235411,2510,"20","orth"
"10175",60,1,104,1,32696312,32701201,4889,"0","valid"
"11161",60,5,126,2,32704580,32709358,4778,"20","orth"
"12159",60,2,45,3,32713463,32718326,4863,"0","orth"
"14158",60,5,6,4,32724529,32729699,5170,"20","orth"
"16151",60,4,5,5,32735974,32740727,4753,"20","valid"
"18167",60,5,42,6,32747374,32750962,3588,"20","orth"
"2051",60,6,85,7,32758819,32763466,4647,"20","mask"
"2147",60,6,79,8,32766571,32771996,5425,"20","mask"
"2245",60,1,44,9,32774912,32777840,2928,"0","valid"
"2442",60,3,76,10,32783854,32788860,5006,"0","mask"
"2541",60,5,114,11,32791749,32796919,5170,"20","orth"
"2648",60,3,118,12,32800201,32804730,4529,"0","mask"
"2740",60,6,37,13,32807698,32811705,4007,"20","mask"
"2946",60,5,120,14,32820921,32825614,4693,"20","orth"
"3042",60,6,133,15,32828856,32832837,3981,"20","mask"
"3144",60,1,116,16,32835667,32840282,4615,"0","valid"
"3239",60,6,103,17,32843328,32846988,3660,"20","mask"
"3344",60,2,75,18,32849975,32854192,4217,"0","orth"
"3444",60,5,90,19,32857205,32861623,4418,"20","orth"
"3541",60,1,8,20,32864937,32867938,3001,"0","valid"
"3740",60,5,108,21,32875591,32879232,3641,"20","orth"
"3843",60,3,106,22,32882311,32885004,2693,"0","mask"
"3942",60,6,55,23,32887716,32891299,3583,"20","mask"
"4043",60,5,54,24,32894619,32897953,3334,"20","orth"
"4244",60,1,80,25,32907992,32913764,5772,"0","valid"
"4338",60,4,107,26,32916993,32920934,3941,"20","valid"
"4444",60,3,40,27,32924562,32928765,4203,"0","mask"
"4641",60,2,81,28,32935282,32939589,4307,"0","orth"
"4739",60,2,39,29,32942504,32945413,2909,"0","orth"
"4938",60,2,117,30,32951440,32954394,2954,"0","orth"
"5043",60,3,28,31,32957263,32961009,3746,"0","mask"
"5245",60,1,2,32,32967303,32972245,4942,"0","valid"
"5445",60,2,63,33,32979710,32983690,3980,"0","orth"
"5543",60,4,119,34,32986984,32991331,4347,"20","valid"
"5645",60,5,30,35,32994482,32998018,3536,"20","orth"
"5840",60,3,64,36,33003450,33007358,3908,"0","mask"
"5943",60,6,31,37,33011385,33016006,4621,"20","mask"
"6142",60,1,56,38,33025085,33029699,4614,"0","valid"
"6244",60,1,110,39,33032661,33035498,2837,"0","valid"
"6342",60,4,53,40,33038687,33041727,3040,"20","valid"
"6550",60,2,57,41,33048178,33053525,5347,"0","orth"
"6644",60,3,94,42,33056969,33060636,3667,"0","mask"
"6737",60,1,92,43,33063774,33067689,3915,"0","valid"
"6844",60,2,93,44,33070461,33075736,5275,"0","orth"
"6942",60,6,13,45,33079037,33082951,3914,"20","mask"
"7141",60,1,38,46,33088560,33091952,3392,"0","valid"
"7342",60,5,24,47,33097358,33100783,3425,"20","orth"
"7544",60,1,14,48,33108862,33113333,4471,"0","valid"
"7741",60,2,15,49,33119059,33121555,2496,"0","orth"
"7943",60,3,130,50,33127595,33133079,5484,"0","mask"
"8041",60,4,71,51,33136053,33139537,3484,"20","valid"
"8143",60,1,98,52,33142380,33146779,4399,"0","valid"
"8246",60,2,105,53,33150152,33153224,3072,"0","orth"
"8344",60,6,67,54,33156120,33159192,3072,"20","mask"
"8438",60,2,33,55,33162244,33166519,4275,"0","orth"
"8649",60,2,123,56,33173441,33176768,3327,"0","orth"
"8737",60,5,12,57,33180984,33184017,3033,"20","orth"
"8938",60,3,124,58,33192390,33195880,3490,"0","mask"
"9042",60,6,109,59,33198966,33203214,4248,"20","mask"
"9144",60,2,69,60,33206927,33209398,2471,"0","orth"
"9244",60,2,99,61,33212549,33218058,5509,"0","orth"
"9343",60,6,25,62,33221255,33226098,4843,"20","mask"
"9544",60,4,41,63,33232471,33235955,3484,"20","valid"
"9744",60,6,61,64,33242590,33246269,3679,"20","mask"
"9844",60,4,35,65,33248989,33251871,2882,"20","valid"
"10045",60,1,68,66,33283651,33287527,3876,"0","valid"
"10176",60,3,88,67,33290612,33294763,4151,"0","mask"
"10238",60,1,20,68,33297835,33301456,3621,"0","valid"
"10439",60,1,50,69,33307711,33310646,2935,"0","valid"
"10643",60,4,23,70,33316274,33320510,4236,"20","valid"
"10838",60,6,73,71,33325837,33329027,3190,"20","mask"
"10946",60,5,48,72,33331857,33333981,2124,"20","orth"
"11162",60,3,46,73,33340380,33345551,5171,"0","mask"
"11340",60,3,34,74,33351277,33355466,4189,"0","mask"
"11538",60,1,74,75,33361702,33365238,3536,"0","valid"
"11644",60,3,22,76,33368069,33371369,3300,"0","mask"
"11845",60,5,18,77,33376794,33380723,3929,"20","orth"
"12045",60,3,70,78,33386991,33391096,4105,"0","mask"
"12160",60,2,111,79,33394077,33397469,3392,"0","orth"
"12250",60,6,49,80,33400593,33403783,3190,"20","mask"
"12444",60,5,66,81,33409607,33413156,3549,"20","orth"
"12539",60,1,134,82,33416216,33419595,3379,"0","valid"
"12640",60,1,32,83,33422883,33426876,3993,"0","valid"
"12840",60,2,135,84,33432681,33435857,3176,"0","orth"
"12948",60,2,21,85,33439289,33441786,2497,"0","orth"
"13165",60,5,36,86,33447557,33452113,4556,"20","orth"
"13342",60,4,29,87,33457591,33461382,3791,"20","valid"
"13538",60,1,26,88,33471507,33475808,4301,"0","valid"
"13745",60,5,96,89,33481945,33485285,3340,"20","orth"
"13836",60,4,11,90,33488058,33490508,2450,"20","valid"
"14044",60,4,17,91,33496515,33496528,13,"20","valid"
"14244",60,1,122,92,33504895,33507293,2398,"0","valid"
"14349",60,6,127,93,33510908,33513666,2758,"20","mask"
"14442",60,2,9,94,33516621,33519157,2536,"0","orth"
"14646",60,6,7,95,33525922,33528733,2811,"20","mask"
"14841",60,5,78,96,33534923,33537406,2483,"20","orth"
"14944",60,3,112,97,33540844,33543531,2687,"0","mask"
"15046",60,2,27,98,33546342,33549885,3543,"0","orth"
"15248",60,3,100,99,33557146,33563271,6125,"0","mask"
"15336",60,3,136,100,33566631,33570591,3960,"0","mask"
"15446",60,4,65,101,33573873,33577134,3261,"20","valid"
"15540",60,5,132,102,33579984,33583965,3981,"20","orth"
"15641",60,4,59,103,33587423,33590698,3275,"20","valid"
"15746",60,4,83,104,33593848,33596600,2752,"20","valid"
"15845",60,1,86,105,33599365,33603731,4366,"0","valid"
"15937",60,6,91,106,33606901,33609660,2759,"20","mask"
"16047",60,3,10,107,33612627,33615667,3040,"0","mask"
"16242",60,4,47,108,33622464,33625059,2595,"20","valid"
"16447",60,1,128,109,33630687,33634661,3974,"0","valid"
"16541",60,3,16,110,33638217,33641695,3478,"0","mask"
"16746",60,3,52,111,33647571,33650205,2634,"0","mask"
"16947",60,6,115,112,33655676,33659231,3555,"20","mask"
"17043",60,4,137,113,33661951,33665265,3314,"20","valid"
"17161",60,5,102,114,33668245,33671337,3092,"20","orth"
"17241",60,6,19,115,33674213,33677579,3366,"20","mask"
"17442",60,6,1,116,33683730,33687299,3569,"20","mask"
"17647",60,3,82,117,33693084,33696404,3320,"0","mask"
"17740",60,6,121,118,33699979,33703221,3242,"20","mask"
"17846",60,5,72,119,33706012,33709156,3144,"20","orth"
"17942",60,3,4,120,33712170,33715882,3712,"0","mask"
"18168",60,1,62,121,33721523,33724994,3471,"0","valid"
"18242",60,4,101,122,33729569,33732838,3269,"20","valid"
"18340",60,5,84,123,33735982,33739263,3281,"20","orth"
"18444",60,2,129,124,33742139,33746250,4111,"0","orth"
"18539",60,2,87,125,33749558,33754323,4765,"0","orth"
"18642",60,6,97,126,33763108,33766938,3830,"20","mask"
"18742",60,4,95,127,33770304,33773723,3419,"20","valid"
"18842",60,4,131,128,33776938,33780377,3439,"20","valid"
"18941",60,4,125,129,33783508,33789090,5582,"20","valid"
"19041",60,5,138,130,33792293,33795293,3000,"20","orth"
"19162",60,3,58,131,33799711,33804777,5066,"0","mask"
"19246",60,4,89,132,33808045,33811830,3785,"20","valid"
"19343",60,4,77,133,33815471,33819013,3542,"20","valid"
"19442",60,6,43,134,33822674,33827524,4850,"20","mask"
"19641",60,2,3,135,33835047,33838152,3105,"0","orth"
"19840",60,2,51,136,33844165,33847041,2876,"0","orth"
"20042",60,5,60,137,33853087,33856219,3132,"20","orth"
"20140",60,4,113,138,33859271,33861173,1902,"20","valid"
